Date,Description,Deposits,Withdrawls,Balance,Customer Id,Index,First Name,Last Name,Company,City,Country,Phone 1,Phone 2,Email,Subscription Date,Website
20-Aug-2020,Cash,"97,540.00",00.00,"170,542.01",Fbd8FAaD2ccC03F,677,Dillon,Soto,"Avery, Torres and Arellano",Davidberg,Cote d'Ivoire,+1-799-961-3002,+1-035-693-9215x7273,diane91@rocha.net,2021-09-22,http://www.mccormick.com/
20-Aug-2020,Commission,00.00,"34,108.40","136,433.61",ad72E2c53510Aed,8171,Douglas,Bennett,Hatfield Group,Devonmouth,Mauritius,3783301320,+1-561-310-2412x632,ericamorales@ball-arias.com,2021-11-15,https://www.ray.com/
20-Aug-2020,ATM,41.00,00.00,"136,474.61",59aa3f2dabdf86f,9230,Virginia,Haas,Fleming Ltd,Rebekahport,Bahamas,001-094-405-1821,+1-436-914-2970x9592,devonduke@church.info,2020-10-20,http://bennett.com/
20-Aug-2020,Interest,50.00,00.00,"136,524.61",b1BabAFCce090F5,9791,Alejandro,Cameron,Richardson Ltd,Louisburgh,Senegal,426.235.9969x94451,(317)642-6419x2108,alan20@willis.org,2021-02-12,https://www.gallegos.com/
20-Aug-2020,Commission,00.00,"34,131.15","102,393.46",bE13C300faDAE19,7864,Jonathan,Atkins,Zuniga-Lynch,New Jeromeport,Seychelles,(070)902-6164,(832)818-1234x902,alicevelasquez@pena-parker.biz,2020-01-09,http://www.boyle.com/
20-Aug-2020,Reversal,00.00,"17,065.58","85,327.88",eC7903DBFB7b465,506,Anthony,Jackson,Fuller LLC,East Rodney,Faroe Islands,(242)730-8145x398,612.240.1690,micheal09@johnson-barajas.com,2021-07-19,https://olsen.org/
20-Aug-2020,Reversal,"204,765.00",00.00,"290,092.88",dE1Be6D9c110A1B,9084,Phyllis,Olsen,Stewart LLC,South Andrea,Thailand,+1-461-084-6696,(116)473-2469,sandynorris@juarez-blevins.com,2021-12-21,https://kane.com/
20-Aug-2020,Cheque,"53,121.00",00.00,"343,213.88",16E6BFdbD035E27,5108,Daryl,Harvey,Huynh-Tate,New Danaview,Maldives,+1-086-168-5195,314.205.4122,fbuckley@durham.com,2020-06-12,https://www.larsen-parks.com/
20-Aug-2020,NEFT,07.10,00.00,"343,220.98",D3c3bcBEeD5FFFe,3638,Fernando,Hogan,Young-Boyle,East Darrellbury,Vietnam,+1-381-509-8285,+1-390-729-4715x650,unolan@white-key.biz,2020-09-13,https://www.mitchell.com/
20-Aug-2020,IMPS,03.46,00.00,"343,224.44",025d9B97DEaB5cf,6728,Kelsey,Strickland,Ruiz Inc,Marshfort,Andorra,001-697-158-3924x915,455.626.8086x437,cheyenneguerra@burke.com,2020-10-23,http://robertson.com/
20-Aug-2020,Transfer,03.00,00.00,"343,227.44",8734c8EaAb96ba2,4069,Karen,Fuller,Davenport-Arroyo,South Johnny,Syrian Arab Republic,001-803-485-1064x84202,469-911-1776,lozanodebra@freeman.net,2022-01-10,http://www.fitzpatrick.com/
20-Aug-2020,RTGS,"223,558.62",00.00,"566,786.06",FEfeb54Bae1Dfd1,5189,Lucas,Ramos,Mullins-Meza,Wangview,Greenland,381-482-9679x19469,001-846-979-6390,stephenstristan@carrillo.org,2022-03-10,https://mccormick.biz/
20-Aug-2020,ATM,"496,536.75",00.00,"1,063,322.81",dE4CbFD230e480c,4239,Valerie,Aguilar,Browning and Sons,Saundersport,Finland,001-736-558-6154x1927,9383830090,mackenziegrant@sharp.com,2021-11-26,https://haley.com/
20-Aug-2020,Reversal,"770,726.00",00.00,"1,834,048.81",7bbb0fD595c6B7D,2727,Christina,Miller,Trevino-Novak,Port Tracieshire,Slovenia,001-224-361-6675,155-904-1270x05264,vhoffman@doyle-bowen.net,2020-05-18,http://www.melton.com/
20-Aug-2020,Interest,00.00,"1,834,048.81",00.00,1DDD6CabFeBa6E3,3440,Maxwell,Pearson,Hess and Sons,Leeburgh,Palau,782.103.0340x12417,058.991.3605x595,yhodge@holden.com,2021-07-22,http://www.montoya.com/
20-Aug-2020,Bill,00.01,00.00,00.01,66E95eA94Ec95F9,6347,Tony,Reynolds,Villa-Mckenzie,South Juan,Martinique,832.894.4691x362,001-597-702-3226x35787,ltanner@valdez.com,2020-07-06,http://www.gutierrez.info/
20-Aug-2020,Commission,"18,690.68",00.00,"18,690.69",B9beF8c3eCE69d7,6159,Sonia,Sexton,Murillo-Zhang,Hubermouth,Netherlands,(216)715-5309,187-369-3620x5117,dblack@stafford.com,2022-02-25,https://blake-yoder.com/
20-Aug-2020,Cash,00.00,"1,869.07","16,821.62",8a5C36aBc71ace2,8456,Darrell,Pitts,Callahan Group,Meyerfort,Saint Barthelemy,610.315.0468x7719,799.047.2687x8180,rreilly@ponce.info,2021-06-06,http://frazier.info/
20-Aug-2020,Cheque,190.00,00.00,"17,011.62",AeEaeDc36fAa1BC,6409,Jade,Sweeney,Rowe Ltd,Karenton,Cayman Islands,653-114-8608,(103)292-6514x7370,jose41@mora.com,2020-02-09,https://www.harmon.com/
20-Aug-2020,Tax,55.00,00.00,"17,066.62",Cb8B8bfcfD5FE5A,9206,Henry,Schaefer,"Calderon, Day and Boyd",Ashleybury,Palau,(443)084-6897,+1-981-577-6705x22906,lkaufman@walton.com,2020-03-05,http://webster-chavez.com/
20-Aug-2020,ATM,00.00,"1,896.29","15,170.33",bd7Da4B82F28279,405,Zachary,Shaffer,"Haynes, Lara and Lara",Mccormickmouth,Czech Republic,(713)867-5810x3140,540.738.7911x210,avilasummer@hensley-richmond.net,2022-01-30,https://www.burgess.org/
20-Aug-2020,Transfer,00.00,"3,034.07","12,136.26",08800F76A7bb4c0,1936,Cathy,Stanley,Kline Group,Lake Hayden,Nepal,556-116-4958x14315,024-650-8735x25924,kirsten54@hansen.info,2020-12-09,http://mack.info/
20-Aug-2020,ATM,26.60,00.00,"12,162.86",bB74ca44dcF7ED1,2919,Bill,Bauer,Wood Group,Peggyfort,Niue,+1-417-610-6866x08946,279-113-5193,hoodroberta@ware-sanford.com,2022-05-24,https://sexton.com/
20-Aug-2020,ATM,00.00,"6,081.43","6,081.43",fe9bdADcFAddcAd,6695,Troy,Dodson,Hernandez-Caldwell,North Cliffordborough,Bolivia,8631095209,142-731-6285x45762,george99@lynch.com,2020-10-19,https://steele.com/
20-Aug-2020,NEFT,"1,986,737.80",00.00,"1,992,819.23",fD582B6be0baB6c,1637,Tommy,Gallagher,Hunt Ltd,South Caitlinville,Austria,001-296-355-1459x214,383.793.1131,melissadavid@mcbride.com,2021-10-13,http://www.weiss.com/
20-Aug-2020,Reversal,00.00,"664,273.08","1,328,546.15",D4EEd12c5B0F192,9806,Kenneth,Hansen,Juarez-Harper,Lake Stuartville,Senegal,001-128-494-5934x8229,001-050-732-9825x02718,jeffrey25@johnston-summers.net,2020-12-08,http://vincent-powell.com/
20-Aug-2020,Cash,03.81,00.00,"1,328,549.96",bebEFA30A2aD4d8,8993,Darin,Beltran,David PLC,Bonnieberg,Ukraine,+1-656-505-8539x7155,(680)771-8596,mjohnson@kemp.com,2021-09-07,http://cain.biz/
20-Aug-2020,RTGS,"1,474.00",00.00,"1,330,023.96",61513B2BedFEccD,1447,Latasha,Riley,Carr Ltd,Porterburgh,British Virgin Islands,546-000-6861x02901,093-450-2714x06322,anna60@barnes.org,2022-01-23,https://www.ryan-merritt.net/
20-Aug-2020,Interest,00.00,"147,780.44","1,182,243.52",f0d9CaAb9d8cfbe,4177,Danielle,Rocha,Flores-Scott,West Isaiah,Portugal,+1-078-800-5568x2810,(364)182-2597x901,raybrandt@meyer.info,2021-02-19,http://www.bonilla-hays.info/
20-Aug-2020,Bill,00.00,"168,891.93","1,013,351.59",5AE6a9B50D6BBe8,879,Meagan,Johnston,"Castro, Bowman and Santana",Pricehaven,Reunion,005.127.7902,268.887.8343x096,yatesjoann@wilcox.com,2021-05-14,https://velazquez.com/
20-Aug-2020,Transfer,191.00,00.00,"1,013,542.59",e1795bDcc9dFd0e,7958,Stacy,Coleman,Cortez Group,Lake Janetown,Kazakhstan,+1-118-382-9725x6741,+1-573-114-1364x58839,alexbaxter@glass.com,2020-10-14,http://grimes.info/
20-Aug-2020,Interest,"22,709.69",00.00,"1,036,252.28",d70a2EC8dF04bD1,6244,Brittany,Avila,"Mitchell, Ho and Johnson",Lake Gabrielfurt,Turks and Caicos Islands,952.931.9767,(991)908-1467,hbaxter@montes.com,2021-07-19,http://warner-good.com/
20-Aug-2020,ATM,44.00,00.00,"1,036,296.28",1C2EB2EbF185cB4,4183,Duane,Pierce,Cooke Group,New Briannaview,Nepal,001-883-608-5731x81952,001-174-852-9037x2935,mstanton@hines-weeks.com,2021-12-04,http://www.conley.org/
20-Aug-2020,Interest,54.05,00.00,"1,036,350.33",DFB3fcfbe67D6cc,8903,Laura,Petty,"Hill, Mcpherson and Hernandez",North Mindy,Namibia,(437)493-9021x439,7636737129,perry53@skinner.com,2020-04-03,https://berry.com/
20-Aug-2020,IMPS,178.00,00.00,"1,036,528.33",bcE3Fbe7cfAfaFa,6621,Ronald,Pennington,Potts LLC,North Olivia,Madagascar,(279)295-1295,001-887-559-7046,dillon37@cruz-rosales.info,2021-03-05,http://acevedo.com/
20-Aug-2020,ATM,00.00,"518,264.17","518,264.16",d63fC569F1a72DE,8235,Jeremy,Fry,Nichols-Carrillo,South Isaacview,Belize,473.766.8694x85956,(656)516-1655x6652,gillvickie@hoover-stevenson.com,2022-01-02,http://chapman.info/
20-Aug-2020,Miscellaneous,00.00,"103,652.83","414,611.33",9B13Eb7a280B7E9,1010,Kelsey,Colon,Andrade-Sawyer,Lesterfort,Indonesia,+1-990-015-4214x4165,001-270-221-6376x1125,oowens@valenzuela.biz,2020-10-14,http://hickman.com/
20-Aug-2020,Cash,16.00,00.00,"414,627.33",B152EC6d833Fbb8,5263,Ricky,Bailey,Tyler and Sons,New Jeremiah,Brunei Darussalam,(400)449-9913,4216180876,ubradford@torres-mercado.com,2021-09-08,https://randolph-johnson.com/
20-Aug-2020,Transfer,00.00,"46,069.70","368,557.63",0aad7ED3Fe3DaF1,3801,Lynn,Trujillo,"Booth, Velez and Gibbs",Fisherland,Malta,+1-937-120-4252x567,8791410284,ldunlap@carlson.com,2020-08-16,https://www.bell-warner.com/
20-Aug-2020,Debit Card,00.00,"184,278.82","184,278.82",2c0bE27aBAaA8bB,3145,Dwayne,Peters,Glenn-Howard,Port Lorraineside,Syrian Arab Republic,(661)540-1716x26870,+1-057-070-7005x8840,kmay@lewis-mcmillan.com,2022-05-29,http://www.novak.com/
20-Aug-2020,NEFT,00.00,"30,713.14","153,565.68",1Ba4e2F45c2AeE9,9245,Trevor,Anderson,Luna LLC,New Eduardotown,Thailand,790.986.0064,151-233-4390x5188,wyatt09@bender.com,2021-08-11,https://www.benton.com/
21-Aug-2020,Cash,"14,418.10",00.00,"167,983.78",a36EA2cD2D9F4f1,764,Collin,Sanford,"Key, Obrien and York",Stokesport,Burundi,607.070.7192,3647576021,calvindiaz@snow.com,2020-02-15,https://www.frye.org/
21-Aug-2020,RTGS,00.00,"33,596.76","134,387.02",4CAFa16DDD7CB98,6588,Danny,Wilkinson,"Franco, Burgess and Pena",Hendrixport,Malta,(442)457-6281x60521,001-624-575-5849x269,patricksandra@lang-bradford.com,2020-03-29,https://www.shea.com/
21-Aug-2020,Purchase,00.00,"44,795.67","89,591.35",Fc0aB845dC093e6,7918,Harold,Jensen,Navarro PLC,West Maureentown,Turks and Caicos Islands,001-370-331-1504x5993,647.638.7159x1444,mario03@mayer.org,2020-02-10,https://steele.org/
21-Aug-2020,Debit Card,492.86,00.00,"90,084.21",11d171cC26b7CeE,5906,Annette,Cooper,Rose-Graves,East Ian,Malawi,+1-054-273-4822x456,654-994-3222,meghan21@ramirez.com,2021-07-12,https://shaw.net/
21-Aug-2020,ATM,00.00,"90,084.21",00.00,BF4da4732349D6A,6311,Louis,Strong,Green Ltd,Cheyenneville,Iraq,719-371-4963x3424,(918)574-2352,pwu@roman.com,2020-01-09,http://www.parrish.biz/
21-Aug-2020,RTGS,08.00,00.00,08.00,B4BCE89feD0fDfA,3704,Jeff,Escobar,Phillips-Cobb,Brandyburgh,Bosnia and Herzegovina,001-178-690-2441x8902,852.037.7581,diane65@grant.org,2022-01-04,https://hunt.com/
21-Aug-2020,Bill,"7,099.00",00.00,"7,107.00",763ED2e150f8aCC,6790,Robert,Mcdowell,Dickson-Owens,North Shariland,Sri Lanka,662-739-0422,686-024-5911x1062,francisco09@frank-mcdowell.com,2021-09-26,https://www.jacobs.com/
21-Aug-2020,Purchase,02.60,00.00,"7,109.60",dd6BBbdEFD7A1e6,8068,Rebecca,Fowler,"Walton, Salas and Rosales",Lake Ronnieburgh,Maldives,184-815-5397,874.398.1523,ihouston@long-skinner.info,2020-10-26,http://www.hughes.com/
21-Aug-2020,NEFT,772.40,00.00,"7,882.00",a4Bca3efd46afD0,7006,Sally,Bowman,"Hensley, Warren and Wolf",Alyssaton,Palau,4088522344,2265543033,gibbsdarius@stanton.net,2020-12-27,https://www.brady-byrd.com/
21-Aug-2020,Bill,"1,335,369.25",00.00,"1,343,251.25",0F53bd0a1ddaD59,3485,Erik,Cole,Black-Callahan,Juliemouth,Mauritania,979.737.1737x34632,8247257764,monique35@bishop.com,2021-06-05,https://www.shaw.biz/
21-Aug-2020,NEFT,"31,237.00",00.00,"1,374,488.25",C153f9Ee155c248,2826,Dominic,Ray,"Malone, Archer and Hart",West Stanleyton,Sri Lanka,+1-614-370-4863x0042,001-190-226-9005x40823,gmoon@marks.com,2020-05-13,http://www.kirk.net/
21-Aug-2020,Transfer,00.00,"137,448.83","1,237,039.42",Ccf5958b82309Ff,628,Katrina,Stanley,"Mccullough, Stanley and Sloan",West Doris,Liechtenstein,001-259-822-8869,(067)980-4629,melissahunt@andrews-wiley.biz,2022-05-08,https://braun.org/
21-Aug-2020,IMPS,00.00,"412,346.47","824,692.95",BffFFed20cb0fD1,6665,Charles,Krause,Cantu-Wolf,Brandyton,Macedonia,+1-667-747-3352x909,(341)085-3724,lori84@mcgee-weber.net,2020-10-08,http://michael.com/
21-Aug-2020,Commission,00.00,"412,346.48","412,346.48",b9c7C4ab1c1E053,4264,Hailey,Frost,Daniels-Combs,Dicksonland,Gabon,001-016-296-5366,001-199-930-4021,arichard@espinoza-spears.com,2020-08-13,http://daniels-costa.org/
21-Aug-2020,Bill,00.00,"51,543.31","360,803.17",AF1d84BDD5eD29A,9720,Jermaine,Frey,"Robles, Hodge and Morgan",Deniseside,Zimbabwe,624-760-7794x2672,+1-788-426-6007x901,vmaxwell@hooper.com,2020-03-11,https://knapp.net/
22-Aug-2020,NEFT,00.00,"90,200.79","270,602.38",8F8CaD61FECcB19,5939,Lacey,Welch,"Bruce, Hart and Bautista",Alejandrofort,Kenya,(135)475-9034x9214,198-416-8413x57135,teresacharles@ewing.org,2022-05-03,http://www.mosley.com/
22-Aug-2020,NEFT,06.60,00.00,"270,608.98",1Ba4e2F45c2AeE9,9245,Trevor,Anderson,Luna LLC,New Eduardotown,Thailand,790.986.0064,151-233-4390x5188,wyatt09@bender.com,2021-08-11,https://www.benton.com/
22-Aug-2020,Reversal,00.00,"45,101.50","225,507.48",67BbA4AeC24c1df,3338,Jill,Weaver,Osborn-Conway,Port Selenaview,France,616.617.9060x9554,(697)476-0291x23078,holly76@andrade.org,2021-11-27,http://petersen.org/
22-Aug-2020,RTGS,"217,183.10",00.00,"442,690.58",0cF95ECbBEd88eD,6935,Diana,Stein,Higgins Group,West Virginia,Iran,001-594-009-6153x58013,+1-568-124-4659x820,maxwellcolton@petty-zamora.com,2021-04-05,http://maldonado.com/
22-Aug-2020,RTGS,00.00,"221,345.29","221,345.29",4CfcBf68d2AAdEf,6796,Christine,Ho,Kelly Group,Lake Alec,Syrian Arab Republic,226.973.0402x413,471-668-0953x9195,greerconnor@livingston.com,2020-11-20,https://www.prince-beltran.com/
22-Aug-2020,Debit Card,"17,021.00",00.00,"238,366.29",05d0BBD8588dc21,9538,Randall,Chung,Daniel-Stuart,Rileyhaven,Mali,429-485-7232,+1-316-077-0083x122,jonbright@conway.org,2020-09-15,http://www.payne.biz/
22-Aug-2020,Commission,"128,690.25",00.00,"367,056.54",e8fC8CC2f02B9aC,3074,Malik,Roth,Alvarado-Young,Dominguezbury,Tonga,+1-484-610-9650x3616,007-366-0489,michellehurst@navarro-barajas.info,2021-01-16,http://www.benjamin.com/
22-Aug-2020,Reversal,"3,749.10",00.00,"370,805.64",3254Bb7DcfD7AaC,2425,Belinda,Graham,Crawford-Saunders,West Guymouth,Philippines,001-564-943-5171x7505,001-161-461-9386x84740,buckrickey@hensley.biz,2020-12-26,https://shields-daniels.com/
22-Aug-2020,Miscellaneous,"2,585.20",00.00,"373,390.84",d0Ca394F8A5bf8c,4417,Kristy,Salas,Owen Group,South Marchaven,Tunisia,(458)666-2004x550,(125)744-9881,chrishays@fisher-yates.com,2022-01-27,https://www.dudley.com/
22-Aug-2020,NEFT,"1,339.00",00.00,"374,729.84",C63a4C5e8Ef1eE9,2313,Rick,Fuentes,Bowen Inc,Rochamouth,Croatia,6175371586,122-718-7478,nmontoya@watts.info,2021-11-30,http://nash-odom.com/
22-Aug-2020,Purchase,00.00,"93,682.46","281,047.38",5D24eb6c7Ba0fBe,7342,Marilyn,Chen,Morton-Sampson,Cynthiaside,Belize,980.756.5889,337.611.5560x24375,brendaandersen@spence-galvan.com,2021-06-15,https://www.hatfield.com/
22-Aug-2020,Bill,335.70,00.00,"281,383.08",486fFC2fa54A5e7,620,Johnathan,Mcmillan,Singleton-Patterson,Melvinhaven,Tonga,001-556-002-7345x7021,(180)357-3552,ravencollins@hoover.org,2020-10-21,https://www.small.com/
22-Aug-2020,Bill,00.00,"35,172.89","246,210.20",fBE68ee9EFcCd1B,3595,Nicolas,Hood,Russell-Velez,South Vincenthaven,Estonia,+1-896-444-7307,322-274-6630,blake37@craig.biz,2021-04-21,http://www.wolfe-wood.net/
22-Aug-2020,NEFT,00.00,"24,621.02","221,589.18",eEF7ea406d36dbA,2456,Daniel,Love,"Hinton, Caldwell and Gross",Kentton,Puerto Rico,2418308843,344-618-2713,montgomerylacey@gibson-hayden.com,2021-09-03,http://www.vazquez.com/
22-Aug-2020,NEFT,00.00,"36,931.53","184,657.65",AFBd06F16e8DF6f,3955,Kent,King,"Chan, Simpson and Wiggins",South David,Malaysia,288.173.6385x5023,998.124.8877x6867,velasquezray@sloan.com,2021-11-05,https://griffin.net/
22-Aug-2020,RTGS,00.00,"92,328.83","92,328.82",aDDAeE25Cbd1feA,5037,Jessica,Khan,Flores-Casey,Lake Triciaton,Singapore,+1-890-767-8102x52793,109.664.3155x974,travismoyer@gonzalez.com,2020-02-06,https://bennett.com/
22-Aug-2020,IMPS,"39,082.70",00.00,"131,411.52",5f45710F6bebce4,6870,Eugene,Dennis,Juarez-Sheppard,Kiaramouth,Cameroon,247.914.5009,893.962.6712x1953,jackie14@stevenson-chaney.biz,2022-01-16,https://www.schmitt.com/
22-Aug-2020,Interest,16.48,00.00,"131,428.00",DDcdC5d99e78c80,2002,Jodi,Frost,Villanueva Group,Tyroneberg,Mauritius,001-000-063-3072x286,001-209-513-2574,kristiemiles@chaney-brennan.com,2020-10-23,http://www.livingston.com/
22-Aug-2020,ATM,00.00,"18,775.43","112,652.57",CdDB5Bcb91A60e7,363,Kelli,Adams,Duffy-Quinn,West Dakotaborough,Costa Rica,5232340972,+1-455-531-0276x75217,blakedunlap@bautista.com,2020-03-12,https://joseph.com/
22-Aug-2020,Debit Card,"1,001,957.00",00.00,"1,114,609.57",f41dF8Fd2aF69d5,2248,Haley,Davies,"Hendrix, Meyers and Braun",North Albertborough,Guinea-Bissau,351.505.8558x6249,001-992-635-7508x439,camachooscar@clark.com,2021-11-05,https://www.kirby.com/
22-Aug-2020,Commission,00.00,"1,114,609.57",00.00,0BcE5983C641cBe,9075,Cristian,Bullock,Reeves Inc,Hornberg,Sierra Leone,+1-332-553-8919x99073,(896)945-8038x561,antonio41@horton.info,2020-03-31,https://www.maldonado.com/
22-Aug-2020,Interest,"229,611.00",00.00,"229,611.00",B0bba4E0d0FE1DC,912,Nicole,Parker,Whitehead-Carpenter,Hernandezville,Bulgaria,+1-235-384-5758x13467,761-965-3775x62082,eproctor@cain-osborn.org,2020-01-19,https://woodard-hickman.com/
22-Aug-2020,Purchase,"21,743.97",00.00,"251,354.97",664c5ABFDc5c6DD,8623,Grace,Duarte,Hutchinson-Townsend,Franciscostad,French Southern Territories,468-498-2829x16187,1225413846,daisy89@patel.info,2021-05-02,http://www.johnston-love.org/
22-Aug-2020,Purchase,00.00,"125,677.49","125,677.48",81dcffffDB34C5c,7315,Elizabeth,Wiggins,"Duke, Logan and Craig",Jillianton,Philippines,674-984-2963,714.430.9338x4455,kristacarey@cain.com,2020-10-12,https://flynn.org/
22-Aug-2020,Purchase,272.00,00.00,"125,949.48",EE1cAaabcfebcFa,6749,Henry,Mack,"Gates, Beltran and Kramer",Yorkborough,Ethiopia,677.394.6870x4621,+1-399-265-3949x598,yangrickey@gilbert.com,2020-12-11,http://conner-vance.com/
22-Aug-2020,Debit Card,306.00,00.00,"126,255.48",35Ce298A0d4Bf21,6157,Madison,Keller,Carroll-Dougherty,North Joel,French Polynesia,+1-611-243-9495x06645,001-656-704-6946x03904,meredithmalone@buck.com,2020-06-04,https://morse.net/
22-Aug-2020,Tax,00.00,"42,085.16","84,170.32",dfb506258cfb0C9,8065,William,Fitzgerald,Wu LLC,East Kirk,Swaziland,720.396.1252,(892)103-7793x0679,ariana70@reid.net,2020-08-26,https://carney-roy.com/
22-Aug-2020,Cheque,"2,408.00",00.00,"86,578.32",B12F96Fd9FD84B0,4776,Andres,Alexander,Gaines-Silva,Lawrenceberg,Israel,+1-731-326-4061,(440)205-1691x6035,yvilla@patel.biz,2020-02-05,https://nelson.com/
22-Aug-2020,Interest,36.68,00.00,"86,615.00",DD02E0b1eaC0348,7638,Andres,Burnett,"Mcclure, Jacobson and Spence",West Lindseyborough,Mali,322.316.4153,037.100.8403x0976,rowlandhector@franklin.info,2020-12-31,http://conrad-wilcox.info/
22-Aug-2020,Purchase,59.51,00.00,"86,674.51",C7f4BdCcB76EaAF,3837,Sheri,Dominguez,"Cummings, Frazier and Leach",Jeannemouth,Peru,580-142-4205,001-547-143-6046x9853,millerbruce@fitzgerald-clay.com,2020-08-08,http://www.costa.com/
22-Aug-2020,Transfer,58.49,00.00,"86,733.00",427eC087b8aD8De,7774,Sheena,Knox,Herman LLC,North Regina,Anguilla,026.263.3719,544.904.1188x37868,mccalleric@castro.info,2020-01-22,https://peterson.com/
22-Aug-2020,Bill,"24,976.60",00.00,"111,709.60",1DA72AfCDf13e16,8063,Vernon,Daugherty,"Chapman, Phelps and Whitaker",South Shariport,United Kingdom,923-092-5499x88724,4546074907,heidifrost@andrews.com,2020-11-25,http://huber.com/
22-Aug-2020,Tax,27.00,00.00,"111,736.60",E80a2C0b1dcEBDa,3927,Beverly,Morton,Guerrero-Morrow,West Peggybury,Algeria,298-789-8903x60076,535-130-6363x04970,rjames@guerrero.com,2020-11-22,http://henderson.com/
22-Aug-2020,NEFT,00.00,"18,622.77","93,113.83",67BbA4AeC24c1df,3338,Jill,Weaver,Osborn-Conway,Port Selenaview,France,616.617.9060x9554,(697)476-0291x23078,holly76@andrade.org,2021-11-27,http://petersen.org/
22-Aug-2020,Transfer,06.00,00.00,"93,119.83",86Df56BFCc0a7CA,15,Catherine,Blackwell,"Mack, Garcia and Schaefer",Lake Seth,Dominican Republic,001-915-961-8896x5744,(310)185-3032x0974,calhounalisha@hardin.net,2021-03-30,https://barker-bishop.info/
22-Aug-2020,RTGS,04.00,00.00,"93,123.83",7ba27bAD9bc9F5c,7977,Ellen,Leach,Mueller PLC,Port Pedroview,Egypt,688.830.0429,584-099-6520,shaunbass@shields-swanson.biz,2021-08-10,https://www.padilla-lester.com/
22-Aug-2020,NEFT,00.00,"46,561.92","46,561.92",6eE86b00C91Ec4C,8715,Taylor,Buckley,Lynch Ltd,Lake Jeremyberg,Niger,714.623.2103x115,156-064-7587x812,helen11@irwin.com,2020-08-24,http://baker.org/
22-Aug-2020,ATM,"3,925.00",00.00,"50,486.92",6E1E5db6e2E3E4A,8416,Franklin,Bender,Winters-Conner,Lake Alvin,Cayman Islands,139-968-6203x9556,137-777-4244,caitlyndaniels@york-stark.info,2020-10-08,http://wiggins.com/
22-Aug-2020,IMPS,07.20,00.00,"50,494.12",757E4594a9B866B,5020,Nicholas,Case,"Dudley, Lopez and Roman",Sheliaview,Paraguay,001-383-581-0410,934.966.5958x730,sheila74@haney-reilly.biz,2020-10-20,https://www.schroeder.info/
22-Aug-2020,IMPS,00.00,"16,831.37","33,662.75",CDa47E8374AaAB4,1117,Holly,Reyes,Lynn-Joyce,Johnstonville,Turkey,(135)011-9753,(759)761-5910x49231,swansonkristie@alexander.com,2020-11-29,https://callahan-hall.com/
22-Aug-2020,IMPS,"74,284.97",00.00,"107,947.72",b7AFA72118d4ee3,4463,Larry,Gentry,"Everett, Shepherd and Brown",East Chris,Jordan,001-956-139-9094x7437,001-351-325-8476x557,kharper@moreno-holmes.com,2021-12-21,http://www.moore-holloway.info/
22-Aug-2020,ATM,00.00,"15,421.10","92,526.62",81a68a9fa7ae4c2,8964,Isaac,Johnson,"Shelton, Carter and Kline",South Hectorshire,Moldova,6045349457,+1-120-645-8149x781,sallyshields@morse.com,2020-07-27,https://www.pratt.com/
22-Aug-2020,Bill,00.00,"18,505.32","74,021.30",bD09E12d587Bf63,2761,Betty,Greer,Heath Group,Gambleside,Iceland,(299)266-6164,001-189-107-1572x339,julie40@colon.com,2021-01-28,https://goodwin-castro.com/
22-Aug-2020,Bill,06.00,00.00,"74,027.30",cdF6EaBC23a6a74,1524,Yvette,Swanson,Stanton LLC,Ramosville,Cyprus,+1-706-625-8482,487.262.9612x77342,floydhayley@salazar-wyatt.com,2021-08-12,http://pope.biz/
22-Aug-2020,Purchase,00.00,"7,402.73","66,624.57",1B3ddaa12F9DcbF,8579,Hailey,Lin,Ferguson and Sons,Simmonsview,British Virgin Islands,131-922-7230,559-328-8901,dwaynehull@russo-trujillo.org,2020-10-25,https://conner-bradford.com/
22-Aug-2020,Cash,00.00,"66,624.57",00.00,BB0ec00797C1d29,8668,Earl,Floyd,Alvarado-Warren,East Javier,Iraq,+1-513-923-1611x508,319-847-0473x921,alisha44@peters.com,2020-05-28,https://www.christian-moore.com/
22-Aug-2020,Purchase,"16,267.00",00.00,"16,267.00",aAC287d15f531C0,5975,Randall,Lyons,Mclean-Stout,Kentburgh,Tokelau,376-024-1899x0663,001-047-231-4317x468,deannablanchard@madden.info,2020-04-17,http://mora.com/
22-Aug-2020,Commission,00.00,"1,626.70","14,640.30",3FA568FCbfF04f5,5386,Lucas,Welch,Boone-Rowe,Lake Sherriberg,New Zealand,233.069.6749,+1-864-718-6409x5623,alyssa83@rich.com,2022-05-15,http://gallagher.com/
22-Aug-2020,NEFT,00.00,"1,626.70","13,013.60",a3aCDdFA3fbCe1c,5425,Faith,Cohen,"Frazier, Russell and Bridges",East Jimmymouth,Japan,+1-893-467-7354x41283,146.330.2439x19960,fhammond@huynh.com,2021-08-17,https://garrett.com/
22-Aug-2020,ATM,"2,599.60",00.00,"15,613.20",EDB60f4CA5b339F,9353,Raven,Barrera,"Tran, Atkins and Mathews",Luiston,Morocco,+1-150-995-3106x9463,(602)961-4124x248,brendarios@camacho.com,2020-08-13,http://www.brooks.com/
22-Aug-2020,Miscellaneous,"3,420.20",00.00,"19,033.40",Bcc2aB11725a6aD,5903,Jared,Dudley,Ramos PLC,Lake Grantbury,Madagascar,7561803074,584-206-7618x3144,williamsnicolas@vaughan.com,2020-06-16,http://drake.com/
22-Aug-2020,Debit Card,00.00,"4,758.35","14,275.05",F1B1C715A9fa566,3721,Anna,Lyons,House-Hill,Hoganmouth,Sweden,+1-212-067-0821x04357,2835297567,petersenclifford@huynh-robertson.com,2021-06-27,http://thompson.com/
22-Aug-2020,Reversal,00.00,"4,758.35","9,516.70",0aEdFcbdb76637c,446,Caitlyn,Cross,Bentley-Moyer,Lake Tannerstad,Solomon Islands,001-526-323-6313x65050,806.154.2363,jefferyhammond@guerra-chase.biz,2020-05-10,https://www.rivera.com/
22-Aug-2020,Cheque,00.00,"1,359.53","8,157.17",8DB35f10bba81DB,1372,Beth,Lamb,"Higgins, Dorsey and Adkins",Weeksburgh,Fiji,(894)217-3043x561,9143019199,ylindsey@mckinney-ali.com,2020-03-12,http://cruz-hudson.com/
22-Aug-2020,Commission,00.00,906.35,"7,250.82",6860624e7df4EB0,8667,Lynn,Weaver,"Ball, King and Poole",Hebertstad,Monaco,695.763.8044,575-756-8205x1847,barbara73@strickland.net,2021-11-30,https://www.norman.com/
22-Aug-2020,Debit Card,00.00,"1,450.16","5,800.66",dBCDC7D10eeA1E5,2021,Ian,Hester,"Mcdonald, Gregory and Casey",Estesbury,Holy See (Vatican City State),+1-209-931-9034x49458,001-567-428-6589x225,romeroterrance@frost.biz,2020-12-30,https://www.rodgers.org/
22-Aug-2020,Purchase,00.00,580.07,"5,220.59",A2FDdedAB4ccbaE,3464,Geoffrey,Huerta,Forbes Ltd,Levinemouth,Cuba,(904)098-1944,(827)261-8123x602,hmorgan@vasquez.org,2020-10-15,http://arnold-wilcox.com/
22-Aug-2020,Interest,00.00,"1,044.12","4,176.47",dFbC1EDEa186C2a,4782,Carrie,Merritt,Glenn-Chambers,Schaeferland,Bhutan,(018)626-6086,4738263512,latasha02@williamson.com,2020-03-10,https://www.hatfield.org/
22-Aug-2020,Miscellaneous,00.00,"4,176.47",00.00,0aee1acDdbF6d3D,3158,Catherine,Lyons,"Davila, Krause and Henry",Port Randall,Bahrain,001-249-694-1733x458,416-351-8900x246,rebekah91@hubbard-ware.org,2021-02-01,https://paul.com/
22-Aug-2020,Miscellaneous,"16,915.80",00.00,"16,915.80",899B7A9025aDebb,573,Mathew,Tucker,Rivera LLC,Henrymouth,Luxembourg,+1-807-291-0164x062,+1-153-243-2316x439,taylormartin@donovan-hendricks.info,2021-12-03,http://west.info/
22-Aug-2020,Cheque,00.00,"2,819.30","14,096.50",4Aa0DeFBCfFbADe,2247,Carly,Cabrera,"Ali, Wells and Blanchard",Copelandland,Denmark,(480)293-6769x305,(420)953-5385,zortega@cannon.info,2021-10-26,https://www.griffin.info/
22-Aug-2020,IMPS,00.00,"7,048.25","7,048.25",F64d0B3a74d7eC7,681,Cathy,Ritter,Brock-Elliott,North Vickieland,Nauru,797.207.6965x261,254-781-9423,omullins@vasquez.com,2020-05-27,https://schmitt.info/
23-Aug-2020,Purchase,"1,432.00",00.00,"8,480.25",6BA45A55aDFbDD6,1004,Robyn,Burns,Fitzgerald-Dean,South Franklin,Wallis and Futuna,(488)442-9817x071,(808)320-6815,ashlee98@acosta-lyons.com,2021-06-19,http://www.jenkins-hoffman.info/
23-Aug-2020,Miscellaneous,00.00,848.03,"7,632.22",46Ae5DcdE05fDEE,7432,Cody,Tate,"Drake, Harvey and Lindsey",New Alexandria,Tonga,+1-449-094-2244,(658)760-6593x90757,preynolds@bailey.com,2020-07-22,http://www.foster.com/
23-Aug-2020,IMPS,"1,807,354.00",00.00,"1,814,986.22",1FF8c39d5cEAC08,8933,Frank,Navarro,Guerra-Holland,Lake Joyce,Uruguay,001-874-168-4505,+1-727-172-1438x927,janice95@bonilla.info,2020-02-05,http://adams-harris.com/
23-Aug-2020,Interest,00.00,"604,995.41","1,209,990.81",eF0b0cfcDFe4C8F,9985,Jaime,Patel,Richard-Frost,Port Evelyntown,Sudan,000-256-0158,8632275982,jsandoval@weaver.com,2021-06-11,https://tanner-silva.com/
23-Aug-2020,Bill,00.00,"120,999.08","1,088,991.73",1fE2c9DfEa1bF3a,1319,Randy,Morton,"Colon, Compton and Booth",Port Carolborough,Bahrain,562.780.1287,001-568-013-2710x69644,mortonjermaine@hogan.com,2022-03-06,http://peterson-glenn.org/
23-Aug-2020,Debit Card,01.70,00.00,"1,088,993.43",066BeCcCAC62a7B,7628,Kristin,Schmidt,Richards-Cox,West Cristina,Uruguay,717-000-8643x4726,168-684-7296x611,tasha62@morse.com,2022-05-09,http://www.bird.biz/
23-Aug-2020,Reversal,00.00,"155,570.49","933,422.94",34DbfA4adFB5ccf,5112,Lacey,Mcmillan,Harrington and Sons,Port Jonathantown,El Salvador,+1-882-053-0597,+1-582-504-6971,lchambers@hurst.com,2021-05-05,http://www.hodges.com/
23-Aug-2020,Bill,00.00,"133,346.13","800,076.81",4527652Cc9c7E3B,8086,Jim,Hensley,Merritt-Moses,Levifort,British Virgin Islands,(783)623-3942x9497,+1-223-911-5707x5287,darrellpatterson@becker.biz,2022-04-15,https://www.chambers-patrick.net/
23-Aug-2020,Cash,00.00,"114,296.69","685,780.12",f177BD3D5d111b8,5598,Gabrielle,Rosario,Shepherd-Winters,Brentfurt,Isle of Man,001-155-015-7988x1612,+1-203-506-1981x292,rollinsdarin@tucker.com,2022-04-01,http://moses-hooper.com/
23-Aug-2020,Commission,00.00,"171,445.03","514,335.09",F6A181c16bA9db4,9243,Juan,Carey,Proctor Ltd,Montgomeryland,Comoros,(992)650-9776,509-260-9405x69528,carly92@rasmussen.com,2020-05-20,http://www.caldwell.info/
23-Aug-2020,ATM,28.00,00.00,"514,363.09",dae705AEC1fcbf3,3300,Richard,Reid,"Norman, Villegas and Moses",North Martha,Trinidad and Tobago,380-869-5523x173,+1-846-861-3852,kelly04@bradley.org,2020-06-25,https://www.donaldson.org/
23-Aug-2020,ATM,00.00,"73,480.44","440,882.65",77cF6E1DCA1dBCB,6207,Patrick,Hendricks,James-Brooks,Janicemouth,Kuwait,+1-742-919-4800x973,(718)570-0006x2284,wilkinsondwayne@singh.com,2020-12-04,http://www.ali-herman.net/
23-Aug-2020,NEFT,"72,005.25",00.00,"512,887.90",bdd60975F95e13f,2224,Kari,Elliott,"Mckenzie, Chase and Ortega",Warrenbury,Turkmenistan,920-459-2372x04493,0131639868,scase@krueger-ali.com,2020-03-27,http://www.bray.com/
23-Aug-2020,Transfer,01.60,00.00,"512,889.50",19B48e08DadC372,341,Jacob,Livingston,"Stokes, Brennan and Potter",Lake Natashatown,Philippines,4775965171,(685)130-9960,elaine95@kerr.com,2021-04-04,https://colon.com/
23-Aug-2020,RTGS,00.00,"56,987.72","455,901.78",0966Dc741dBD684,9328,Joe,Zamora,Becker-Conway,East Amberville,Italy,815-083-9634,1233284411,sherriochoa@benitez-munoz.com,2020-07-18,https://reese.com/
23-Aug-2020,Purchase,80.79,00.00,"455,982.57",c9B8C8D05fF5D55,3326,Howard,Bullock,Acosta-Lowery,North Sylvia,Palau,781.525.9499x206,(696)385-5993,katie94@ballard-munoz.com,2021-08-15,https://www.jennings.com/
23-Aug-2020,RTGS,00.00,"75,997.10","379,985.48",6D0f349ba77A173,5673,Clifford,Irwin,"Chavez, Hancock and Nielsen",South Markborough,Ecuador,+1-118-202-5280x5653,(330)990-8483,crystal02@aguirre-ryan.com,2021-11-12,https://myers-mitchell.com/
23-Aug-2020,Reversal,"5,277.66",00.00,"385,263.14",dcbA216fC09255E,1113,Patty,Humphrey,Sheppard-Chambers,South Javierberg,Burundi,+1-850-411-4787,1814333637,alexa87@levine-moyer.com,2020-06-26,https://leblanc.org/
23-Aug-2020,Reversal,00.00,"128,421.05","256,842.09",57DAB79F18FCe13,2551,Summer,Jensen,"Russo, Myers and Thornton",Paulastad,Qatar,(988)392-8023x8671,(408)765-1927x65252,imorrison@garner.com,2021-06-21,https://www.estes.com/
23-Aug-2020,Cash,00.00,"64,210.52","192,631.57",f8294aFE8dbD3D9,8633,Nicole,Becker,"Hamilton, Riley and Huffman",Jaimestad,Kazakhstan,(263)701-7001x475,601.814.0961x7514,acevedocalvin@frye-huynh.com,2021-01-09,https://www.ballard.com/
23-Aug-2020,RTGS,00.00,"27,518.80","165,112.77",fA9b14c46C4AC85,8714,Willie,Faulkner,Morris Inc,Lake Debra,Congo,610-045-1676x8428,+1-886-586-3243x563,mbailey@henry.com,2020-03-15,http://spencer.biz/
23-Aug-2020,ATM,271.00,00.00,"165,383.77",dFAbAcEEEEcCA1D,3356,Paul,Arias,Huber-Hudson,New Reneechester,Botswana,(506)132-8932,497.843.8753x4853,rbaldwin@spencer-mckinney.info,2020-09-20,https://salas.com/
23-Aug-2020,ATM,00.00,"55,127.92","110,255.85",8096f44BB8AD8DD,725,Patty,Dunn,"Mcdaniel, Barrett and Bond",Port Jenna,Greece,001-534-271-5631,864-365-3787x50763,qbullock@pollard.com,2020-04-06,https://www.horne.com/
23-Aug-2020,Cheque,00.00,"11,025.59","99,230.26",AcBbeCc0A66D2C1,1366,Samantha,Church,Woodard Group,North Ginashire,Holy See (Vatican City State),196-578-5878x7522,(517)947-0113,wclayton@carroll.org,2021-07-23,http://sampson-cooke.com/
23-Aug-2020,Reversal,"10,196.72",00.00,"109,426.98",15B07b57eca7dcf,8425,Micheal,Flynn,Wheeler-Sampson,Walterburgh,United States Minor Outlying Islands,(327)939-7358x324,328-273-5007,gravesariel@white.com,2021-11-19,https://donovan-odonnell.com/
23-Aug-2020,ATM,00.00,"109,426.98",00.00,39DF405BEb911f1,3318,Toni,Craig,"Rangel, Dominguez and Mcgee",Carolineshire,Congo,(745)343-9552,345.372.9844,allen95@yu.biz,2020-12-23,http://gould.com/
23-Aug-2020,Cash,"1,078.50",00.00,"1,078.50",c04F56B52D4CFB2,8545,Trevor,Cannon,Lamb Inc,West Meagan,Marshall Islands,(839)696-4426x274,001-147-213-8749,iprice@bauer.net,2021-03-15,http://west-martin.com/
23-Aug-2020,Reversal,00.00,359.50,719.00,9E4b29faac6c337,5083,Katie,Robles,Yoder-Fuller,Savannahborough,Canada,001-967-222-2585,(049)936-5341,diane42@reilly.net,2020-10-17,https://manning.com/
23-Aug-2020,Debit Card,00.00,102.71,616.29,2028eAbCcc10DBC,7071,Wyatt,Long,Bauer-Lane,Schmittfurt,Maldives,709.769.1540x511,530-998-6117x9248,holdendustin@allen.com,2020-12-13,http://blair.com/
23-Aug-2020,Bill,"16,011.00",00.00,"16,627.29",ebd25dbbdEFe520,1752,Francis,Hatfield,"Rose, Kaiser and Hinton",West Bailey,Kyrgyz Republic,(630)742-2703,+1-478-990-4022x121,nicholsjasmin@sloan.org,2022-01-29,http://snyder.info/
23-Aug-2020,Commission,00.00,"3,325.46","13,301.83",3fa9C24b27FebF1,1348,Logan,York,Cooper Ltd,Hancocktown,Guam,001-040-169-1991x756,+1-675-471-1235x49725,gmalone@meyer.biz,2020-09-13,https://mayo.com/
23-Aug-2020,Cash,00.00,"1,477.98","11,823.85",aB91ad0B4c5300b,8999,Sharon,Whitaker,"Miranda, Harris and Pope",New Bridgetberg,Saint Martin,293-323-2674,+1-517-318-9593x7542,rhodesshelley@becker.com,2020-11-18,http://donaldson.com/
23-Aug-2020,Cheque,00.00,"3,941.28","7,882.57",5109Ae18Baf4b9B,4896,Mitchell,Franklin,Calderon-Wilkinson,Santanatown,Lithuania,(962)336-0612,(702)285-9235x9147,smathews@hogan-moran.org,2022-05-20,http://leach.com/
23-Aug-2020,Cash,"3,960.92",00.00,"11,843.49",Ca492c76A52Da9F,67,Kelli,Bridges,"Black, Richardson and Sandoval",Lake Aaron,Mongolia,5657167326,220.834.4618x14578,daisyblair@walsh-holmes.org,2021-12-05,https://www.trevino.info/
23-Aug-2020,Transfer,00.00,"2,368.70","9,474.79",31A7098a3Ab99c4,2067,Kathryn,Branch,"Ritter, Hill and Summers",Christianshire,Senegal,001-055-373-1450x6116,439.136.0624,zprice@reeves-wilkinson.info,2021-01-19,http://velez.com/
23-Aug-2020,Cash,00.00,"1,353.54","8,121.25",8d9fb9A677bCDfe,4354,Alex,Hayes,Douglas-Chandler,Jensenside,Egypt,246.761.7495x53654,8221010296,karl21@mccarty-willis.info,2020-05-31,https://mcgrath-mercado.biz/
23-Aug-2020,NEFT,00.00,812.13,"7,309.12",4244D72Ab6a5c2D,988,Lynn,Booth,Morton-Petty,Geraldtown,Peru,(111)338-4918,3474514709,david48@everett.info,2021-08-29,http://kirk-zhang.com/
23-Aug-2020,NEFT,00.00,"1,044.16","6,264.96",B80dEC9Ae1CB6dC,6629,Joanne,Bishop,Drake-Cantu,East Miranda,Iceland,379-317-7415x94693,001-740-810-0746x5497,ybates@schneider.com,2022-05-03,https://mccullough.com/
23-Aug-2020,Cheque,00.00,"1,252.99","5,011.97",d3FDd664b1BAE7a,3097,Terry,Leon,"Stevens, Cooke and Stephens",North Matthewfort,Algeria,(519)367-7372x0660,(615)652-3278x6424,rachelcarroll@madden-strong.com,2020-03-08,http://www.wise.com/
23-Aug-2020,Miscellaneous,00.00,"1,002.39","4,009.58",73Ad6f9Cbe021D3,6340,Kelsey,Sawyer,"Callahan, Blake and Fuentes",Jeanland,Guatemala,001-444-313-6363x50164,001-938-075-9287,ehampton@huerta.org,2022-01-05,https://mitchell.biz/
23-Aug-2020,Interest,01.00,00.00,"4,010.58",8117ccb51bc0351,3513,Ashley,Pruitt,"Gomez, Walls and Olson",Port Zoebury,Malawi,001-000-659-8440x51897,039-025-7753x208,yesenia45@greene.net,2020-12-22,http://www.ponce.biz/
23-Aug-2020,Debit Card,"8,729.50",00.00,"12,740.08",4ccf47c0B4Ada1a,1559,Sara,Oconnell,Nichols LLC,South Cameron,Isle of Man,100-627-8054x1413,5058523655,nancylutz@cooley.com,2022-05-26,https://www.mays-bass.com/
23-Aug-2020,ATM,00.00,"6,370.04","6,370.04",4D8Bbc3f79e2cB1,6337,Lonnie,Marquez,"Ferguson, Brock and Patel",Chungberg,Comoros,001-355-443-3539x157,067.171.4242,kaylacallahan@oconnell.com,2021-03-19,http://www.hammond.com/
23-Aug-2020,Cheque,00.00,"6,370.04",00.00,5a1C556F1b9cb04,4830,Denise,Stevenson,Savage PLC,Tylerhaven,Slovakia (Slovak Republic),001-403-860-0044,001-757-011-2292x47649,wyatt05@hill.biz,2021-02-08,https://www.figueroa.org/
23-Aug-2020,NEFT,54.77,00.00,54.77,1f9B6Bc6fcC41bc,2160,Ivan,Gardner,Kennedy-Dalton,Karinamouth,Australia,261.770.3981x49432,(700)151-3217,holmesdakota@compton-rogers.com,2022-01-15,https://www.frazier.com/
23-Aug-2020,Bill,00.00,06.85,47.92,762AaDC9A3c17Bc,2725,Jon,Mccoy,"Erickson, Reid and Wolfe",West Brooke,Estonia,001-552-332-8213,+1-621-110-2708x85553,bookertyler@gross.com,2021-07-23,http://www.brown-zhang.net/
23-Aug-2020,ATM,00.00,23.96,23.96,8D6e62B960eb3E5,6089,Dawn,Crosby,Randall-Hogan,Eugeneshire,Tonga,+1-942-610-8769x16692,027-655-8278,janet51@weeks.com,2021-01-31,http://www.crosby.com/
23-Aug-2020,NEFT,"252,961.10",00.00,"252,985.06",3dAe819B0EA3f4D,1723,Chloe,Reilly,Matthews-Camacho,Lutzhaven,Bahamas,001-317-954-9043x251,001-063-031-6424,jaimeconrad@bowman-simmons.com,2021-06-08,https://madden.com/
23-Aug-2020,Reversal,00.00,"50,597.01","202,388.05",c20Ad51A7EE25eb,7269,Caroline,Villarreal,Bridges-Merritt,Melendezhaven,Thailand,(314)860-7919x3018,6472898194,curtisrowland@lambert.net,2021-08-04,https://www.dominguez.com/
23-Aug-2020,Cash,"2,795.10",00.00,"205,183.15",52FDe6b6B8a0cDe,1308,Ralph,Orr,"Flynn, Richard and Buckley",Meyermouth,Oman,+1-741-939-1850x179,549-240-8979x05631,amontoya@cruz.com,2021-11-12,https://mclean.com/
23-Aug-2020,Commission,00.00,"102,591.58","102,591.58",FeDffAcFa7B5b79,4641,Tara,Hall,Moses LLC,Contrerasburgh,Costa Rica,579-861-1629,(989)419-5924x7534,jeancarrillo@cobb-mcmillan.com,2021-03-30,https://www.mason.com/
23-Aug-2020,Debit Card,00.00,"102,591.58",00.00,A87ADB9f283fBBC,5774,Sandra,Fitzgerald,Vazquez and Sons,North Carlmouth,Taiwan,(354)535-0766x42008,4789416814,chobbs@richmond.biz,2021-01-29,https://www.ramsey.org/
23-Aug-2020,Bill,"29,662.05",00.00,"29,662.05",543B060D55adf9A,4176,Kaitlin,Andrews,Miller Group,Shawnaview,Sri Lanka,(663)576-4966x992,(926)503-0622,corypayne@conway.net,2021-01-13,http://www.woodward.com/
23-Aug-2020,Debit Card,00.00,"3,295.78","26,366.27",Eee44fD22E0B7D0,1362,Cathy,Ellison,"Wilkins, Gross and Goodman",West Perry,Svalbard & Jan Mayen Islands,001-646-827-0664,370.890.2424,mike23@merritt.com,2020-11-14,http://www.lara.com/
23-Aug-2020,Purchase,55.00,00.00,"26,421.27",4248a5584EC671b,2877,Natalie,Camacho,Mcdonald Group,South Mary,Martinique,(206)628-9654,001-323-000-5761x0056,brandon84@gilmore-lester.net,2022-01-17,https://www.hansen-vance.org/
23-Aug-2020,RTGS,"206,667.80",00.00,"233,089.07",1FCAbcf2eedbc5E,9095,Bruce,Austin,Haynes and Sons,East Joshua,Lesotho,843.938.8433x724,246.733.1666x914,claire36@rivera.com,2021-08-21,https://mcconnell.org/
23-Aug-2020,Bill,"1,658,310.00",00.00,"1,891,399.07",dc08Ba1db5Bcf55,9161,Cassandra,Ho,Hickman LLC,Janiceport,Dominican Republic,(020)707-4490,+1-029-031-6657x3590,caleb67@moran.info,2021-01-12,http://www.villarreal.com/
23-Aug-2020,RTGS,"2,385.10",00.00,"1,893,784.17",e1eb57F22b79F18,7676,Jill,Duffy,Matthews-May,North Brittney,Cook Islands,870-316-3631,247-388-4032x1971,claudiamullen@golden-dorsey.com,2021-01-28,http://www.bonilla.org/
23-Aug-2020,Commission,00.00,"631,261.39","1,262,522.78",5eDb72a05b2A31b,9071,Yvonne,Collins,"Paul, Shah and Pierce",New Dustin,Netherlands,001-077-852-5731x82409,548-977-5738x29621,allison03@herring.com,2021-06-16,https://www.sweeney.biz/
23-Aug-2020,Debit Card,06.40,00.00,"1,262,529.18",a26711e5794EAdb,5377,Michaela,Dillon,"Gutierrez, Cruz and Freeman",Lauraberg,Egypt,975-393-0290x83245,(304)406-9697x3947,kara47@mcclain.net,2021-05-10,http://www.mathews.biz/
23-Aug-2020,Debit Card,00.00,"140,281.02","1,122,248.16",bFBdC1cf26cecdF,1525,Darren,Murillo,"Martinez, Mccormick and Gilbert",Victoriaview,Kazakhstan,449.315.4450,+1-433-875-0164x46367,cassidykent@green.com,2021-05-15,http://roberson-gonzales.org/
23-Aug-2020,Commission,00.00,"374,082.72","748,165.44",46f9c1beE1e04ea,4291,Yvonne,Wise,Peck-Nguyen,Johnsonmouth,Latvia,909-324-9560,001-715-081-1134,allisondouglas@marsh-flowers.info,2021-12-03,https://salazar.com/
23-Aug-2020,Tax,00.00,"249,388.48","498,776.96",6b77bdcCA49b46A,7710,Jodi,Vega,"Pope, Mccormick and Potts",West Ethan,Singapore,080-665-9736x9961,(658)660-1176,moodybrent@todd-blair.net,2021-11-30,http://kaufman.com/
23-Aug-2020,Purchase,04.00,00.00,"498,780.96",CE70B2Bb909D00f,7323,April,Pennington,"Espinoza, Dodson and Mack",Krystalstad,American Samoa,006.638.3335x919,001-346-234-1919x472,wblevins@ashley.info,2020-07-08,http://www.koch.com/
23-Aug-2020,RTGS,176.89,00.00,"498,957.85",d7cB19c374Dbadd,4203,Jim,Gibbs,Porter-Sweeney,East Bryanshire,Cuba,2950694934,001-807-382-6357x55014,ekey@bolton-summers.com,2020-09-15,http://www.taylor.com/
23-Aug-2020,Interest,00.00,"71,279.69","427,678.16",cedcdFF5afDf58b,9017,Javier,White,Oconnell and Sons,Crawfordland,Sweden,(776)350-2671x056,001-782-122-8858x987,zachary69@burch.org,2021-06-05,http://www.fritz-moreno.com/
23-Aug-2020,Cash,00.00,"47,519.80","380,158.36",AF17Ceed1D347d8,4899,Richard,Cox,Fuller Inc,Lake Lydiamouth,Sierra Leone,362.803.6868x431,(061)978-8529,marisa51@martin.com,2020-12-17,http://www.duran.net/
23-Aug-2020,Miscellaneous,00.00,"76,031.67","304,126.69",929685f77ecba7c,2481,Jenna,Maldonado,"Sandoval, Orozco and Hines",East Wyatt,Mozambique,0989799734,(474)377-8546x7640,dmckenzie@wood.com,2020-04-06,http://www.barr.com/
23-Aug-2020,Miscellaneous,00.00,"43,446.67","260,680.02",Ba0BCdd5AAd0116,3350,Marisa,Sherman,Aguirre Inc,Littleside,Guam,083.324.4044,478.614.1773,kent43@booker.com,2022-05-23,http://www.silva.org/
24-Aug-2020,Tax,"1,086,041.00",00.00,"1,346,721.02",5C9d23EEfcF05F3,5453,Alisha,Leach,"Stafford, Gibbs and Stanton",Terrymouth,Belize,+1-342-925-6404,(670)763-8888,vaughnjade@oliver-petty.net,2020-05-29,https://www.carr.net/
24-Aug-2020,Bill,497.06,00.00,"1,347,218.08",eF41DcC56c4E96E,5624,Marissa,Lawson,Stanley-Good,Markshaven,Liberia,(761)376-9572,6606960758,pamela02@gibson.com,2020-08-06,http://www.morris.biz/
24-Aug-2020,Transfer,00.00,"134,721.81","1,212,496.27",ebC4De12FAde3Ad,6523,Harold,Kline,"Bentley, Mckee and Ford",Olivialand,Gabon,001-536-548-7402,(427)121-8236x93734,mark60@beasley.org,2020-03-24,http://barrett-downs.com/
24-Aug-2020,Cheque,00.00,"151,562.03","1,060,934.24",7fe381D16fDFbdC,8554,Cassidy,Huff,Boyer-Fisher,Desireebury,Nepal,498-496-1543,001-418-521-2049x8125,cannonshane@ritter.com,2020-07-28,http://roy.com/
24-Aug-2020,Transfer,"1,846.56",00.00,"1,062,780.80",a7EEA9653B26f7A,1490,Dakota,Beltran,Rhodes Ltd,Jaredberg,Chile,7406557525,+1-827-770-4844x72130,kathleen80@fernandez-noble.org,2021-12-03,https://www.david-clarke.com/
24-Aug-2020,Debit Card,"631,472.00",00.00,"1,694,252.80",CfD1afBA1215bA7,4288,Jasmin,Burke,"Murray, Lane and Perez",Cheyennebury,Benin,(950)446-2339x2069,(141)485-3653x62925,mercedes09@todd-acevedo.com,2020-07-22,http://www.oliver.org/
24-Aug-2020,Purchase,"15,629.00",00.00,"1,709,881.80",bE00d844431Eee3,5568,Lonnie,Mccormick,"Schwartz, Beck and Carr",Carrollchester,United States of America,545-882-5871,861-342-8132x85593,bill74@jarvis-dunn.com,2021-06-18,http://cooke-horton.com/
24-Aug-2020,IMPS,"174,734.70",00.00,"1,884,616.50",72bAfd3bacbd3Da,8919,Debbie,Hurley,Bowman PLC,Joneshaven,Myanmar,(131)846-4194,275.865.9682,lebob@fleming.com,2020-08-26,http://www.norton-acevedo.net/
24-Aug-2020,Cheque,26.90,00.00,"1,884,643.40",CD44F2F9C452Ed0,7697,Lorraine,Greer,"Becker, Pruitt and Mullen",Doughertymouth,Vietnam,310.088.8923x5660,001-437-883-3848x8959,hailey04@singh.org,2020-10-23,http://jackson-vance.net/
24-Aug-2020,Cash,274.70,00.00,"1,884,918.10",Aa93B2ef1fdCB80,9754,Martin,Wagner,Mullins-Olsen,Port Tristan,Norfolk Island,(666)360-2604x5646,2686075516,changmark@robertson.info,2022-03-24,http://lynn-beard.net/
24-Aug-2020,Purchase,15.20,00.00,"1,884,933.30",22FDb2Bacf1dd1E,6133,Brianna,Galloway,Rowland-Mcdaniel,Ianfort,Jamaica,(621)392-4337x346,965-565-0800,jbuchanan@coleman.biz,2021-07-20,https://www.floyd-moore.com/
24-Aug-2020,RTGS,00.00,"188,493.33","1,696,439.97",FEfC56aEeFD575d,5898,Charlotte,Escobar,Mullen PLC,Lake Marissamouth,Switzerland,534.998.5416,4754829550,frobles@rhodes-gamble.com,2020-01-23,http://hanson.com/
24-Aug-2020,ATM,00.00,"565,479.99","1,130,959.98",1c98Da1cbab2Ff9,2289,Brianna,Levine,Mathis-Mckee,East Tara,Poland,001-699-245-3788x9827,001-843-129-8436x0172,plindsey@ballard-case.info,2021-04-14,https://www.reyes-floyd.com/
24-Aug-2020,Reversal,"74,038.72",00.00,"1,204,998.70",8B79dF5b2C91Ef8,2868,Henry,Valdez,Scott PLC,Gregville,United Kingdom,(072)411-0588x6943,+1-240-576-5180,lbolton@andersen.net,2020-10-02,https://dudley.com/
24-Aug-2020,ATM,00.00,"172,142.67","1,032,856.03",35f3857043d7CFf,7573,Thomas,Marsh,Roth LLC,Blackwellhaven,Lesotho,+1-864-269-7968x1794,929.512.7107,arroyophilip@fleming.info,2020-08-17,https://www.cruz.com/
24-Aug-2020,Miscellaneous,"86,627.00",00.00,"1,119,483.03",6E5DABCBb2ABfA4,4355,Kenneth,Reid,Dawson-Herrera,Port Karen,Belarus,359.174.2570,718.019.0814x0956,paula22@nielsen.com,2021-10-22,http://lucero.net/
24-Aug-2020,Tax,00.00,"1,119,483.03",00.00,4ab7e95A7B9cFC0,9567,Kara,Boyer,Gamble and Sons,Merrittview,Norway,(195)073-2278x746,+1-931-774-1860x21209,vpugh@francis.info,2021-04-05,https://salazar.com/
25-Aug-2020,RTGS,"3,364.10",00.00,"3,364.10",a8a2B4e499C210A,1696,Jo,Woodward,Horne and Sons,Lake Kerrifurt,Timor-Leste,001-752-057-6655x568,292-933-7318,marvinstuart@jacobs.org,2021-12-19,https://bass-vaughan.com/
25-Aug-2020,Transfer,00.00,420.51,"2,943.59",998370d4f5DdBfc,8902,Reginald,Pacheco,"Kent, Garrison and Briggs",Cruzville,Austria,3836063976,280.306.5592x4555,iwatts@rowland.com,2021-10-23,http://french.info/
26-Aug-2020,Interest,"10,699.78",00.00,"13,643.37",4F1deABbaB7CdC2,7253,Wyatt,Villegas,Hanson Ltd,Blackburntown,Faroe Islands,+1-289-389-5304x7147,390.019.1646x8160,lutzclinton@livingston.com,2020-10-01,https://woods-dominguez.net/
26-Aug-2020,Tax,00.00,"1,705.42","11,937.95",1e43bbC6DBdC4Bc,9172,Mindy,Horn,Cross Ltd,Gibsonhaven,Belgium,298-313-0078x414,9042265912,cchase@rangel-donaldson.info,2022-04-15,https://www.wade-ortiz.biz/
26-Aug-2020,RTGS,00.00,"1,492.24","10,445.71",52a2CAFAad429eF,4988,Mark,Stein,"Bailey, Hanna and Webster",Angelicamouth,Botswana,830-169-0995,(591)263-3077x7940,barberelijah@cameron-harvey.biz,2021-01-22,https://nixon.com/
26-Aug-2020,RTGS,00.00,"1,160.63","9,285.08",C5EBbE976cDa63B,8083,Ana,Yu,"Winters, Holmes and Jones",South Angiefurt,Namibia,125.010.8339,(206)401-7441,mcguirelee@lowery.biz,2020-08-29,http://gardner.com/
26-Aug-2020,Purchase,00.00,"1,857.02","7,428.06",d73292Bb8b48100,7762,Caitlin,Mason,"Hanson, Medina and Monroe",West Jimmy,Macao,001-364-342-6085x59890,284-337-7044x84971,stuartbridges@shelton.org,2021-12-08,https://www.singh-andrade.com/
26-Aug-2020,NEFT,00.00,"1,238.01","6,190.05",a69FE7b7Bff9DE4,7611,Charles,Ibarra,"Buck, Travis and Kent",North Catherinemouth,Uzbekistan,587-944-5718,980-889-2048x349,calhounalejandra@silva.com,2020-04-04,http://fitzgerald.biz/
26-Aug-2020,RTGS,00.00,"1,031.68","5,158.38",C3Fd307ca1bAdEa,6723,Sheila,Cardenas,"Bird, Gamble and Mcguire",East Maxwelltown,Poland,(038)466-0435x48397,926.647.4233x3279,nancypetty@fletcher.com,2021-02-22,https://mcintosh.com/
26-Aug-2020,Purchase,"1,098.20",00.00,"6,256.58",2bDD58D1f444eCb,9683,Randy,Pope,Jones Group,Laneburgh,Myanmar,491.374.9325x63663,946.086.6309x36640,kaylalambert@roberson.com,2020-12-08,http://bray-mcmahon.biz/
26-Aug-2020,Cash,00.00,"1,251.32","5,005.26",dE5f3e1D10dB80b,9664,Chelsey,Hartman,Hogan LLC,Huffburgh,Suriname,+1-447-360-8396,560-339-9674x04544,erojas@meyers-savage.com,2020-07-15,https://james.com/
26-Aug-2020,Interest,46.20,00.00,"5,051.46",1b2ADA1EBbaaa2F,6038,Angelica,Shah,Salinas and Sons,South Cliffordbury,Norfolk Island,922.729.3515,(975)310-7454,alejandro48@graham.info,2020-07-07,http://willis-brooks.info/
26-Aug-2020,NEFT,"3,871.60",00.00,"8,923.06",380f4DdDC06fa82,2424,Grant,Snyder,Buckley LLC,Mortonmouth,Ecuador,006.798.9180x5770,689.541.4149x06592,breweredgar@aguirre.com,2021-02-01,https://krause.info/
26-Aug-2020,Debit Card,00.00,"1,784.61","7,138.45",e921CB5e5ccB0fe,6394,Barry,Sellers,Byrd and Sons,Bartlettside,Vanuatu,(231)198-5870x6531,001-430-580-4999x516,cynthiablack@walter.com,2020-12-15,https://www.espinoza.com/
26-Aug-2020,ATM,00.00,713.85,"6,424.60",bf2892bfd7bbeEE,4590,Terry,Thornton,Crosby-Brown,Nicholasland,Albania,756.500.9868x463,197.710.2449,franklin29@mccann.com,2020-05-04,https://castro-levine.org/
27-Aug-2020,Transfer,329.60,00.00,"6,754.20",2EBd9B32c0BafF1,9030,Samuel,Flores,Friedman-Mack,Ashleyland,Seychelles,001-264-663-6201x598,(271)151-0862x513,gloveradrienne@stanley.com,2020-06-28,https://ball-carter.org/
27-Aug-2020,NEFT,00.00,"1,125.70","5,628.50",E0F9b44beaB3cA8,8347,Loretta,Young,Moore-Mora,Erikaside,Liechtenstein,972.365.6925x28848,917.669.4653x988,zgallagher@gross.com,2022-01-03,https://hopkins.org/
27-Aug-2020,Tax,"32,651.54",00.00,"38,280.04",2D9FD3aC63Fb117,5949,Jane,Henry,Santana PLC,Owenstad,Maldives,(362)073-5714,(567)279-4241,bartletttim@glenn.info,2020-08-03,https://clay.com/
27-Aug-2020,ATM,44.00,00.00,"38,324.04",CedEF89c8fB6988,4357,Leslie,Richards,"Kim, Kelly and Freeman",Shafferfort,Morocco,436-977-0122,001-818-338-9698x28948,cameron42@gamble.net,2021-02-17,http://franklin.com/
27-Aug-2020,ATM,01.24,00.00,"38,325.28",3aE736eebEC66d1,6382,Elaine,Richmond,Mccullough-Dean,Quinnfurt,Georgia,042.839.7938,(612)170-6561x40803,wandamcconnell@hines-cole.com,2021-11-02,https://www.rivera-trujillo.org/
27-Aug-2020,Commission,00.00,"12,775.09","25,550.19",ED51f690ecdAA1f,4807,Kenneth,Bennett,"Mathis, Spence and Davila",Lake Randall,Fiji,001-082-248-9881x89828,856-094-2917,ibarrakendra@rush-leonard.org,2020-07-31,http://moody.org/
27-Aug-2020,IMPS,00.00,"2,838.91","22,711.28",761cD254af2510b,9749,Alvin,Stanley,Dominguez Ltd,East Francismouth,Romania,(632)233-9387x7068,(151)673-6114x437,jesse17@villa.com,2022-01-16,http://barker.info/
27-Aug-2020,NEFT,887.03,00.00,"23,598.31",a3B38aD7ceF9c26,5511,Shawn,Bolton,"Michael, Mccann and Mayo",Hufffurt,India,657.467.6122x85402,304-095-4260,nrasmussen@cantrell.info,2021-12-31,http://davenport-vargas.org/
27-Aug-2020,ATM,"70,759.00",00.00,"94,357.31",cacaD68a5e4BF4b,9,Bruce,Payne,"Arroyo, Cain and Hudson",Barrettview,Zimbabwe,391.313.4649x42910,166.227.5055,mayerjerome@hurst-graham.net,2020-11-26,https://www.glenn-snow.com/
27-Aug-2020,Miscellaneous,00.00,"10,484.15","83,873.16",Ca83aa93393309B,3470,Brandy,Weeks,Chen-Atkins,New Darylville,Oman,+1-398-016-8211,156.667.7689x9032,brookechapman@roberson.com,2021-09-11,http://grimes-frederick.com/
27-Aug-2020,Miscellaneous,06.00,00.00,"83,879.16",aF2F7d88788cc7E,8605,Daniel,Neal,"Merritt, Little and Potts",Leefort,Albania,2395655515,+1-893-727-8174x7692,derek31@parrish.biz,2021-03-14,http://gilmore.net/
27-Aug-2020,Miscellaneous,00.00,"10,484.90","73,394.26",10dAcafEBbA5FcA,2,Kristina,Ferrell,"Horn, Shepard and Watson",Aaronville,Andorra,932-062-1802,(209)172-7124x3651,xreese@hall-donovan.com,2020-04-27,https://tyler-pugh.info/
27-Aug-2020,Cheque,"134,526.00",00.00,"207,920.26",06a1777505E1AC6,8503,Lee,Griffin,Buchanan-Harvey,Port Tracie,British Indian Ocean Territory (Chagos Archipelago),847-365-0670x84225,(165)778-9288x040,peggy97@cunningham-stephens.com,2022-04-22,https://www.weaver.com/
27-Aug-2020,Interest,232.00,00.00,"208,152.26",fcd66fD4Ce91C0F,2073,Joseph,Cross,Bright Ltd,Greerchester,Nepal,(654)080-3534x02763,080-286-4608,sharon01@forbes-good.biz,2020-01-28,http://www.berg.com/
27-Aug-2020,NEFT,00.00,"26,019.03","182,133.23",AAf49FcB8DD5FF7,9706,Mariah,Holmes,Rubio Group,South Calvin,Tuvalu,(143)609-4524x13535,167.853.6773x892,velazquezglenda@mahoney.com,2020-04-20,https://www.harris.org/
27-Aug-2020,IMPS,00.00,"26,019.03","156,114.20",b52146EeE2ffdf7,2431,Brittany,Nelson,Choi and Sons,Michaelton,Denmark,773.512.0983x90656,+1-490-384-9488x7362,rhawkins@griffin-hancock.net,2022-01-02,https://www.murphy.com/
27-Aug-2020,RTGS,00.00,"19,514.28","136,599.93",B2A4fEc9fa4FC39,2773,Bill,Andrade,Morrison-Parks,Port Theresahaven,Holy See (Vatican City State),049-239-6225x9348,001-527-193-6094,tbaird@peters-valdez.com,2020-03-13,http://mason.com/
27-Aug-2020,Miscellaneous,00.00,"15,177.77","121,422.16",A8205E5c66709D5,53,Roy,West,Finley Group,East Kaitlynfort,Micronesia,953.571.7565,001-400-483-7933,mbonilla@hampton.com,2020-01-22,https://www.lindsey.org/
27-Aug-2020,Cash,37.10,00.00,"121,459.26",bA1BD3DcFE52FE2,4070,Anthony,Duke,"Odonnell, Monroe and Farley",East Robertshire,Tuvalu,533-465-3222,(484)849-3635,barajasluke@jensen-mays.info,2021-08-22,http://www.ellison.org/
27-Aug-2020,Transfer,51.90,00.00,"121,511.16",f8eCAC5d746CfE3,8811,Ebony,Andrews,Patrick Ltd,New Jenniferport,Jordan,001-479-640-1721x42340,8508669531,karimeyer@goodman-spears.com,2021-04-06,https://mckee.com/
27-Aug-2020,Purchase,"977,896.00",00.00,"1,099,407.16",Cb1adf8F4D77aDf,5407,Teresa,Sparks,Gray-Walls,West Aaron,Sierra Leone,868-979-0906x68940,(711)497-8794x665,zshepard@french.com,2020-11-09,http://bender-tapia.com/
27-Aug-2020,ATM,"112,202.47",00.00,"1,211,609.63",ef968C34824a798,2288,Sonya,Waters,Beard Ltd,Lake Mindy,El Salvador,127.286.1543x951,793-717-7460x10002,jo58@hanson.com,2021-09-22,https://www.webster-hudson.info/
27-Aug-2020,RTGS,"5,812.60",00.00,"1,217,422.23",9CdA4fcbADED63e,4795,Daryl,Contreras,Mccarthy-Hopkins,Port Phillip,Northern Mariana Islands,716.629.6931x003,001-327-640-0015x317,gallowaychristian@norris.com,2021-03-22,https://buck.com/
27-Aug-2020,ATM,00.00,"608,711.12","608,711.12",83F0B1D11A63aEB,7284,Ellen,Mcintosh,"Schroeder, Ramirez and Parker",Cynthiastad,Croatia,001-443-067-2044x65930,+1-051-015-0774x924,mullinstyrone@henry-weber.com,2020-06-06,https://www.winters.com/
27-Aug-2020,Interest,87.00,00.00,"608,798.12",bdaf74CcEDC5A6B,2047,Gene,Glenn,Cardenas LLC,New Jacobton,British Virgin Islands,(639)185-5188x9405,+1-159-591-3729x1462,leroy68@farley.net,2022-02-08,https://www.jenkins.info/
27-Aug-2020,Miscellaneous,"281,350.80",00.00,"890,148.92",BAc29cf4B74C6Ba,3133,Devon,Gentry,Mata-Hancock,New Gail,Malaysia,568.744.6775x46977,(814)325-4575,arellanowalter@flowers.com,2022-04-26,https://www.marks.info/
27-Aug-2020,Debit Card,00.00,"445,074.46","445,074.46",3abB55cBE69EC5B,7474,Gail,Washington,Fitzgerald-Dudley,Port Tyler,Northern Mariana Islands,794.255.2146x62892,6278389753,lorraine91@benton-steele.com,2020-06-11,https://miller.com/
27-Aug-2020,Tax,"363,356.00",00.00,"808,430.46",2E2248a23f853E5,8360,Jesus,Rosario,Andrews-Walker,East Beverlyville,Tokelau,348-505-3775x2174,001-257-721-9913,renee50@villarreal.com,2020-10-06,https://www.miranda.org/
27-Aug-2020,Cheque,00.00,"80,843.05","727,587.41",C1af618aaBD782B,4765,Cory,Hunter,Roach Ltd,East Christiefurt,Norway,+1-340-869-8950x9018,001-524-240-8840x059,frederick91@lucero.com,2020-05-20,http://www.cantrell.com/
27-Aug-2020,Cash,00.00,"181,896.85","545,690.56",BC4E5ded790cf5B,4223,Traci,Hendrix,"Matthews, Medina and Fowler",West Hunterchester,Haiti,(539)846-0835,323-838-2618x7724,osanders@trevino-mora.com,2020-05-26,http://www.ross-beck.com/
27-Aug-2020,Commission,"95,879.90",00.00,"641,570.46",1aD2deA0fde50BA,355,Joan,Gregory,Hartman Inc,Port Kylieville,Korea,305.639.5002,453.485.8642,xvang@schmidt.com,2020-11-01,http://blanchard.biz/
27-Aug-2020,Miscellaneous,"18,525.99",00.00,"660,096.45",faE2C52D8BFEC4a,7870,Sherry,Mitchell,Vance Ltd,Alvaradofort,South Georgia and the South Sandwich Islands,+1-303-952-9934x8850,(334)780-0113,eddie50@huff-juarez.com,2021-10-06,http://barr.com/
27-Aug-2020,Transfer,"3,077.00",00.00,"663,173.45",aB2DF335fBDBecF,8127,Ray,Lynn,"Russell, Drake and Chung",Hardinchester,American Samoa,879.938.8706x029,+1-090-708-9866x67442,zhale@horton-jimenez.com,2020-06-20,https://www.clarke-mercer.org/
28-Aug-2020,Tax,227.40,00.00,"663,400.85",ea556ADC10dF0a5,7448,Roger,Brock,Buck LLC,Hurleyborough,Sudan,+1-695-744-6323x735,(957)488-4866x0104,terrihodges@braun.com,2022-05-05,http://www.king.biz/
28-Aug-2020,Purchase,00.00,"165,850.21","497,550.64",2d47defdb02DF9B,1408,Emma,Montoya,Jones-Valencia,East Joseph,Greenland,001-735-199-6461x123,073.146.5603x765,wshaw@walton.com,2020-06-28,http://rose.info/
28-Aug-2020,Interest,00.00,"82,925.11","414,625.53",8D2c6a15DA9bCe6,3739,Kenneth,Floyd,"Gibbs, Welch and Cooley",Brentfort,Dominica,+1-061-203-2516x52068,733-548-8620,franklin16@davies-larson.com,2021-06-07,https://www.hanna.info/
28-Aug-2020,Cash,00.60,00.00,"414,626.13",08CEEAC431eBE1C,2737,Dana,Murillo,Rangel-Macias,Mcleanburgh,Netherlands,692.401.0647,404-951-1881x9114,riveraclifford@watts.biz,2020-10-13,https://lozano.net/
28-Aug-2020,Reversal,00.00,"46,069.57","368,556.56",56E59a329aeD29e,4667,Caitlin,Freeman,Fischer and Sons,Brooksborough,Saint Kitts and Nevis,(329)148-1088x24852,553.353.7942x404,rreilly@church.com,2020-08-28,https://www.duffy.com/
28-Aug-2020,NEFT,00.00,"46,069.57","322,486.99",fA2Ac4C6a1e9cEd,9529,Terri,Knapp,Peterson-Hoffman,Pattonmouth,San Marino,(000)575-1644,001-919-710-8180,bradymora@esparza-gill.net,2020-01-02,http://www.pena.info/
28-Aug-2020,Reversal,00.00,"107,495.66","214,991.33",FDA733eEc39bef2,7091,Mathew,Franklin,Carrillo-Daniel,Port Kayleefurt,Peru,(119)882-3338x84765,673.121.3093x704,ydickerson@gentry-brock.com,2020-08-22,http://harrison-wagner.biz/
28-Aug-2020,Interest,00.00,"53,747.83","161,243.50",E1B93b7cE3Cc48B,4759,Douglas,King,"Brooks, Collins and Holmes",Nashshire,Malawi,477-391-9324x2330,556.366.5837x57181,meghanoconnell@meza.org,2020-12-22,https://www.cortez-mcpherson.com/
28-Aug-2020,RTGS,00.00,"17,915.94","143,327.56",Aaddb77cDbA6dFf,1026,Parker,Macdonald,Hammond-Schroeder,Taylorport,Gibraltar,+1-768-914-5114,004-831-5646,kylie72@payne.com,2021-10-14,http://rivas.com/
29-Aug-2020,IMPS,00.00,"71,663.78","71,663.78",71ddadEfB8ce6cf,9506,Carl,Ray,Stafford-Figueroa,West Summer,Chad,+1-625-385-1844x180,001-464-130-7168,benjaminkim@holder-blake.com,2020-02-07,https://www.huffman-wilcox.com/
29-Aug-2020,Debit Card,44.00,00.00,"71,707.78",147ea12Fbac36F4,5279,Lori,Harding,"Day, Prince and Petersen",Port Glenn,Aruba,(131)893-8633,5215492547,msantos@owens-reid.org,2020-04-25,https://www.phelps-schmitt.com/
29-Aug-2020,Bill,00.00,"17,926.95","53,780.84",f6ebaafaA5e23BB,5566,Rebekah,Salazar,"Meadows, Koch and Baker",West Kevin,Falkland Islands (Malvinas),+1-780-476-2431,325.994.8061,camerondawn@huffman.com,2020-02-16,http://peck.info/
29-Aug-2020,NEFT,193.74,00.00,"53,974.58",4EA04B80A5fc7fD,8642,Jacqueline,George,Murphy Ltd,Stacyport,Cameroon,273-598-2082,(849)313-1804,megancraig@bowen.com,2021-03-21,http://www.brandt.com/
29-Aug-2020,Debit Card,"42,941.40",00.00,"96,915.98",08D5DeAEd67321d,1666,Dwayne,Wheeler,"Cooke, Walls and Blair",Lake Yvetteport,British Indian Ocean Territory (Chagos Archipelago),573-999-7446,(235)194-7064,jennifer64@church.com,2020-02-09,https://vaughan.org/
29-Aug-2020,Purchase,"1,491,531.00",00.00,"1,588,446.98",7830fDDeB2394FD,7450,Gary,Pollard,Richards-Sosa,Candacefurt,Russian Federation,2312035566,467-115-8736x46087,billysantos@dawson.net,2021-04-11,https://www.english-moreno.info/
29-Aug-2020,Cash,"3,716.50",00.00,"1,592,163.48",F23FB38aFc8ccdE,2763,Alejandra,Rush,"Dyer, Brennan and Fox",Matthewtown,Central African Republic,001-707-059-5715x742,750-201-9438,billarroyo@nielsen.com,2020-08-17,http://www.mckinney-mcclain.biz/
29-Aug-2020,Bill,00.00,"176,907.05","1,415,256.43",BC8Cbf2AeD7EF0b,6745,Ian,Ramsey,Hickman-Cross,New Kathleentown,Tuvalu,(055)954-9609x77967,564-854-6123,zamoragabrielle@forbes-barber.net,2020-08-05,http://www.oliver.com/
29-Aug-2020,RTGS,00.00,"1,415,256.43",00.00,39AfAab3dEf0cc5,5036,Tammie,Glenn,"Petty, Franco and Oconnell",Susanstad,Bahrain,(467)659-0848,860-606-6266x3708,jane10@west-stone.biz,2020-11-23,http://www.cain.com/
29-Aug-2020,Debit Card,"223,474.00",00.00,"223,474.00",AD7C2eF1Fcec3a9,8201,Mitchell,Watkins,Waters-Bullock,North Randy,Nauru,(020)730-3990x778,001-817-359-0727x2575,hinesfaith@salas.org,2021-03-26,http://silva.org/
29-Aug-2020,Commission,"10,931.00",00.00,"234,405.00",38D4ED7aE1be4d1,3449,Emma,Fischer,"Cordova, Beasley and Mckee",New Coleton,Falkland Islands (Malvinas),186.637.7295,(881)751-1064x725,joshua48@mcclure.com,2021-04-30,https://www.mclean.com/
29-Aug-2020,Interest,00.00,"234,405.00",00.00,3FBeABF4e0DF6B3,1228,Anita,Dickerson,"Hensley, Tanner and Mcneil",Carlsonchester,Russian Federation,+1-632-068-2455x9686,001-297-426-0190x0529,glennwarren@stone.com,2020-02-01,https://www.rasmussen.com/
29-Aug-2020,Transfer,31.00,00.00,31.00,eE718cdA1CCaA91,6195,Bradley,Clayton,Ramos Inc,Barberstad,Luxembourg,360.797.7453x7457,5987632252,mcclurejoel@hubbard-lawson.info,2021-01-14,https://www.ferguson.com/
29-Aug-2020,Commission,00.00,04.43,26.57,039Da58df1aEC3c,1343,Annette,Arnold,"Trevino, Knox and Salazar",Sherrymouth,Guadeloupe,516-776-5797x17107,773-466-1205x8708,jblevins@potts-wilkerson.com,2021-11-06,http://glover.com/
29-Aug-2020,Transfer,"1,714,731.00",00.00,"1,714,757.57",f2460BC1CE7Fc41,4447,Victor,Lindsey,Lowery PLC,Lake Joe,Hungary,302-662-4012,945.381.5443,santosdamon@house.biz,2022-05-06,https://www.burgess.biz/
29-Aug-2020,Interest,"3,091.56",00.00,"1,717,849.13",7B4F36a6219AC88,1290,Aaron,Fritz,Lawson-Stanton,Carlyburgh,Bangladesh,001-501-747-1945,(086)859-5884,pollardkirk@french-rios.org,2020-10-05,https://singh.net/
29-Aug-2020,Transfer,"20,652.90",00.00,"1,738,502.03",aB883abf8BFD23b,7421,Ross,Valentine,"Dunlap, Hicks and Rogers",Stewartville,Sri Lanka,001-074-691-9670x179,658-806-7782x0931,rhonda66@green.com,2020-05-07,http://www.franco.com/
29-Aug-2020,Transfer,"1,635.00",00.00,"1,740,137.03",fbFCe3bEf074Ac1,5420,Robyn,Noble,Shields-Ball,Juliefurt,Oman,161-501-0848x12007,096-587-3193x699,brandon00@soto.com,2022-01-10,http://www.rice.org/
29-Aug-2020,Purchase,00.00,"1,740,137.03",00.00,Fd9CafEc035bCfB,8428,Cody,Blake,Randall Group,Bonillabury,Brunei Darussalam,9837682616,+1-789-923-1094,umeza@ryan.org,2020-02-22,https://www.marquez.info/
29-Aug-2020,Purchase,503.59,00.00,503.59,9AeB0cd91C1cABB,5163,Cameron,Hardin,"Simmons, Cabrera and Johnson",Lake Emilystad,Mali,184-641-2858,(329)130-7515,reeseshelly@travis.info,2021-03-15,https://www.dominguez.com/
29-Aug-2020,Bill,00.00,50.36,453.23,43b624ad3BEB86F,7960,Toni,Hester,Gonzales-Arias,Carsonland,Saint Pierre and Miquelon,001-580-863-3359x4420,001-670-919-4323x47851,rowlandsandy@schwartz.com,2020-12-19,https://www.woodard.com/
29-Aug-2020,Commission,00.00,151.08,302.15,bfb8a8b41ddc8F9,7263,Rick,Schroeder,Kim-Galloway,Barrerafort,Iraq,(915)920-8541x597,588.004.7147x182,shelia91@frye-arellano.org,2022-01-25,https://www.mathis-ayala.com/
29-Aug-2020,Purchase,00.00,50.36,251.79,46Ae5DcdE05fDEE,7432,Cody,Tate,"Drake, Harvey and Lindsey",New Alexandria,Tonga,+1-449-094-2244,(658)760-6593x90757,preynolds@bailey.com,2020-07-22,http://www.foster.com/
29-Aug-2020,Interest,00.00,41.97,209.82,35f3857043d7CFf,7573,Thomas,Marsh,Roth LLC,Blackwellhaven,Lesotho,+1-864-269-7968x1794,929.512.7107,arroyophilip@fleming.info,2020-08-17,https://www.cruz.com/
29-Aug-2020,RTGS,00.00,29.97,179.85,69c0Abbba9c1CFC,5433,Oscar,Fletcher,Avila-Barrera,Jesseton,Burkina Faso,(098)116-4019x187,+1-631-034-4825x362,evelyn37@shah.com,2021-07-28,http://www.higgins.com/
29-Aug-2020,Bill,00.00,17.99,161.86,CED37cEFE1CA5aE,8026,Stacie,Cunningham,Washington-Lynn,North Ruthmouth,Venezuela,112.991.1808x11810,001-590-699-4059,nparks@santana-villanueva.org,2021-07-18,http://houston-bruce.com/
30-Aug-2020,RTGS,00.00,26.98,134.88,aB3E8f98Db33FbC,864,Angelica,Drake,"Washington, Ho and Schaefer",New Elizabethport,Tanzania,(794)712-2326,446.079.2122x50972,haysdustin@farmer.com,2020-10-12,http://pennington.com/
30-Aug-2020,Cheque,00.00,19.27,115.61,d1aCDbfCf97c12b,6706,Kerri,Meyers,Vang-Shaw,Tuckertown,Guinea,001-856-091-2956x52587,606.040.0420x012,myu@cox.com,2022-05-06,https://shah.com/
30-Aug-2020,Cheque,00.00,57.81,57.80,d59AfC9b255Aa8b,1672,Adam,Garrison,Clayton Ltd,West Stacie,Bermuda,001-822-021-0681x78994,001-059-304-7143,yhardy@watts-hayes.info,2020-08-10,http://sawyer-booth.com/
30-Aug-2020,Interest,04.30,00.00,62.10,BD54bAb8092a043,2779,Beth,Schmidt,Reynolds-Chase,Austinberg,Vanuatu,924-010-9732x93574,775.476.3705,frances15@frank.biz,2022-05-27,https://gilmore.com/
30-Aug-2020,Cash,09.00,00.00,71.10,18EC22b40be4f24,8030,Isabel,Humphrey,Vance-Ford,West Kathryn,Russian Federation,089-851-2862x322,9737557872,curtisalexandra@vasquez.com,2020-09-22,http://www.bender.org/
30-Aug-2020,Commission,"82,053.30",00.00,"82,124.40",3724f3906248BA6,6592,Jennifer,Garner,Cannon Group,Lake Jon,Comoros,552.632.1812,001-999-663-0470x92372,cchandler@andrews.com,2021-02-23,http://rangel.com/
30-Aug-2020,RTGS,"92,237.06",00.00,"174,361.46",A65794a9ABa4A04,8832,Taylor,Cline,"Shaffer, Serrano and Schultz",Michaelaview,Guam,(457)300-1166x9980,001-205-881-0958x3191,robertsonsteve@petty.biz,2021-07-02,https://lowe-shepherd.net/
30-Aug-2020,Commission,"877,120.00",00.00,"1,051,481.46",97e39Adf972722F,3552,Shawn,Day,Delacruz-Lloyd,Reillybury,Venezuela,+1-393-938-4080x49649,525.174.9514x2368,shahevelyn@ware.org,2020-02-01,https://hess.com/
30-Aug-2020,Tax,202.00,00.00,"1,051,683.46",c98E6cb1BcbE2a1,9748,Yvette,Estes,Cuevas LLC,Miahaven,Kazakhstan,(256)265-7057x849,(280)322-1933x10035,houstonmarvin@stein.com,2021-11-11,http://www.ball.com/
30-Aug-2020,ATM,"3,312.00",00.00,"1,054,995.46",D9c3Aec96C173d9,4105,Gail,Skinner,"Hinton, Tucker and Peterson",Kyliehaven,Uganda,(164)987-8507,(603)692-2352x8981,joycenash@west-cobb.com,2022-05-07,https://donovan.net/
30-Aug-2020,Bill,00.00,"150,713.64","904,281.82",a2F1Eb5B4518167,5545,Maxwell,Curry,"Huber, Collier and Martin",North Terrence,Marshall Islands,978.125.7335x45676,751-163-5135x21219,xbarker@dennis.com,2020-12-23,http://odonnell-parker.com/
30-Aug-2020,NEFT,00.00,"452,140.91","452,140.91",727739891bfeb9a,5964,Sheila,Jennings,"Berg, Gould and Morris",East Nina,Puerto Rico,153.047.2971x220,(270)966-6630,bergdanielle@stout.com,2021-12-19,http://www.perry.org/
30-Aug-2020,ATM,00.00,"226,070.46","226,070.46",CCD016f5e064faF,1739,Gwendolyn,Foley,Heath and Sons,Emmaland,Turkmenistan,320.107.8978x2778,001-156-511-5085x73976,kara18@short.com,2020-03-10,http://donaldson-roach.info/
30-Aug-2020,ATM,164.00,00.00,"226,234.46",2BBa459dBdAF331,9362,Brent,Sexton,"Crane, Cross and Gould",Port Evelynside,Malaysia,001-625-440-6328x469,(584)505-5938,orrstanley@rush.org,2021-08-09,http://www.schroeder.com/
30-Aug-2020,Reversal,"258,167.80",00.00,"484,402.26",Bc3D2DEfcb4c136,3914,Leroy,Joyce,Stafford Inc,Ginachester,Saint Vincent and the Grenadines,766-194-6696x7826,(543)981-2840,rose16@rowe-valenzuela.biz,2021-11-03,http://smith.com/
30-Aug-2020,Reversal,00.00,"48,440.23","435,962.03",D01765c93d9aABe,4245,Lonnie,Holt,"Travis, Burnett and Bowen",New Alexandriaborough,Iceland,0812708863,001-736-457-2080x6438,jacksonnicholson@casey-fritz.com,2020-01-25,http://www.grant-rowe.info/
30-Aug-2020,NEFT,618.80,00.00,"436,580.83",0b40C864ABbbBFb,9074,Derrick,Ali,Branch-Lin,Derrickberg,France,047-953-1119,1377732679,kerrimcfarland@larson.com,2020-06-22,http://www.morgan-charles.info/
30-Aug-2020,Reversal,21.00,00.00,"436,601.83",A0ae9a58fBFc9fB,5172,April,Nixon,Bruce-Dickerson,Kruegerbury,Burkina Faso,(720)904-6072x6799,(808)907-7048x14882,bridget97@eaton.biz,2021-11-11,http://mcpherson.net/
30-Aug-2020,Interest,275.74,00.00,"436,877.57",8Ce1Fb6D34F288b,307,Wayne,Gomez,Owens-Hale,West Sonya,Vanuatu,+1-633-747-5786x82865,687-760-2164x42491,hollowaykatherine@jones.com,2020-06-05,http://www.le.com/
30-Aug-2020,ATM,"3,574.50",00.00,"440,452.07",5056feB7EecAf02,3353,Cheyenne,Pearson,"Barr, Lopez and Morrow",Moranfort,Cameroon,(234)517-0626x2792,382.028.3517x16659,colton46@robinson.biz,2020-08-29,http://washington-mullins.net/
31-Aug-2020,Commission,17.00,00.00,"440,469.07",A61A72AdEfFa1d0,5574,Julie,Villarreal,Estrada Group,South Samantha,Croatia,223-335-9416x9790,117-026-6029,christina49@holder.net,2021-07-19,http://www.delacruz-hooper.com/
31-Aug-2020,Interest,00.00,"220,234.54","220,234.54",2f50cC9aAAaFc33,3526,Marie,Rodriguez,"Chapman, Arroyo and Powers",Pittsstad,Palau,001-755-850-1166x10533,068.943.6946,uhill@callahan.info,2020-03-17,http://www.orr.com/
01-Sep-2020,Transfer,"6,222.32",00.00,"226,456.86",2Fc3F4aAdecC9B7,9765,Terry,Carroll,Shepherd-Weeks,Port Oscarburgh,Myanmar,+1-271-831-8900x71673,001-302-104-2664x193,villakathy@webster.info,2020-08-25,https://www.lamb.info/
01-Sep-2020,ATM,53.30,00.00,"226,510.16",CDe18D005a1ba61,1840,Tim,Rowe,Clayton-Fitzpatrick,Lake Marilyn,Cameroon,+1-725-722-0639x427,868.984.3423,vanessa75@love.com,2021-02-28,https://ford.com/
01-Sep-2020,Reversal,00.00,"28,313.77","198,196.39",2D382e583244B3C,8181,Rebecca,Garner,Watts-Braun,Sydneyburgh,United States Minor Outlying Islands,524.772.9867x640,+1-140-999-4070,andres04@wilcox.com,2022-01-09,https://www.dickerson-lin.com/
01-Sep-2020,Cash,"938,633.75",00.00,"1,136,830.14",2A0f5CFFf389edF,3701,Patty,Cortez,Mccoy Group,Laceyfurt,Isle of Man,586-445-4025x38212,001-557-416-0663x101,vweiss@stokes.com,2021-12-29,https://mendoza.com/
01-Sep-2020,IMPS,01.40,00.00,"1,136,831.54",d6F5Cd2D7EDa18C,8224,Tim,Blevins,"Floyd, Barrett and Moreno",South Joanbury,Kenya,(290)087-1979,+1-736-277-8208,vicki91@underwood.com,2021-04-26,http://mcmahon-travis.info/
02-Sep-2020,Purchase,"2,719.00",00.00,"1,139,550.54",9E4b0DD1C2B3C75,3210,Alexander,Navarro,Chase-Wilkins,Paynemouth,Uganda,707-146-2865,001-821-174-1865x56850,rollinseugene@wilcox.org,2020-08-22,https://www.espinoza.com/
02-Sep-2020,NEFT,"238,647.10",00.00,"1,378,197.64",FB830f3D90cf4FA,2098,Norma,Powers,"Weeks, Ramirez and Decker",Lake Cameronborough,Falkland Islands (Malvinas),(794)043-4031x0702,809.912.4123x6195,bkaufman@richardson-rivera.com,2020-11-01,https://zuniga-ritter.com/
02-Sep-2020,Debit Card,00.00,"196,885.38","1,181,312.26",fCcCf0B2bbACEAa,9928,Omar,Sherman,Barajas Group,Haroldfurt,Holy See (Vatican City State),096.367.5827,(724)644-0128x8158,toddvaldez@rush.com,2022-03-13,http://www.steele.com/
02-Sep-2020,Debit Card,00.00,"131,256.92","1,050,055.34",FaaCDAE3c4dbed1,9232,Marissa,Oneill,Schwartz-Charles,Lake Patty,Faroe Islands,0140132738,(838)801-1430,blake12@rodgers.com,2021-06-17,http://www.cruz.org/
02-Sep-2020,RTGS,"1,702,770.20",00.00,"2,752,825.54",16CDE704ac1d3AC,3343,Anne,Vang,Garrett-Duffy,Brightstad,Sri Lanka,(314)613-4936x738,155.464.1136x1179,davenportmarilyn@le.com,2021-03-25,https://campos.com/
02-Sep-2020,Cheque,00.00,"550,565.11","2,202,260.43",ceeF7BC6bABaFBC,5412,Fred,Zamora,Marshall Inc,South Amy,Guatemala,+1-060-231-9197x7789,980.156.3803,christopherwise@wallace.com,2020-12-07,https://www.mullen.biz/
02-Sep-2020,ATM,"1,261,327.80",00.00,"3,463,588.23",6FEDAECdC31Dce6,9832,Ray,Dorsey,Mcgrath Group,Arthurmouth,Sweden,(072)744-8223x8205,6220605998,malikarias@wagner.org,2020-01-20,http://www.spencer-jimenez.com/
02-Sep-2020,RTGS,"1,216,645.50",00.00,"4,680,233.73",6FeCb831b47F18C,7341,Jasmin,Frank,"Horne, Hebert and Michael",Isabeltown,Cambodia,+1-000-460-0703,697-377-2642x41048,frances48@hines.info,2020-02-08,http://manning-williamson.com/
02-Sep-2020,Interest,00.00,"520,025.97","4,160,207.76",B6C25f8Da3eBFff,9433,Benjamin,Sweeney,Aguilar-Cohen,Hawkinsberg,Papua New Guinea,4806044324,644-716-9460x95703,clintoningram@travis-allison.org,2020-11-29,http://www.braun.biz/
02-Sep-2020,Transfer,00.00,"462,245.31","3,697,962.45",AeedE93A2bf57Ab,5866,Clarence,Hinton,"Johns, Mclean and Harmon",Allisonland,Georgia,361-507-5650,243-977-2224,margaret18@morris-ware.com,2020-06-28,http://sawyer-cervantes.org/
02-Sep-2020,Bill,00.00,"410,884.72","3,287,077.73",AF448EaC8b6b1Af,1886,Tasha,Pittman,"Ferrell, Pierce and Calderon",Haroldville,Sierra Leone,875-461-4445x82567,530.849.3398x587,leonardirwin@garner-krueger.info,2021-11-18,https://giles-orozco.com/
02-Sep-2020,Transfer,07.90,00.00,"3,287,085.63",0Fff46BDe5f7d03,7770,Nichole,Edwards,Jensen-Castro,Port Haroldmouth,Argentina,001-164-958-9638x8121,001-945-356-0355x41770,kevindunlap@logan.com,2020-01-15,https://www.garner-patel.com/
02-Sep-2020,Tax,377.55,00.00,"3,287,463.18",59dbfFCdc0fBEC4,1602,Breanna,Bush,"Pennington, Galvan and Neal",Cristinastad,Liberia,001-476-026-4388x00576,192-295-0587,xberg@phelps.com,2020-05-24,https://little-mercado.biz/
02-Sep-2020,Miscellaneous,245.53,00.00,"3,287,708.71",BdaF7d3aCffcB56,7909,Jacqueline,Weiss,"Burgess, Casey and Mayer",Heathberg,Pitcairn Islands,+1-747-318-6624x481,404.628.0103,tinastokes@ellison.com,2020-12-15,http://www.thomas-humphrey.com/
02-Sep-2020,ATM,00.00,"657,541.74","2,630,166.97",d2bd8DC7bb71169,2882,Leonard,Knight,"Hendricks, Lambert and Ashley",West Blakehaven,Benin,733-594-2727x115,(373)503-8797,leslieaustin@atkinson-brady.com,2021-07-30,http://watts-knapp.com/
02-Sep-2020,NEFT,00.00,"263,016.70","2,367,150.27",70CD1cFdFE2fCED,8769,Edward,Small,Mathis Group,West Michealfurt,Comoros,702-799-8508x5124,(094)257-8928x94438,joel28@reed.com,2020-03-20,http://mcguire.info/
02-Sep-2020,NEFT,51.10,00.00,"2,367,201.37",beed56F4538Cfa3,6946,Jaime,Benton,Dodson Inc,Lindabury,United States Virgin Islands,+1-995-784-6309x404,+1-880-341-1068x346,mcdonaldralph@lara-conner.com,2020-02-12,https://daugherty.biz/
03-Sep-2020,Bill,00.00,"789,067.12","1,578,134.25",b50Af85F352ED3d,1951,Trevor,Evans,"Wolfe, Travis and Ochoa",Lake Janeberg,United States Minor Outlying Islands,270.497.2589,330-716-6478x52752,theodore18@reese-fletcher.org,2021-07-23,https://www.reese.com/
03-Sep-2020,Purchase,00.00,"789,067.13","789,067.12",b089c72F44cffd7,5889,Brent,Mitchell,Freeman-Riggs,New Laurenberg,Guinea,3911780989,+1-547-044-8725x19874,deckershelley@arias-ryan.com,2020-09-15,https://www.kirby.com/
03-Sep-2020,RTGS,"1,384.35",00.00,"790,451.47",b1C84c589cD6b1C,2014,Philip,Pugh,Fitzgerald and Sons,Port Adamfurt,Sudan,(159)927-0849,+1-833-174-7328x9740,tamibeck@michael.info,2022-01-04,https://bautista.com/
04-Sep-2020,Transfer,00.00,"98,806.43","691,645.04",E1B93b7cE3Cc48B,4759,Douglas,King,"Brooks, Collins and Holmes",Nashshire,Malawi,477-391-9324x2330,556.366.5837x57181,meghanoconnell@meza.org,2020-12-22,https://www.cortez-mcpherson.com/
04-Sep-2020,Interest,00.00,"98,806.43","592,838.61",b4f8F1D3Cb5F7cf,6633,George,Gonzales,"Bowman, Allen and Rhodes",North Madison,Guadeloupe,732-028-3480x6134,717.168.8758x3994,staffordnatasha@shields.net,2020-02-08,http://www.harding.com/
04-Sep-2020,NEFT,00.00,"592,838.61",00.00,FB358C9e5bC0E12,2188,Jackie,Becker,"Ramos, Bryant and Goodwin",West Shane,Brazil,001-911-744-0581,001-070-356-5674x587,haguirre@cherry.com,2021-01-13,http://www.reese.com/
04-Sep-2020,RTGS,00.72,00.00,00.72,fdCdfE6f31839E4,2440,Stefanie,Pollard,"Horne, Roberson and Gates",New Angiefort,Equatorial Guinea,173-281-4412x87406,001-836-526-9692x75900,spearscurtis@rich.com,2021-12-28,https://henson.org/
04-Sep-2020,Transfer,03.33,00.00,04.05,D78E74055ecd916,5208,Samuel,Ali,Flores-Salazar,New Kristina,Albania,(002)445-7808x6953,387.406.0286x643,linda63@arroyo-sandoval.com,2020-02-10,https://www.avila-vang.biz/
05-Sep-2020,Reversal,00.00,01.35,02.70,075c8CbAFD5C24B,3428,Joanne,Jacobs,Benjamin-Rocha,Jacksonberg,Reunion,495.773.6841,001-561-094-1384x3573,bauerjackson@carson.info,2022-05-27,https://pace.org/
05-Sep-2020,Bill,00.00,01.35,01.35,c3EeEd28dB06e84,6530,Krystal,Palmer,Jimenez and Sons,Dariusberg,Pitcairn Islands,787-941-1436x180,+1-085-779-3491,audrey11@koch.com,2021-02-06,http://lin.com/
05-Sep-2020,Interest,00.00,00.23,01.12,2AdaCF424D7Ab1a,2820,Elijah,Blair,"Roach, Webster and Medina",Alvinbury,French Polynesia,(951)041-6976x05879,(395)398-2747,kennedymarc@sims.com,2020-07-10,http://www.daugherty-hooper.biz/
05-Sep-2020,Reversal,922.00,00.00,923.12,f8CCf2BFf6AbEbb,2974,Dominic,Salas,Cobb Ltd,North Jerry,Palestinian Territory,441.295.7488x00063,603-385-8247x731,rodneylin@romero.com,2021-05-29,http://www.bolton.com/
05-Sep-2020,Commission,"1,858,278.00",00.00,"1,859,201.12",Ff9ea1647acFb6B,4567,Jodi,Newton,Kaiser-Dorsey,Angelberg,United States Virgin Islands,832-114-1565x1026,001-951-329-3477,mackenziemcneil@stewart-manning.com,2020-01-23,https://randall.com/
05-Sep-2020,Interest,277.00,00.00,"1,859,478.12",601c8fd56fa4F62,9427,Janice,Krueger,"Knox, Clark and Huff",Mcclainview,Finland,001-576-749-9239x3284,(621)611-6530x2122,weavermarissa@hogan-rowland.com,2020-10-06,https://www.campos-pham.org/
05-Sep-2020,Interest,00.00,"619,826.04","1,239,652.08",bfCcdaFA3086F2C,8233,Rick,Morgan,Robertson Group,New Kelliburgh,Saint Vincent and the Grenadines,+1-198-971-9606,(708)016-3510x3838,robindean@yates.com,2020-12-07,http://whitney-cochran.com/
05-Sep-2020,Transfer,340.90,00.00,"1,239,992.98",dfCE769cc1D18Ae,5084,Benjamin,Houston,"Holden, Trevino and Tate",South Diana,Lebanon,968-809-7996x98609,001-084-821-7290x686,rhonda21@herrera-glover.com,2021-06-09,https://grant-price.com/
05-Sep-2020,Transfer,"1,892.78",00.00,"1,241,885.76",D5bD3Bab8F151f7,5723,Chloe,Holden,Bean-Mullen,Ashleychester,Norfolk Island,642-065-8798x213,(795)938-9142x73453,qcox@conley.biz,2020-09-28,http://www.burgess-chang.com/
05-Sep-2020,Bill,00.00,"248,377.15","993,508.61",e5169aAa0A2cE5e,2470,Vernon,Wong,"Kane, Sawyer and Frye",New Lynn,Holy See (Vatican City State),7021188400,+1-932-776-6495x590,antonio35@joseph-hansen.com,2021-10-26,https://daniels-mccarthy.info/
05-Sep-2020,NEFT,00.00,"198,701.72","794,806.89",07E6cB9a3d9FCFA,2722,Steve,Brewer,Proctor-Phillips,East Paige,Greece,+1-482-021-2955x296,0685178377,claytonrobles@zavala-atkins.org,2020-10-27,http://www.cervantes.com/
05-Sep-2020,Cheque,00.00,"88,311.88","706,495.01",597df5C8A75B14D,1430,Dale,Solis,"Knapp, Huff and Garner",Spencertown,Jersey,(027)060-5731,054.420.9064x49651,jorge56@mendez-nicholson.biz,2021-08-04,https://coleman.info/
05-Sep-2020,Transfer,"9,815.44",00.00,"716,310.45",EefFa0D5AC7BBfb,6083,Janice,Whitaker,"Watkins, Williams and Faulkner",Dylanfort,Tajikistan,(380)959-5283x56382,531.241.6421x259,karl16@cain.net,2022-03-26,https://www.lowery.biz/
05-Sep-2020,Cheque,"723,495.75",00.00,"1,439,806.20",fFC18d58DbBaA83,4198,Judy,Frederick,"Cohen, Hoover and Tapia",Krausehaven,Italy,+1-536-175-6527x1610,084-121-2121,zgarner@kennedy-key.com,2020-08-15,https://liu.com/
05-Sep-2020,ATM,00.00,"143,980.62","1,295,825.58",72cfceB4DB19Edc,9949,Colton,Washington,"Ferguson, Lambert and Haney",Mollybury,Bouvet Island (Bouvetoya),(796)594-9993,+1-862-912-0306x990,holly71@solomon-roberson.com,2020-10-17,https://www.serrano-sosa.info/
06-Sep-2020,Bill,06.50,00.00,"1,295,832.08",8bC1D97f7b3f97F,5213,Bruce,Salas,"Barrera, Mays and Harrison",Amandaview,Cambodia,+1-991-943-1274,970-920-2035x193,hooperjeanne@dunlap.biz,2021-02-18,https://www.riley.com/
06-Sep-2020,NEFT,347.00,00.00,"1,296,179.08",7F95CBD0AbAE575,6705,Frank,Winters,"Webster, Pace and Tucker",Stephenstown,Afghanistan,+1-106-264-8005x481,099-271-7099x45296,iwang@bray.com,2021-07-08,https://www.gaines-stokes.com/
06-Sep-2020,Tax,"12,657.40",00.00,"1,308,836.48",2cd3cEBb3Bb9c3f,9816,Nina,Boyer,"Brady, Lynn and Gallagher",South Kathryn,Saint Vincent and the Grenadines,738.100.5607x3601,190-674-6921x29242,jasmin50@sanders.info,2021-09-10,http://mckay.com/
06-Sep-2020,Interest,"220,259.06",00.00,"1,529,095.54",EdC595c710f313f,1909,Caitlin,Boyd,"Frazier, Li and Landry",Wandaville,Austria,496-245-3496x550,366-275-4738x261,javierconner@saunders.com,2021-07-30,https://www.harper.com/
06-Sep-2020,RTGS,00.00,"382,273.89","1,146,821.66",5bcD12cf1A055C2,5734,Paige,Becker,"Avery, Weiss and Vazquez",East Scott,Estonia,059-010-6905x823,442-507-6131,osullivan@vaughan.biz,2021-12-16,https://www.mcfarland.org/
06-Sep-2020,NEFT,167.50,00.00,"1,146,989.16",CEF4632DAEd6EB0,1167,Judith,Powell,Suarez-Lewis,East Geraldberg,Madagascar,810.507.7664,696.341.3798x1016,cbenitez@suarez.org,2021-10-06,https://www.madden-hendricks.com/
06-Sep-2020,Cheque,00.00,"573,494.58","573,494.58",a5Cfdaf71B6c3fe,6768,Katherine,Maddox,Hendricks LLC,Hughesfurt,Guyana,844.817.5403x29668,387-815-9829,wongeddie@wallace.biz,2020-04-13,https://norris-melton.com/
06-Sep-2020,Cheque,00.00,"71,686.82","501,807.76",5e9bB94dAA30C1f,6090,Stacy,Meyer,Frye Group,South Donaldmouth,Argentina,428.422.8669,880-793-5055x0630,tanya55@lucero.com,2020-06-09,http://cooper.com/
06-Sep-2020,IMPS,"750,867.20",00.00,"1,252,674.96",FADa2dff9E8f3bC,442,Kayla,Fry,Vazquez-Wilson,New Andrew,Botswana,(986)611-0141,001-625-816-0923x62214,patriciagiles@oneill-chung.com,2020-01-14,http://www.flores.com/
06-Sep-2020,NEFT,59.80,00.00,"1,252,734.76",F1cef5EC17f48f8,3141,Sheryl,Melendez,Cannon-Carroll,Lake Suzanne,Nicaragua,074.508.5923x2435,896.482.8017x1093,burnettbrandon@church.biz,2021-02-10,https://mccann.com/
06-Sep-2020,IMPS,"4,778.51",00.00,"1,257,513.27",3839Be575fdafe2,9460,Laurie,Lucas,Pennington Group,Pacestad,Greece,(529)862-1160x4669,(299)881-3775,donoconnell@kerr-nunez.net,2020-05-30,https://burke.com/
06-Sep-2020,Miscellaneous,00.00,"1,257,513.27",00.00,e090f2CAF78D1fa,2497,Erica,Sloan,Rowland LLC,West Noahview,Botswana,+1-092-286-3619x944,001-666-132-2734x6100,hendrixshelby@gallagher-villanueva.com,2021-12-15,http://vargas.com/
06-Sep-2020,NEFT,"25,899.00",00.00,"25,899.00",Dbc7b8B3dC23efa,7680,David,Key,"Woods, Gaines and Garrett",Dunlaphaven,Syrian Arab Republic,001-931-759-8369x599,156.792.2335x209,keithcandace@ramos.com,2020-07-25,https://dyer-wilkerson.org/
06-Sep-2020,Commission,00.00,"3,699.86","22,199.14",d3bA1550eB3B2AF,3981,Joseph,Mcmillan,Robinson and Sons,Lake Angelaton,Sri Lanka,+1-455-218-5326x9932,(977)326-3036,hduran@washington.com,2020-09-12,http://ford.info/
06-Sep-2020,Interest,00.00,00.00,"22,199.14",a6F3Fbda479cdd0,8991,Mike,Monroe,Hall-Howell,Port Leslieberg,Cyprus,001-773-125-2750x48846,+1-215-880-3327x05358,maxwellblake@hall.info,2020-11-06,http://www.ochoa-francis.com/
06-Sep-2020,Miscellaneous,00.00,"2,466.57","19,732.57",AFCF9ffB711C3a2,8602,Sheri,Ponce,Rangel LLC,Kristinbury,Mozambique,972.567.3853x64005,(042)504-6336,candicecase@luna-caldwell.com,2021-06-27,https://fletcher.com/
06-Sep-2020,Cheque,00.00,"19,732.57",00.00,7cF3fA9AdFcde2c,6760,Allison,Atkinson,Adkins Ltd,East Terriland,Christmas Island,(958)827-1468x209,(456)003-6382x6288,brandon82@hernandez.com,2020-08-18,http://acosta.com/
06-Sep-2020,Transfer,04.21,00.00,04.21,7D07A123cDaebfB,2327,Darius,Howard,Wong PLC,Port Kiara,Wallis and Futuna,(363)202-6090x16483,+1-355-472-0719x51811,mistyluna@maldonado-roberts.com,2021-05-04,http://colon.com/
06-Sep-2020,Cheque,00.00,01.05,03.16,F3DcCA3FBEd02b6,5241,Traci,Gonzales,"Roth, Arroyo and Castillo",Normanshire,Bosnia and Herzegovina,(097)647-1505x923,958-019-1644x328,vanessa32@nash.net,2020-01-09,http://www.cordova-chandler.biz/
06-Sep-2020,Debit Card,00.00,00.53,02.63,080d64e37586bDA,2172,Madeline,Cortez,Walsh-Bass,Lake Joanna,Vanuatu,155.703.5825x06726,+1-422-720-2893x72069,kristiegarza@english.com,2021-01-20,https://malone.com/
06-Sep-2020,Miscellaneous,00.00,00.66,01.97,c49aAEc99b4FDCb,5342,Javier,Bates,"Guerra, Wolfe and Macias",West Ralph,Hong Kong,+1-351-373-2103x21393,+1-075-590-0412,sean09@gregory-frazier.com,2020-12-23,http://burke.com/
06-Sep-2020,Debit Card,00.00,00.99,00.98,bBf7CB3Ef01F12a,9406,Neil,Ali,Delgado Ltd,Pedromouth,Taiwan,708-848-2185,+1-748-088-2209x98980,robin98@bennett-keith.info,2020-12-22,https://logan-douglas.com/
06-Sep-2020,IMPS,00.00,00.98,00.00,A4A70f48DDD19fc,2547,Rick,Pratt,Bowers-Bruce,New Harrychester,Luxembourg,(007)904-7220x881,(753)395-4538x0770,ooneal@jenkins.net,2021-07-14,http://www.sims-santos.info/
06-Sep-2020,Bill,213.60,00.00,213.60,ff8af69AecCdFCB,4021,Kelli,Wilcox,"Taylor, Hanna and Valdez",Lynnstad,Guyana,615-445-5255,+1-692-624-2700x3041,edward96@greene.org,2022-01-02,http://friedman.com/
06-Sep-2020,Reversal,"2,033,119.20",00.00,"2,033,332.80",73Ad6f9Cbe021D3,6340,Kelsey,Sawyer,"Callahan, Blake and Fuentes",Jeanland,Guatemala,001-444-313-6363x50164,001-938-075-9287,ehampton@huerta.org,2022-01-05,https://mitchell.biz/
06-Sep-2020,Cash,"260,909.12",00.00,"2,294,241.92",dAFf1fC8CcFe956,7357,Jenna,Mccall,David-Schmitt,Baileyburgh,Ethiopia,514.944.7179x907,+1-921-344-9287x047,sgray@stanton-peters.com,2021-01-14,http://lowery.com/
06-Sep-2020,Reversal,00.00,"286,780.24","2,007,461.68",45bBbaB4A13AB5c,3002,Leon,Beasley,Gamble-Schmitt,Katherinemouth,Guyana,+1-381-384-2716x7728,(590)235-3858,carneygeorge@daniel.biz,2021-08-31,http://wright.com/
06-Sep-2020,Interest,00.00,"401,492.34","1,605,969.34",dD23773A34D391A,9003,Jody,Hess,Holland LLC,Seanmouth,Moldova,884.222.6470,2703437843,vwalker@arias-alexander.com,2021-02-18,http://phelps-mcdonald.com/
06-Sep-2020,ATM,"23,090.54",00.00,"1,629,059.88",3F9241ebD6bA4af,9429,Tammy,Ayers,Dillon-Wilcox,Mollyland,Iceland,001-793-724-1718,854.490.6605x8736,glassdana@bernard-barker.com,2021-11-01,http://www.house.com/
06-Sep-2020,Transfer,778.81,00.00,"1,629,838.69",b38DA3B9d2419a3,2714,Leah,Mckenzie,Lawrence LLC,North Meagan,Peru,001-035-337-7443x92890,061-768-0736x306,brianarandolph@webb.net,2021-09-25,http://roy-holden.org/
06-Sep-2020,IMPS,00.00,"232,834.10","1,397,004.59",96fef84eee0E6eB,7969,Jessica,Diaz,Williamson-Woodward,Douglasport,Greenland,520-446-7020x164,715.269.6649x94159,nluna@gilmore.com,2021-12-06,http://hart.com/
07-Sep-2020,Cheque,442.45,00.00,"1,397,447.04",F71d5C3bcDcddEc,3090,Herbert,Williamson,"Richmond, Padilla and Kane",Lake Brentberg,Hong Kong,882.063.9229x91736,440.434.4361x0547,nguyencody@case.org,2020-04-03,http://irwin.com/
07-Sep-2020,Transfer,"1,251.00",00.00,"1,398,698.04",d2DA1E92A7bEF4e,1003,Kathy,Dougherty,Cherry and Sons,Port Yvette,Costa Rica,503-427-4245x167,+1-469-698-5615x924,ricardo01@jones.com,2020-07-07,http://www.fletcher-beasley.info/
07-Sep-2020,Reversal,08.70,00.00,"1,398,706.74",Ff9589510beABeC,7750,Carrie,Crane,Jarvis-Lam,Stefanieside,Oman,(855)869-6289x74084,258.660.1559x8094,judithholloway@carey.com,2021-07-26,https://bauer.com/
07-Sep-2020,Commission,00.00,"233,117.79","1,165,588.95",3cF6a711dF78c5b,6707,Gabrielle,Miranda,Ferguson-Shepherd,Mitchellchester,Peru,001-324-805-7754x04402,553-620-9928,savannah50@hebert-galloway.com,2022-05-10,https://campbell-knox.com/
07-Sep-2020,Cash,00.00,"166,512.71","999,076.24",Bcb2292edE2d18D,2973,Jade,Diaz,Odonnell-Hopkins,East Howard,Ghana,+1-615-809-3030x69473,(927)668-4232,joshuafoley@holland.org,2021-03-14,https://www.ferrell-frey.com/
07-Sep-2020,Miscellaneous,"32,705.00",00.00,"1,031,781.24",9bbb3aE3882C1Ef,8101,Gilbert,Freeman,Ross PLC,South Kristin,Guinea,(424)094-2029,(609)278-3971,millerlauren@flynn-bean.com,2020-01-20,https://gordon.com/
07-Sep-2020,IMPS,00.00,"147,397.32","884,383.92",1ACdeF80EF0d1Bf,9871,Craig,Chen,Mullins-Chung,Shirleymouth,Georgia,(779)012-4865x71465,001-651-205-6731x5817,chelsea72@alvarado-melendez.com,2021-03-09,http://www.best.biz/
07-Sep-2020,Purchase,00.00,"126,340.56","758,043.36",0Ba16339Ec9a97a,160,Bridget,Vaughan,"Ponce, Wade and Cowan",Lake Cristian,Svalbard & Jan Mayen Islands,(097)547-0859,0841167321,kari95@henry.org,2021-01-31,https://weber.net/
07-Sep-2020,Bill,07.70,00.00,"758,051.06",0eFf84b706a8DdB,100,Aimee,Sims,"Lara, Leon and Montoya",East Jeanneside,Grenada,(570)770-4667x7987,001-511-768-2295x52680,anthonyzuniga@tucker.com,2021-07-27,http://moran.com/
07-Sep-2020,ATM,"2,432.00",00.00,"760,483.06",E8Fbf1f9F918b55,3486,Sonya,Hoover,Cordova Inc,Katrinachester,Ethiopia,4388402490,844.959.0964x9302,mindygregory@campbell-matthews.com,2020-10-16,http://www.goodwin.biz/
07-Sep-2020,Cheque,"4,052.17",00.00,"764,535.23",c510965CCe7da88,8410,Ricardo,Strong,Rosales LLC,Vincentfurt,Spain,860-895-0481x842,001-813-981-6951x546,rmckinney@valencia.com,2022-02-17,https://www.dennis.info/
07-Sep-2020,IMPS,00.00,"76,453.52","688,081.71",b4Fd62e2cC113df,3712,Hayley,Steele,"Alvarado, Drake and Molina",Carlberg,Angola,841.534.8981,205-718-0628x521,chase92@mcfarland.com,2022-04-23,http://www.lucas.com/
07-Sep-2020,Transfer,39.50,00.00,"688,121.21",8A0DFf8BC28f3C4,8721,Beth,Schroeder,Acosta-Murillo,Kerrimouth,Sri Lanka,029.761.7667x850,+1-109-907-1626x2992,heidirivera@shepherd-huffman.com,2021-06-30,http://www.sandoval.info/
07-Sep-2020,Cash,"1,513,966.00",00.00,"2,202,087.21",a8fb6bcF8bFf51a,5663,Justin,Bell,"Gardner, Hendricks and Ferrell",Castrotown,Gambia,001-889-787-6501x37470,+1-212-040-5219x290,angel77@hahn-drake.com,2021-02-18,https://www.scott.com/
07-Sep-2020,IMPS,412.00,00.00,"2,202,499.21",A0c82B2Ef6d3EaC,8921,Madeline,Woodard,Dodson-Flores,Howellbury,Netherlands,+1-863-491-8049,131.985.5308x4406,uadkins@ramsey.info,2020-04-09,https://www.joseph.com/
07-Sep-2020,Transfer,00.00,"244,722.13","1,957,777.08",Da63bffb10feFc2,697,Zachary,Tran,"Shepherd, Greer and Murphy",Kimberlyburgh,Andorra,831.331.8338x3219,145.151.4483x888,lstrong@aguirre.org,2021-02-10,http://parks.biz/
07-Sep-2020,Reversal,05.00,00.00,"1,957,782.08",d27FDD64f9118D7,5218,Priscilla,Owen,"Boyer, Black and Hurst",Henrymouth,Zimbabwe,001-946-569-0877,(024)073-0303,emmaburgess@arellano.info,2020-11-29,https://www.skinner-rasmussen.info/
07-Sep-2020,Cheque,00.00,"326,297.01","1,631,485.07",77aFB79505b1778,7562,Vernon,Wade,Randall-Bass,Scottview,Burkina Faso,178.990.0899x26708,533.119.7069x2991,sallymatthews@stanley.net,2021-06-11,http://brandt-calhoun.net/
07-Sep-2020,Reversal,"1,782,155.00",00.00,"3,413,640.07",ae37F41D3CDd82d,1731,Kelli,Barron,"Gray, Contreras and Ball",Angelicatown,Macao,128.189.6323x5170,074-693-6371x208,trevor78@beltran.biz,2020-10-09,https://sloan-valencia.com/
07-Sep-2020,Transfer,"156,911.84",00.00,"3,570,551.91",D108CbA57cCa4Fb,9740,Shawn,Perkins,Mayer PLC,Melaniemouth,French Polynesia,001-179-555-6391x413,665.965.4187x087,katiemercer@mcintosh.com,2021-04-19,https://bernard.biz/
07-Sep-2020,Commission,00.00,"357,055.19","3,213,496.72",Ac50d57aB2bCbD5,6507,Roger,Holloway,Callahan Group,South Isaacfurt,Serbia,114.153.3688x64124,(508)034-5914,kristamoss@shepherd.com,2020-02-16,http://sexton.com/
07-Sep-2020,Cheque,00.00,"357,055.19","2,856,441.53",93aEBC17c54EF3e,1049,Jose,Daugherty,Williams and Sons,South Jorge,Trinidad and Tobago,001-331-544-4966x709,4244849503,rrose@mack.com,2020-05-14,http://www.chaney-krause.info/
07-Sep-2020,Bill,00.00,"952,147.18","1,904,294.35",ccC0ddeBF9b1cbe,4432,Tina,Hood,Benton-Ferguson,New Travisbury,Greenland,9170749340,132-472-7322,daryl70@rodgers.com,2020-11-29,https://blair.biz/
07-Sep-2020,Reversal,"2,534.91",00.00,"1,906,829.26",B8B255A57FAAab1,732,Joyce,Franklin,Webb-Cameron,Lucashaven,Israel,808-406-0457x07254,+1-330-815-6383x66858,marciapugh@gilmore-fischer.com,2021-01-10,https://www.hardy.biz/
07-Sep-2020,Purchase,"69,855.00",00.00,"1,976,684.26",7d4b0cB7f1b07b0,5890,Ronnie,Watkins,Russo-Hines,South Ralphside,Andorra,412.668.0132,8599205667,amandawaters@bentley.net,2020-06-24,http://yoder.com/
07-Sep-2020,Reversal,166.34,00.00,"1,976,850.60",4DCb2a22eDFe4bA,3574,Carmen,Keller,Valentine Group,North Valerieport,Uganda,(983)139-4030,001-733-030-3370,tim15@prince.info,2021-03-06,https://blair-humphrey.net/
07-Sep-2020,NEFT,"8,517.02",00.00,"1,985,367.62",BBA220FBFC502E3,3054,Chloe,Chen,Weaver-Evans,Shawntown,France,9822818500,+1-835-475-1323x051,jason36@boyd.com,2022-03-17,https://www.franklin.com/
07-Sep-2020,Interest,02.00,00.00,"1,985,369.62",0CD4DdF92bEA98C,6504,Sara,Fitzpatrick,Massey Inc,North Darryltown,Sudan,001-202-091-9405x83621,2177337690,kristinalvarado@merritt.com,2022-01-17,https://www.cannon.com/
07-Sep-2020,ATM,03.00,00.00,"1,985,372.62",1d3749Dc7ADfa2F,1063,Tammy,Oneill,Pope-Mckee,Port Bethchester,Spain,301-747-2921x5938,378-571-8346,rickmatthews@bowen.com,2021-12-07,https://hill.org/
07-Sep-2020,Purchase,125.08,00.00,"1,985,497.70",eaA8Da1cca546e6,2693,Lawrence,Bradshaw,Fuentes-Roberson,New Terrence,Tonga,(134)617-5797x99623,(341)486-2304,ffinley@stokes.com,2020-12-17,https://www.mclaughlin.info/
07-Sep-2020,Interest,"10,590.00",00.00,"1,996,087.70",f459C4b155702B9,3394,Hailey,Salinas,Mueller Group,Elainefurt,Norway,505.216.5358x0437,178.322.7872x85042,psellers@gaines.com,2021-10-04,https://allen.com/
07-Sep-2020,Interest,"596,055.80",00.00,"2,592,143.50",50c1bAd0B750cB9,7125,Bill,Conner,"Odom, Serrano and Gregory",Malikland,Portugal,1071527957,001-388-791-3939x9695,dawnponce@jacobs.com,2020-01-06,https://lawrence-costa.com/
07-Sep-2020,Interest,"396,941.50",00.00,"2,989,085.00",E1fa105ca19C3d6,9183,Marvin,Garcia,Gallegos PLC,West Charlotte,Gambia,+1-099-680-6872x371,975-807-0005x352,aaron59@hansen-durham.com,2021-08-04,http://www.baird.com/
07-Sep-2020,Commission,21.00,00.00,"2,989,106.00",Fe5cF5C0f05C194,3223,Clayton,Peck,Ewing-Willis,Helenmouth,Liechtenstein,001-544-677-7045x4042,(613)827-3134x4886,jphelps@roach.com,2021-09-05,http://www.hayes-miller.net/
07-Sep-2020,Tax,"3,310.90",00.00,"2,992,416.90",6b6bBD73A8ec126,9173,Caitlyn,Harmon,Harvey-Rodriguez,East Jonport,Puerto Rico,+1-106-886-4454x90386,338.487.8673,barrycolton@zuniga.biz,2022-03-07,http://www.keller.com/
07-Sep-2020,Tax,00.80,00.00,"2,992,417.70",91Bd624Ea6Dd56D,8489,Lynn,Franco,Mahoney Group,Port Benjamin,Iceland,001-623-107-8577,9822264272,brandonweaver@hendricks.com,2020-07-23,https://www.blackwell.com/
07-Sep-2020,Commission,98.24,00.00,"2,992,515.94",DeDE98DC3f3D47D,3545,Kristina,Harper,Matthews PLC,North Max,Maldives,475-691-0104x600,103-173-2216x7573,yatesjack@jennings.net,2020-10-01,https://www.cisneros-sutton.com/
07-Sep-2020,Reversal,05.50,00.00,"2,992,521.44",a005CC1161448E3,4547,Leon,Arnold,Drake Ltd,Romerohaven,Vietnam,041-668-7794x6042,(002)816-4058x22880,krivera@haley.com,2021-04-05,http://carney.info/
07-Sep-2020,Reversal,"10,164.00",00.00,"3,002,685.44",52aC7BadBdD4823,1365,Phyllis,Hatfield,Montes-Bradford,Port Alexisside,Moldova,6137332375,976.302.2855x34054,wigginsnatasha@compton.org,2021-10-26,http://www.oconnell.com/
07-Sep-2020,Cash,00.00,"500,447.57","2,502,237.87",ddeDE3bA36737B4,5110,Robin,Cox,"Mcneil, Tucker and Jensen",Bettybury,Ethiopia,(488)783-2510x089,590.730.1277x458,pkirby@delgado.com,2022-01-31,https://macias.com/
07-Sep-2020,Interest,"382,115.50",00.00,"2,884,353.37",bca9CCD7EFCD24D,5531,Caitlyn,Saunders,Glass-Byrd,Port Alyssahaven,Slovakia (Slovak Republic),5367053156,+1-590-083-0350x455,avaughan@johnson-bean.com,2021-06-13,https://lozano.com/
07-Sep-2020,Purchase,00.00,"961,451.12","1,922,902.25",8cF0b6cd2E93c00,2210,Erik,Huff,Prince and Sons,Mcphersonborough,Japan,671.671.1993,627-155-4710x384,lynnpacheco@lloyd.com,2021-06-26,https://www.benitez.com/
07-Sep-2020,Interest,00.00,"961,451.13","961,451.12",e090f2CAF78D1fa,2497,Erica,Sloan,Rowland LLC,West Noahview,Botswana,+1-092-286-3619x944,001-666-132-2734x6100,hendrixshelby@gallagher-villanueva.com,2021-12-15,http://vargas.com/
08-Sep-2020,NEFT,"1,499.00",00.00,"962,950.12",E93d3BA519EBAF1,6186,Alec,Morrow,Harvey Group,South Alison,Georgia,+1-416-938-3587,001-075-331-0341,samanthahubbard@branch-cline.biz,2022-03-19,https://potts.com/
08-Sep-2020,Purchase,325.00,00.00,"963,275.12",E6a9296fdE54341,3571,Misty,Walton,Hays-Oconnell,Meganbury,Poland,001-118-045-2810,315.990.6413x62913,dukecaitlin@lozano-gibbs.info,2021-04-04,https://www.hooper.com/
08-Sep-2020,ATM,"766,598.20",00.00,"1,729,873.32",821DDeeBa5FB326,9393,Lonnie,Castillo,Rosario-Wood,West Jade,Panama,603.901.5631,9465083149,hfischer@stanton.info,2021-11-19,http://www.villegas-mata.com/
08-Sep-2020,Cheque,"241,951.00",00.00,"1,971,824.32",Eedaa2Cf4efa503,2297,Sarah,Alvarado,"Crosby, Bates and Conrad",Lake Beverly,Denmark,530-197-5883x65749,1876708892,jim59@townsend.info,2020-07-06,http://www.harrell-murray.com/
08-Sep-2020,Commission,29.00,00.00,"1,971,853.32",EDb0DCAaf614c22,801,Daryl,Reid,Winters-Sandoval,Bullockborough,Taiwan,3105048938,(039)191-1383,markcamacho@hooper.com,2020-02-26,https://www.carr-mendez.biz/
08-Sep-2020,Transfer,"59,175.20",00.00,"2,031,028.52",B77c73dDFFFcd09,1960,Randy,Beck,Bond PLC,East Collinmouth,Taiwan,993.490.9312x7860,001-890-410-2795,fandersen@ibarra.net,2021-12-08,https://soto.com/
08-Sep-2020,Reversal,00.00,"253,878.57","1,777,149.96",84e2381cDDB5CD7,9138,Ryan,Weeks,Tanner-Mcintosh,South Joshuachester,Kenya,632.337.0482x287,(957)742-1493x3057,vrichards@mclaughlin.net,2020-11-25,https://www.compton.com/
08-Sep-2020,NEFT,00.00,"177,715.00","1,599,434.96",05a734fB7EbE534,7405,Cesar,Parks,Sandoval-Caldwell,South Rodneybury,Uruguay,(639)612-9351,001-636-538-3986x65208,vrubio@wilcox.info,2020-08-07,http://www.chapman.net/
08-Sep-2020,Cheque,00.00,"228,490.71","1,370,944.25",CF00A8415C9c9FA,5143,Tim,Lowe,"Howell, Faulkner and Malone",Patrickville,Kenya,775-944-1786x4549,9619857515,nsilva@frazier.com,2020-08-30,http://www.fischer.com/
08-Sep-2020,Bill,00.00,"342,736.06","1,028,208.19",180C3ff1Bfa0ee5,2794,Yolanda,Macias,"Mcfarland, Malone and Huber",West Bradberg,Isle of Man,368.597.3651,550-766-1883,bobbywebster@lyons.org,2020-11-14,https://mathis.net/
08-Sep-2020,Miscellaneous,"1,360,620.25",00.00,"2,388,828.44",bBB50aAC7eFA813,4989,Jaime,Sampson,Jefferson-Delgado,Port Isaacmouth,Montserrat,256-928-6970x9868,515-068-5441x855,spearstheresa@bowen.org,2020-10-03,https://warren-herrera.biz/
08-Sep-2020,Miscellaneous,01.00,00.00,"2,388,829.44",51dE6f5a10A9eb0,3860,Kimberly,Keller,Bean-Hahn,Stephenburgh,Haiti,+1-875-245-3183x763,001-708-706-2005x6648,carlos62@reid.biz,2021-04-05,http://joseph-blankenship.com/
08-Sep-2020,ATM,"26,845.22",00.00,"2,415,674.66",03Ed9D062ACdEA3,7809,Lisa,Bright,"Parsons, Montoya and Rojas",North Joannamouth,Macao,575.400.3481x6848,065-190-6463,benitezfernando@nunez-castro.com,2020-01-21,https://johnson-davies.com/
08-Sep-2020,RTGS,281.80,00.00,"2,415,956.46",afC8ecDd7936ea7,3007,Hannah,Franklin,"Mccann, Braun and Booth",Serranochester,Canada,4599134612,331-611-6633x63699,benjaminbrown@contreras.com,2021-03-14,https://www.proctor-glenn.net/
08-Sep-2020,Commission,00.00,"483,191.29","1,932,765.17",77a4010b05bcB88,1295,Kayla,Becker,"Farmer, Page and Mitchell",Rubenchester,Mauritius,(372)987-6807x35078,(654)549-1267,leonard46@spencer-patrick.com,2022-04-13,http://ray.com/
08-Sep-2020,IMPS,24.55,00.00,"1,932,789.72",7eeFb805E1b293a,7429,Jeremy,Frey,Ellis and Sons,Edwinfort,Grenada,467-591-3498,(891)144-3434x33655,bautistajeremiah@oneill.com,2021-07-29,http://hartman-valentine.com/
08-Sep-2020,Miscellaneous,06.20,00.00,"1,932,795.92",F322eAEeDeA6caC,6751,Abigail,Mueller,Armstrong and Sons,Lake Faith,Burundi,(162)018-7142,914.658.3788x747,sylviamoody@farmer.info,2020-12-21,https://www.doyle.com/
08-Sep-2020,Cash,01.00,00.00,"1,932,796.92",f10fAFa2EA7Ad5c,214,Tyrone,Oconnell,Chavez and Sons,Davestad,Malaysia,001-591-723-3809x36173,001-323-574-2316x07928,malik63@frazier-nichols.biz,2022-03-03,http://www.gray.org/
08-Sep-2020,Miscellaneous,00.00,"966,398.46","966,398.46",505F6632C3cFDD2,4479,Justin,Clarke,"Sandoval, Simpson and Lawson",South Rogerchester,Jamaica,048.629.6502,+1-344-284-6514x61302,yangcaitlin@franklin.com,2021-02-22,http://morales-bartlett.info/
08-Sep-2020,Debit Card,00.00,"96,639.85","869,758.61",bdbA1F0053EDA7A,9993,Jennifer,Haynes,Alexander-Bass,Mcconnellland,Cayman Islands,001-346-519-8104,538.504.5143,jbeard@oneal.org,2020-12-19,http://brandt-gill.net/
08-Sep-2020,Debit Card,"4,014.00",00.00,"873,772.61",FAfccbf3d274BD0,9549,Cristian,Mercer,"Rollins, Garner and Owen",North Shelia,Benin,+1-634-250-0807,613-605-6066,jean83@anthony.biz,2021-11-26,http://andrade.com/
08-Sep-2020,Cheque,41.00,00.00,"873,813.61",2Be8ac81ed1C7fe,976,Stacie,May,Fields Inc,East Adrian,Montenegro,(484)401-4758,299-148-9874x031,deborah96@ortega-anderson.com,2020-03-19,http://www.flynn.com/
08-Sep-2020,Interest,00.00,"109,226.70","764,586.91",1F83219a03e192C,8775,Richard,Brock,Keith-Dunlap,New Coreyburgh,Papua New Guinea,001-738-579-0229x4453,+1-746-446-7421x286,yvette08@glover.com,2022-04-08,https://jordan.com/
08-Sep-2020,Cash,00.50,00.00,"764,587.41",6D3F6307C003B26,9934,Cheyenne,Rangel,Kennedy-Craig,Zoeburgh,Bermuda,781.048.9530,(584)884-6361x163,reesejeff@murillo.com,2020-07-30,https://www.huber-lowe.com/
09-Sep-2020,Debit Card,"3,398.00",00.00,"767,985.41",EcF859343EEBaB7,388,Todd,Quinn,"Woodward, Lutz and Orr",North Maxwell,Cyprus,2598721399,001-453-275-6105,roberthenry@davenport-middleton.org,2021-11-30,https://www.barnett.com/
09-Sep-2020,Bill,98.00,00.00,"768,083.41",2C5856eBEEdbe29,3339,Guy,Mayo,"Estrada, Heath and Dunn",South Leon,Niue,894-925-7760x168,+1-812-310-4347x32477,chavezemma@butler-hart.com,2022-04-28,https://stokes-chambers.com/
09-Sep-2020,Miscellaneous,00.00,"85,342.60","682,740.81",da3ADA2cbcEA54F,138,Lorraine,Bradshaw,"Contreras, Pollard and Moore",Blevinsmouth,Cape Verde,001-382-620-0918x061,608-409-4320,weaverclinton@zamora.org,2021-12-25,https://www.walton.biz/
09-Sep-2020,Tax,00.00,"68,274.08","614,466.73",e5fAFBfd2C0aA5E,2040,Anita,Kelley,Olsen LLC,Port Jesusmouth,Korea,(568)624-5226x0809,001-436-648-4504x1401,joanna72@krueger.org,2022-01-22,http://haney.net/
09-Sep-2020,IMPS,00.00,"76,808.34","537,658.39",0Dff6c27C8049C4,5539,Chris,Buck,Bowman-Bowen,South Edgarberg,Gambia,948.512.2454x11348,001-472-421-9145x827,damon10@clarke.com,2020-09-29,http://www.santos.biz/
09-Sep-2020,Debit Card,"7,032.00",00.00,"544,690.39",fF431cA5eA804CC,9167,Leah,Kirk,Dorsey-Tapia,West Coltonbury,Heard Island and McDonald Islands,(307)966-9533x63920,834.554.0344x48323,jeffersoncarly@austin.com,2021-06-05,http://boyd-booker.org/
09-Sep-2020,ATM,"200,667.00",00.00,"745,357.39",f597c947aBAA2F9,7424,Hunter,Hinton,"Galloway, Hancock and Davila",Tapiaton,Taiwan,+1-596-344-7702x7655,430.404.9490,owensbethany@mercer-browning.net,2021-02-19,http://www.barber.net/
09-Sep-2020,Transfer,00.00,"372,678.70","372,678.70",ebd25dbbdEFe520,1752,Francis,Hatfield,"Rose, Kaiser and Hinton",West Bailey,Kyrgyz Republic,(630)742-2703,+1-478-990-4022x121,nicholsjasmin@sloan.org,2022-01-29,http://snyder.info/
09-Sep-2020,Miscellaneous,00.00,"186,339.35","186,339.35",5E66598bD13e8e7,1081,Christine,Powers,Wilkerson-Barron,Billberg,Peru,611-535-5732,+1-520-555-6704x82155,cantrellcollin@knapp.info,2021-08-05,http://good-cunningham.com/
09-Sep-2020,Debit Card,"1,688,438.50",00.00,"1,874,777.85",DA4d2afc3e5c831,6524,Jerome,Cruz,Burke Group,Kimland,Cameroon,001-103-754-3644,+1-420-375-0229x3051,allisonscott@colon.com,2021-04-21,https://shepard-waller.com/
09-Sep-2020,IMPS,00.00,"234,347.23","1,640,430.62",e6bFE30AEf105Ab,2587,Destiny,Krueger,Chan-Zimmerman,West Damonburgh,Japan,282-953-7933,188.273.3282x877,mlevine@harper.com,2020-02-04,http://www.campbell.com/
09-Sep-2020,Interest,"194,362.00",00.00,"1,834,792.62",573E2B6D7bcaBCd,7557,Mary,Shaffer,"Schneider, Farrell and Roberson",Allisonville,Costa Rica,(848)579-2936x321,+1-480-387-8181,goldenseth@shah.com,2021-06-04,http://www.mercer.org/
09-Sep-2020,Reversal,00.00,"366,958.52","1,467,834.10",cc36BeAf4eCbad1,9902,Vicki,Henderson,"Leach, Patel and Hobbs",Anitafurt,Russian Federation,505.099.2207,(012)644-6802x52532,erocha@davies.com,2020-12-03,https://www.costa.com/
09-Sep-2020,ATM,02.00,00.00,"1,467,836.10",a8Eff9e04AdfC29,2462,Jerome,Pearson,Patel-Costa,Watkinschester,Netherlands,732.495.6762x104,+1-506-597-2261x20206,wolfmiranda@burch.com,2021-09-18,https://strickland.biz/
09-Sep-2020,Cheque,119.60,00.00,"1,467,955.70",1a1F80b3401c7aD,2007,Robyn,Acevedo,Cortez Inc,North Joannefurt,Kiribati,754.074.1462x29000,(005)062-3738,gallegospamela@travis-cannon.com,2020-05-24,https://www.sellers-salas.com/
09-Sep-2020,Miscellaneous,00.00,"209,707.96","1,258,247.74",c513D89c6edef91,7852,Malik,Mathis,Stevenson-Lawson,Port Vanessafurt,United Arab Emirates,943.061.0276,(033)345-5530x2128,katelynroberson@chung.com,2020-04-21,https://www.good.org/
09-Sep-2020,Transfer,121.48,00.00,"1,258,369.22",0AC4c7be5d76EeC,8252,Glenn,Wolfe,"Terrell, Cummings and Mills",Melodyside,Chad,(622)504-8575x47611,641.132.4694,mary36@peterson-barber.net,2021-07-26,https://allison.com/
10-Sep-2020,ATM,00.00,"179,767.03","1,078,602.19",7cF3fA9AdFcde2c,6760,Allison,Atkinson,Adkins Ltd,East Terriland,Christmas Island,(958)827-1468x209,(456)003-6382x6288,brandon82@hernandez.com,2020-08-18,http://acosta.com/
10-Sep-2020,RTGS,191.00,00.00,"1,078,793.19",4f610f6dFaEEc2d,1275,Carl,Bowers,Boyd-Kane,Pedrofort,Macao,+1-179-081-7854x918,4625387594,ethan09@orr.com,2020-05-21,http://watson.org/
11-Sep-2020,Reversal,00.00,"359,597.73","719,195.46",ff1EbB26C67d74e,9080,Mariah,Pineda,Greene-Curtis,Brandiland,Australia,(167)216-1328,001-027-222-7858x7574,blankenshipjillian@davidson-mcdonald.com,2020-05-31,https://www.sullivan-chambers.com/
11-Sep-2020,Transfer,"452,610.00",00.00,"1,171,805.46",5cFFde2c204F3dc,5627,Eileen,Meza,Mullen LLC,Zunigamouth,Grenada,878-972-3110x9952,001-891-826-5756x5881,blackaudrey@nash.org,2021-06-29,https://www.callahan.biz/
12-Sep-2020,Cheque,"4,916.90",00.00,"1,176,722.36",edC586deA775d9D,9797,Dorothy,Walsh,Frank LLC,West Kathleenside,Switzerland,3482532034,766-109-1303x4862,martinchloe@pitts.org,2021-01-11,https://schwartz.com/
12-Sep-2020,Cash,00.00,"588,361.18","588,361.18",05d0BBD8588dc21,9538,Randall,Chung,Daniel-Stuart,Rileyhaven,Mali,429-485-7232,+1-316-077-0083x122,jonbright@conway.org,2020-09-15,http://www.payne.biz/
12-Sep-2020,Cash,00.00,"58,836.12","529,525.06",b4Fd62e2cC113df,3712,Hayley,Steele,"Alvarado, Drake and Molina",Carlberg,Angola,841.534.8981,205-718-0628x521,chase92@mcfarland.com,2022-04-23,http://www.lucas.com/
12-Sep-2020,NEFT,"260,382.60",00.00,"789,907.66",fF36d9FeEf6f876,6415,Carolyn,Vance,Gonzalez LLC,North Wyatt,Swaziland,+1-338-997-6048x52664,353.993.8509,bergsamantha@bridges.net,2020-04-22,http://juarez-merritt.com/
12-Sep-2020,Debit Card,221.00,00.00,"790,128.66",fE48ffc6070EFcB,8341,Brendan,Walsh,Powers Inc,Blackwellville,Kazakhstan,(851)895-5397,(512)174-3113x100,iobrien@fox-boyer.com,2020-05-18,https://singh.com/
12-Sep-2020,Transfer,"545,386.20",00.00,"1,335,514.86",cbE53dCBAD7DCd4,6319,Elijah,Knox,Horn-Riggs,Bradystad,United States of America,(822)937-3685x31944,+1-950-467-7849x6514,hsingleton@sanders.org,2020-11-01,https://www.johnson.com/
12-Sep-2020,Interest,00.00,"190,787.84","1,144,727.02",a099Ffe1bc2ADda,6789,Tracy,Brock,Rubio-Beck,Lake Noah,South Georgia and the South Sandwich Islands,(036)692-3356x75342,001-835-451-8694x975,rebeccasutton@olsen.com,2020-02-24,http://montoya-gillespie.biz/
12-Sep-2020,Debit Card,00.00,"228,945.40","915,781.62",E325c8d31857cEf,2167,Patty,Barrett,Hoover Ltd,New Arthur,Isle of Man,+1-755-739-4688,230.009.0939,dave21@dickson.com,2022-01-21,http://hahn.biz/
12-Sep-2020,Interest,00.00,"91,578.16","824,203.46",387b57da0dC94B0,5166,Alexandria,Mcintyre,Meyers LLC,New Sherriborough,Brunei Darussalam,904-453-6975,(734)439-9764,deanmendez@torres.com,2020-03-10,http://www.melendez-farley.biz/
12-Sep-2020,RTGS,00.00,"274,734.49","549,468.97",9adB0599CaeCCDA,4598,Debra,Price,"Lester, Lucero and Alvarez",Lake Colin,Switzerland,001-942-146-6041,(575)263-2838,dominicsimon@villanueva.org,2021-03-10,http://www.rollins.com/
12-Sep-2020,Interest,781.00,00.00,"550,249.97",2F93cB2Fe98c5CC,2824,Jackie,Larsen,"Zhang, Wiley and Reeves",Brettfurt,Sweden,715-018-8464,493.903.8174x313,leroy10@riggs.biz,2020-07-28,https://www.wang.com/
12-Sep-2020,Commission,"1,910.00",00.00,"552,159.97",E17b7127a53Ca89,3754,Jack,Ali,Reese-Pennington,East Malloryfurt,Saint Pierre and Miquelon,(230)446-7029x229,438.389.5277x5218,geoffrey76@clayton.com,2020-04-25,https://www.franco.biz/
12-Sep-2020,Tax,00.00,"110,431.99","441,727.98",b2729cce9390e94,7256,Alec,Mayo,"Wade, Stuart and Charles",Thomasport,Indonesia,140-002-3731x05445,(486)905-4334x2619,lsingleton@hubbard.com,2020-01-21,http://hampton.com/
12-Sep-2020,Transfer,03.00,00.00,"441,730.98",d8FC702bB32a4ce,3960,Derrick,Koch,"Calderon, Vaughn and Clay",Joannashire,Ukraine,898-158-3507x75118,(829)266-1120,kristy66@kramer.net,2021-08-15,https://www.maddox-stein.info/
12-Sep-2020,Cash,22.00,00.00,"441,752.98",a895a9dfea93dD7,6979,Michael,Beasley,Schroeder LLC,New Cheryl,Togo,001-629-907-7727x336,199.675.0432x0753,jeanettemarshall@gay-haney.info,2020-12-19,https://ward.com/
12-Sep-2020,ATM,00.00,"44,175.30","397,577.68",763d9dc4878e1e9,8380,Mary,Stout,Knox LLC,Larsenfort,Oman,346-454-1116,(918)127-4749x7652,kimberly89@benton-chandler.net,2020-07-12,https://villa-conway.org/
12-Sep-2020,Purchase,413.00,00.00,"397,990.68",9a4fEca87Ad3B50,4153,Sonia,Parrish,Price-Henson,East Lynn,Sierra Leone,+1-722-508-9914x159,001-042-838-8073x168,krista42@hubbard-clayton.info,2021-04-18,https://www.potter.com/
12-Sep-2020,Reversal,00.00,"44,221.19","353,769.49",e3aB1caf3f3a26f,6109,Rose,Curry,"Phelps, Bates and Curtis",Mauricechester,Haiti,374-817-4124x898,001.329.1739x115,camposbradley@stafford.com,2022-03-24,https://www.le.info/
12-Sep-2020,Purchase,406.20,00.00,"354,175.69",cf4DAA75cd7AC14,747,Betty,Soto,Roberson PLC,South Guy,Uzbekistan,3719042212,434-533-6969x900,lcooper@ball-pittman.org,2020-08-29,http://patterson-huerta.com/
12-Sep-2020,Transfer,"2,056,960.75",00.00,"2,411,136.44",f597c947aBAA2F9,7424,Hunter,Hinton,"Galloway, Hancock and Davila",Tapiaton,Taiwan,+1-596-344-7702x7655,430.404.9490,owensbethany@mercer-browning.net,2021-02-19,http://www.barber.net/
12-Sep-2020,Tax,00.00,"267,904.05","2,143,232.39",C6CFa8FFA0E1aEf,4822,Lydia,Mathews,Young-Walton,Kerriland,Finland,378.642.4420x851,227-370-1671,claire32@rollins.org,2020-01-20,https://burgess.info/
12-Sep-2020,Bill,45.70,00.00,"2,143,278.09",34e58FDfe6CeAE6,7559,Derek,Weaver,Glass PLC,Bridgethaven,Peru,(303)511-5921,+1-411-184-3489x96449,swallace@owens-bruce.com,2021-03-02,http://flores-hale.biz/
12-Sep-2020,Cheque,41.33,00.00,"2,143,319.42",e46ee5FfCf07b67,4230,Benjamin,Christian,"Matthews, Garner and Wong",East Devonville,Isle of Man,(157)008-4225,052-577-8374x542,joycesalas@simmons.com,2021-07-13,http://www.reyes.com/
12-Sep-2020,Cheque,00.00,"306,188.49","1,837,130.93",8A43B142f0a4a4C,3594,Ralph,Wyatt,"Mcgrath, Silva and Gill",Guzmanfurt,Maldives,+1-036-485-1474x45841,512-225-9309,olsonsharon@shelton.org,2021-05-24,https://www.whitehead.com/
12-Sep-2020,Cheque,00.00,"306,188.49","1,530,942.44",6f0c451d95cD6be,2042,April,Gardner,"Pham, Koch and Harper",Shellyfort,Bolivia,001-111-310-5141x5762,+1-574-694-7020x2711,patrickfrank@costa.com,2020-08-09,http://mcfarland.com/
12-Sep-2020,Purchase,07.00,00.00,"1,530,949.44",3F6db5cab1AD62c,5659,Isaiah,Kirby,Compton-Valdez,Martinezport,Netherlands,001-965-361-3446,661.632.0153x719,dmcdaniel@elliott-frederick.com,2021-01-26,https://krause-stein.com/
12-Sep-2020,Tax,299.70,00.00,"1,531,249.14",51eDcd67bAcaF0B,5512,Hailey,Murphy,Reed-Mcclain,Bryanside,Lao People's Democratic Republic,0304982075,202-099-2517x45176,warddennis@alvarado.com,2021-09-25,http://cox.biz/
12-Sep-2020,Bill,07.09,00.00,"1,531,256.23",cE26d5BBEc5aeeE,1834,Austin,Knight,Walter-Espinoza,Sheriville,Kazakhstan,+1-994-436-6664x6190,+1-716-520-9719x1785,herbert33@keller-morrow.org,2021-09-29,http://saunders.com/
12-Sep-2020,IMPS,"14,902.60",00.00,"1,546,158.83",b089c72F44cffd7,5889,Brent,Mitchell,Freeman-Riggs,New Laurenberg,Guinea,3911780989,+1-547-044-8725x19874,deckershelley@arias-ryan.com,2020-09-15,https://www.kirby.com/
13-Sep-2020,NEFT,00.00,"171,795.43","1,374,363.40",8C22EBC2100D1AB,6380,Shelley,Benitez,Levy-Oneal,Lanefurt,United Kingdom,(175)896-8255x1995,416-988-4394x66037,sjordan@obrien-wolf.org,2022-04-26,http://boone-salinas.com/
13-Sep-2020,ATM,04.50,00.00,"1,374,367.90",B75cA9DF92eAfAf,466,Collin,Ortega,Daugherty-Stephens,Tanyafurt,Norfolk Island,+1-414-605-9690,091-142-1887x0417,ufriedman@rowland.org,2021-11-05,https://www.norris.net/
13-Sep-2020,Transfer,"2,904.55",00.00,"1,377,272.45",38baedECE07dA6A,272,Jesus,Haynes,Swanson-Glenn,Warrenhaven,Namibia,(592)022-9626,808.651.7562,zramsey@gallagher-briggs.biz,2021-11-13,https://watkins.com/
13-Sep-2020,Transfer,"884,479.50",00.00,"2,261,751.95",ccEd03246F8efF1,5362,Jacqueline,Rocha,Simmons PLC,Port Morgan,Equatorial Guinea,522-050-5801x35272,+1-917-110-7491x6178,cassandra80@wiley.net,2021-01-22,http://www.phelps-quinn.com/
13-Sep-2020,IMPS,00.00,"753,917.32","1,507,834.63",Ad3475Ab9D57a21,9580,Blake,Cuevas,Tran-Ross,North Gabrielamouth,Northern Mariana Islands,997-016-2288x8233,500-431-2197x56505,beverlyhull@sims.info,2020-03-10,http://bradshaw.com/
13-Sep-2020,ATM,00.00,"150,783.46","1,357,051.17",Ba5e827bcF8D9C1,3250,Wyatt,Watts,Jacobson-Buckley,East Krystal,Cambodia,(906)132-0191,961.044.5393x674,nandrews@reynolds.com,2021-04-26,http://irwin.org/
13-Sep-2020,IMPS,05.44,00.00,"1,357,056.61",5CB579BEec65Ff9,9177,Calvin,Garza,"Roy, Frederick and Wilkins",Yvettemouth,American Samoa,408-979-2338x3285,(467)666-4336x25268,buchananmichaela@castro.com,2020-09-17,http://www.gordon-stanton.net/
13-Sep-2020,Debit Card,00.00,"135,705.66","1,221,350.95",BbBAEa65fA91DE2,8695,Derek,Lutz,Schwartz and Sons,West Brianton,Bolivia,+1-020-075-1118,(301)176-0096x0520,dannyjoyce@clarke.com,2020-01-05,http://booth-lynn.info/
13-Sep-2020,Tax,00.00,"407,116.98","814,233.97",5ECC46c9E8cBCaD,3542,Perry,Gutierrez,"Middleton, Sanders and Armstrong",Adamport,Guadeloupe,+1-720-408-1555x905,482-738-1076x035,imedina@sanders.org,2022-04-21,http://www.berry.com/
13-Sep-2020,RTGS,88.38,00.00,"814,322.35",beA6eC6519cf152,1442,Andres,Kemp,"Friedman, Mcbride and Robertson",Kathrynbury,Bouvet Island (Bouvetoya),+1-114-135-7474x8261,199.346.7262x81035,hensleykristopher@medina.com,2021-06-03,https://www.nguyen-berger.net/
13-Sep-2020,Bill,00.00,"135,720.39","678,601.96",fad30DeED369bf6,3328,Jillian,Mitchell,Jimenez-Arroyo,Emmachester,Saint Helena,789-656-7813,(189)134-5789x8290,padillaralph@holloway-morton.com,2020-10-02,http://small.com/
13-Sep-2020,Purchase,00.00,"75,400.22","603,201.74",3bfEE48D2A38B98,111,Chad,Henry,"Gaines, Galvan and Goodwin",Hansonburgh,Cyprus,001-014-140-8925x13758,(560)696-8482,mathisgloria@house-hamilton.org,2020-07-05,https://silva.com/
13-Sep-2020,Commission,00.00,"301,600.87","301,600.87",D00c223EA1F72D1,6906,Summer,Schroeder,"Hebert, Curry and Figueroa",Brandonview,Saint Vincent and the Grenadines,+1-759-893-9156x6299,(463)311-4013x02990,rowejulia@simmons.info,2020-11-13,https://ritter.com/
13-Sep-2020,Purchase,336.81,00.00,"301,937.68",D57ccB50Ba12f4B,4730,Angelica,Todd,Kane-Kirby,Sextonville,Qatar,045-005-7685x739,695-547-9595x936,fcuevas@gill.com,2021-05-29,https://www.powell-le.com/
13-Sep-2020,RTGS,"1,602,771.00",00.00,"1,904,708.68",dC49DdDFcCB1E3B,7860,Katie,Warner,"Bennett, Riddle and Goodwin",Port Cassandramouth,South Africa,001-580-195-2004,+1-981-936-9648x91944,nicholas51@chang-rivers.net,2020-07-11,http://chaney.biz/
14-Sep-2020,Bill,37.63,00.00,"1,904,746.31",93fBece6A07Cbce,8913,Caitlin,Stanley,Espinoza and Sons,West Dylanton,Congo,362-226-7785,728-890-1221,herringariana@evans-stein.com,2021-05-08,http://www.kirby.net/
14-Sep-2020,Interest,00.00,"211,638.48","1,693,107.83",36BdBAE5ED6bb1f,3809,Frances,Hays,Norton-Ruiz,Josephbury,Mongolia,523-110-8071,836.401.7868x1806,randyallen@lozano.net,2020-02-17,http://www.wolfe.com/
14-Sep-2020,Miscellaneous,"534,922.00",00.00,"2,228,029.83",0aBcbaD0A4f8573,1259,Darren,Cisneros,Hoover-Bowers,Port Catherine,Korea,9480260079,014-555-0398x0232,melaniestuart@ferguson.com,2021-02-06,http://www.brooks.com/
14-Sep-2020,Bill,"2,008,229.80",00.00,"4,236,259.63",43eBC5D90A693da,7136,Monica,Steele,Thompson-Reeves,East Rachael,Mali,613-767-0557x968,001-829-947-9873x3668,shelby99@kline.com,2020-09-10,http://huber.biz/
14-Sep-2020,Commission,"2,900.00",00.00,"4,239,159.63",27980Ea6fDfe0ed,2080,Belinda,Buckley,"Joseph, Fritz and Lin",Port Joan,Angola,(288)504-2804,392.031.9185x31100,ihensley@buck.com,2020-02-06,http://www.long-strong.com/
15-Sep-2020,Cash,00.00,"1,059,789.91","3,179,369.72",c94E9DaFec45AFc,3527,Cody,Mason,"Mclaughlin, Thornton and Goodman",South Biancaberg,Croatia,+1-964-268-4513x79272,001-570-841-6028x693,kristinapotts@valentine.com,2021-01-23,https://www.nunez.info/
15-Sep-2020,ATM,00.00,"397,421.22","2,781,948.51",fe9bdADcFAddcAd,6695,Troy,Dodson,Hernandez-Caldwell,North Cliffordborough,Bolivia,8631095209,142-731-6285x45762,george99@lynch.com,2020-10-19,https://steele.com/
15-Sep-2020,IMPS,00.00,"397,421.22","2,384,527.29",64619Ffb49EcFcf,4863,Jeff,Bolton,"Duke, Fritz and Elliott",East Mikaylaberg,Malawi,625.357.5746,001-582-662-6994x687,watsonsarah@tucker.com,2021-01-15,https://chan-rodriguez.biz/
15-Sep-2020,Commission,00.00,"340,646.76","2,043,880.53",Eb17cE4feEb0100,436,Tricia,Fletcher,Franklin Inc,East Kirk,Myanmar,408.412.7123x30688,1024127095,bconner@hartman.com,2020-06-26,http://www.stark-oliver.org/
15-Sep-2020,Commission,00.00,"204,388.05","1,839,492.48",87adbD94A9Da358,5808,Caitlyn,Baker,Crawford and Sons,South Emmaport,Egypt,929-420-4261x96336,863.059.2922x60640,hlin@espinoza.com,2021-05-09,http://solomon.net/
15-Sep-2020,Reversal,245.00,00.00,"1,839,737.48",F81ABF4F815CE97,4148,Geoffrey,Wright,Kirby-Knapp,Mcclainmouth,Cuba,4861561140,+1-856-841-8569x2916,ellisclinton@conley-cisneros.org,2021-11-23,http://orozco.info/
15-Sep-2020,Transfer,00.00,"204,415.28","1,635,322.20",Dabc9CFbc2B68F5,4872,Deanna,Rivas,Young Inc,Shannonview,Ukraine,001-124-731-4713x2101,(086)167-4958,heathjeffery@zimmerman-farley.biz,2022-04-02,http://www.andrade-abbott.info/
15-Sep-2020,Cash,"1,751,873.50",00.00,"3,387,195.70",C153f9Ee155c248,2826,Dominic,Ray,"Malone, Archer and Hart",West Stanleyton,Sri Lanka,+1-614-370-4863x0042,001-190-226-9005x40823,gmoon@marks.com,2020-05-13,http://www.kirk.net/
15-Sep-2020,Miscellaneous,00.00,"846,798.93","2,540,396.78",07BB05bC419cA26,5996,Marcia,Clayton,Clay Inc,East Shelly,Eritrea,+1-146-457-2837x920,001-705-200-6878x383,hamptonkiara@patrick-mccarty.net,2020-05-14,http://moyer.info/
15-Sep-2020,Debit Card,00.00,"423,399.46","2,116,997.32",dB5776CbACAB33D,6441,Alejandra,Richmond,"Torres, Mcfarland and Matthews",New Stanley,Cuba,+1-220-769-5873x39162,9238123462,nicolasmelton@bowers.info,2020-12-26,https://www.vega-mcgrath.com/
15-Sep-2020,Bill,00.00,"2,116,997.32",00.00,5e835cb625CfCeD,2333,Beth,Wyatt,Rosario Inc,Port Kaitlyn,Antigua and Barbuda,(758)988-7140x04211,077.861.3842x279,tammiegonzales@gill-bowen.biz,2020-01-18,https://www.scott.com/
15-Sep-2020,Reversal,"2,662.99",00.00,"2,662.99",5E7e1AeBC968a7C,5301,Mallory,Hunter,Durham PLC,Kaitlynville,Saudi Arabia,001-725-338-3759x6032,+1-189-543-8404,zmorgan@pineda.org,2022-05-19,https://www.cummings-stevenson.org/
15-Sep-2020,Debit Card,00.00,380.43,"2,282.56",92E817f48CaE609,4116,Vickie,Holt,Dorsey-Klein,Lake Andre,Russian Federation,8035819501,001-364-205-3674x44600,gene05@bird.com,2021-03-08,https://www.walker-rice.com/
15-Sep-2020,Bill,"199,807.00",00.00,"202,089.56",1E0a4D06c687Fab,334,Phillip,Burton,"Gallagher, Hester and Pittman",Michellefurt,Saint Pierre and Miquelon,001-168-779-0247,106.948.4327x14050,dalton27@barron.com,2022-04-06,https://zamora-taylor.info/
15-Sep-2020,Cheque,170.00,00.00,"202,259.56",285767fa959679c,4697,Jordan,Singh,Andrews PLC,West Wandabury,Mozambique,5913132282,979-849-3514,whoward@frazier.org,2021-04-24,https://www.myers.com/
15-Sep-2020,ATM,"16,689.37",00.00,"218,948.93",dFb4Bfeac0FF3Fb,2195,Roberto,Estes,Lindsey-Howard,West Ernesthaven,Namibia,1624703862,530.791.1105x14380,whitney64@woodard.org,2021-10-13,https://walter.com/
15-Sep-2020,Purchase,16.91,00.00,"218,965.84",D0cc89bac5fA9bB,1146,Briana,Chaney,Mcconnell-Kidd,West Tanyafurt,Ethiopia,(281)138-8576x11080,909-746-1999x53242,sknapp@trujillo.biz,2022-04-11,http://avery.com/
15-Sep-2020,RTGS,00.00,"31,280.83","187,685.01",a7A58daFFa207BD,2783,Kathryn,Clay,Garrison-Bond,Kurtburgh,Tajikistan,075.981.0402x6410,+1-698-265-4956x1457,rileyyvette@kane-ruiz.org,2021-11-16,http://www.mills-harper.com/
15-Sep-2020,Cheque,"2,422.57",00.00,"190,107.58",2a223dB2Bb4bAdb,9982,Shirley,Harris,Townsend PLC,New Gregberg,Reunion,001-730-756-2420x7804,567.602.8576x57376,soniachang@huff-vaughan.com,2021-08-01,http://webster.com/
15-Sep-2020,Debit Card,00.00,"31,684.60","158,422.98",39C7aeAcac541B3,9067,Adrian,Shelton,"Kramer, Graves and Stuart",Cowanshire,Italy,2326444838,+1-095-668-8518x26505,uvillarreal@davidson-colon.org,2020-06-15,https://www.rollins-gray.info/
15-Sep-2020,Purchase,00.00,"17,602.55","140,820.43",3F9241ebD6bA4af,9429,Tammy,Ayers,Dillon-Wilcox,Mollyland,Iceland,001-793-724-1718,854.490.6605x8736,glassdana@bernard-barker.com,2021-11-01,http://www.house.com/
15-Sep-2020,Transfer,"8,939.69",00.00,"149,760.12",fbF3CC6AdeE9cCA,9540,Mackenzie,Burton,"Powell, Curtis and Leonard",Haydenside,Falkland Islands (Malvinas),(593)865-2696x6223,(920)402-3842x234,carolynsuarez@matthews.biz,2021-09-27,http://craig.com/
15-Sep-2020,NEFT,"254,614.97",00.00,"404,375.09",AFCd8F626cd7F12,2966,Breanna,Mosley,Mcintosh-Boyer,Mcconnellstad,Chad,001-851-317-7553,342.291.7747x3291,tabithavaldez@rubio-bradshaw.com,2021-03-06,https://aguilar-galvan.biz/
15-Sep-2020,Debit Card,00.00,"134,791.70","269,583.39",f0D30a989eDCEeB,8665,Latasha,Vazquez,Watson Group,Tiffanyfort,Jamaica,+1-534-520-9598,630.654.3068x334,hendersonalison@berger.com,2020-08-22,http://chaney-wall.biz/
15-Sep-2020,RTGS,00.00,"67,395.85","202,187.54",fe29fceCf9ba48C,2748,Danny,Conley,Daugherty Ltd,Blackburnfurt,Ukraine,3802922765,+1-778-578-1087x510,glenda77@hughes.net,2022-03-26,https://bentley.com/
15-Sep-2020,Cash,00.00,"25,273.44","176,914.10",DaB6e166432CbF2,6029,Manuel,Rosales,Alvarez-Marshall,New Philip,Liberia,908-231-8124x3692,001-035-745-3117,shawcaleb@huber.net,2021-08-04,http://www.strong.com/
15-Sep-2020,Miscellaneous,00.00,"35,382.82","141,531.28",e8d61edccAbBced,823,Neil,Hodges,Parker LLC,New Annton,Canada,(222)367-9117x6860,832.577.7967x1431,codywu@petty.org,2021-04-16,https://www.mccann-greer.com/
15-Sep-2020,IMPS,00.00,"28,306.26","113,225.02",7C08F48aaEf7Ac4,8566,Katrina,Benjamin,Holden Ltd,Lake Jackson,Heard Island and McDonald Islands,001-923-084-6290x5195,023-976-4720,tchambers@garcia.biz,2022-05-23,http://chung-wade.com/
15-Sep-2020,Miscellaneous,18.93,00.00,"113,243.95",C3fa29b91d47A67,1427,Valerie,Kemp,Estes Group,Lucerostad,Uzbekistan,001-893-151-4295x693,9612282978,edward22@duran.net,2021-02-16,https://hendrix.com/
15-Sep-2020,Transfer,27.00,00.00,"113,270.95",0a8Df1443cE3b5B,7637,Patricia,Ball,"Hansen, Lane and Flores",Juliemouth,Austria,(166)865-8415,2098073269,kimrobyn@carroll-nixon.net,2021-05-16,http://www.schultz.com/
15-Sep-2020,Cash,218.61,00.00,"113,489.56",7FDE65Cbdd11a44,7246,Rodney,Montoya,"Oconnell, Lowery and Hardin",Butlertown,Ireland,(993)041-5889,001-893-984-1838x89399,bakerbenjamin@levy.info,2021-11-29,http://trujillo-hart.com/
15-Sep-2020,Bill,05.00,00.00,"113,494.56",1e7A405d94b47Cc,8447,Adam,Adkins,"Stewart, Ray and Oneal",North Adriennefort,Comoros,921.627.0407x85103,980-241-6850x69421,hmcknight@bruce.info,2021-10-19,http://robinson-fuentes.com/
15-Sep-2020,Cash,00.00,"56,747.28","56,747.28",8FD1fC4aDFaEA7c,9407,Alvin,Weber,Bartlett-Blankenship,Robintown,Mongolia,2878427621,001-692-667-9675x6845,albertbarron@brock-wilkinson.com,2022-05-17,http://berg.com/
15-Sep-2020,Interest,00.00,"6,305.25","50,442.03",4d4a4fF4A8aB0C9,9107,Sylvia,Love,Bradley PLC,Nicholsonhaven,Sri Lanka,(733)453-8147,(113)534-6546,markstricia@tyler.org,2021-10-08,https://www.moreno.com/
15-Sep-2020,Bill,"2,076,465.00",00.00,"2,126,907.03",C2f62DB8E8e0fAB,74,George,Long,"Cochran, Sweeney and Miles",Damonborough,Cote d'Ivoire,292.292.1103x0768,(252)863-4103x848,yolanda69@rosario.com,2022-01-09,http://www.blankenship.com/
15-Sep-2020,IMPS,"3,019.20",00.00,"2,129,926.23",F56a9EfD12d5fFD,6803,Gregg,Holloway,"Arias, Robertson and Bruce",Lake Bryanmouth,Gambia,+1-575-844-7186x28361,(877)736-7893x2402,nicole94@chambers.net,2020-02-13,http://www.mcguire-kramer.com/
15-Sep-2020,Purchase,74.00,00.00,"2,130,000.23",a69b9F07194EeCD,2993,Shelia,Barrett,Stanley-Allison,Port Antoniotown,Belgium,954-465-1896,(410)937-0441x6133,danstone@casey-lewis.com,2020-09-09,http://melendez-bowman.org/
15-Sep-2020,Commission,57.00,00.00,"2,130,057.23",07a0251Cff0A6Bb,5735,Dale,Pruitt,Burnett Ltd,Port Hollystad,Russian Federation,505-469-2224x227,+1-236-835-9930,xmora@barron.net,2020-05-07,https://pugh.com/
15-Sep-2020,Purchase,"1,360,195.80",00.00,"3,490,253.03",4528d6aBf2Aa4D3,7976,Paige,Hobbs,Valdez Group,Rebekahchester,Montserrat,+1-192-498-7362x89206,356-227-9021x9108,arivas@manning.com,2022-05-01,https://www.rasmussen.info/
15-Sep-2020,Transfer,00.00,"387,805.89","3,102,447.14",Db8ADdfccB0D974,4910,Caitlin,Rasmussen,"Shepherd, Bowen and Middleton",Kentborough,Falkland Islands (Malvinas),(912)701-6858,001-901-333-1000x62136,cortezdillon@monroe.com,2020-07-21,https://www.odom-monroe.com/
15-Sep-2020,Cheque,"13,799.14",00.00,"3,116,246.28",6C9c59C9c4CffDC,5966,Daniel,Francis,Fleming Group,New Philip,Bosnia and Herzegovina,534-857-5285x0167,173.866.6431x96642,suttonhector@welch.com,2021-03-25,http://www.gallegos.com/
15-Sep-2020,ATM,"794,307.00",00.00,"3,910,553.28",c6049BfA0AF2888,6351,Cody,Donaldson,King-Yoder,West Tonimouth,Guinea,761.117.3563x0122,001-986-430-3259x793,rparks@galloway.info,2020-03-28,https://www.benson-ewing.com/
15-Sep-2020,Interest,00.00,"488,819.16","3,421,734.12",d98FAABf74bB3A1,7798,Collin,Anderson,Ryan LLC,New Dustinborough,French Southern Territories,6906995557,(888)199-7958,rhonda09@gould.biz,2021-04-03,http://www.hinton.com/
15-Sep-2020,Cash,479.40,00.00,"3,422,213.52",9D4bE5a541DE155,6082,Angela,Zavala,"Barrett, Ryan and Duffy",Lake Casey,Cuba,236.146.3716x973,001-242-668-3982x9471,bryce95@black-harris.com,2020-10-14,https://www.skinner-grimes.biz/
15-Sep-2020,Commission,00.00,"427,776.69","2,994,436.83",1d0D5dbCfB33Fb6,3491,Jacqueline,Yang,Durham-Frederick,Braunfort,Bhutan,(763)091-7981,(529)044-0294,pittsarthur@booth.com,2021-08-30,http://mcintosh.com/
15-Sep-2020,Miscellaneous,00.00,"499,072.81","2,495,364.02",cD70f8c8EF5eAE4,1889,Jesus,Gonzales,"Hammond, Leon and Gilbert",Barreraburgh,Gibraltar,210.562.3331x327,549-231-4687,whuang@lin.com,2021-04-15,http://www.palmer.info/
15-Sep-2020,Commission,00.00,"277,262.67","2,218,101.35",F415d117DfE19e9,6699,Stacy,Coleman,Craig and Sons,South Haley,Australia,001-904-856-5618x255,001-494-739-8136x93666,margaretgallagher@novak.com,2021-05-16,http://carlson.org/
15-Sep-2020,NEFT,00.00,"2,218,101.35",00.00,F1Ca8d02B50CDfE,6355,Mindy,Christensen,Harmon-Sloan,Lake Kristaview,Bouvet Island (Bouvetoya),4839768671,+1-783-125-8650x1535,glen92@petersen-burke.com,2021-05-20,https://www.houston.org/
15-Sep-2020,Bill,01.03,00.00,01.03,79e3dbccCcFDC59,5022,Belinda,Rose,Horton-Velasquez,East Darius,Solomon Islands,001-453-230-8985x249,772-366-1331x29953,timdurham@frost.com,2021-07-28,http://www.bullock-chapman.com/
15-Sep-2020,Reversal,"1,687,673.00",00.00,"1,687,674.03",39EaF5ac3a30efE,7007,Alex,Barrett,"Rivera, Holmes and Carey",Kathrynside,Oman,+1-292-874-6013x76596,(871)032-9340x635,xmorales@munoz.com,2021-01-03,https://www.baird.com/
15-Sep-2020,Debit Card,00.00,"337,534.81","1,350,139.22",3f50Fe6E4C05edb,2127,Cheryl,Juarez,Marsh-Sims,Davebury,Germany,+1-089-557-1139x93718,727-427-2556x7274,katherinecolon@byrd-hickman.org,2022-02-22,https://gomez-patrick.org/
15-Sep-2020,Reversal,00.00,"135,013.92","1,215,125.30",dAEef0Ad6eff05C,4421,Denise,Lee,"Mercado, Osborn and Byrd",Crawfordville,Chile,3523072456,001-383-170-1962x8294,hatfieldpriscilla@zavala.info,2020-10-21,https://www.mason.com/
15-Sep-2020,Cash,00.00,"135,013.92","1,080,111.38",2A7321Cc6E3db6C,6508,Kristina,Pittman,Shah Group,Kelliechester,Uganda,(621)381-9490x603,+1-497-080-9656x14224,icook@lynch.com,2020-11-12,https://hancock.com/
15-Sep-2020,Cheque,"22,879.00",00.00,"1,102,990.38",86EF9efb3bdCc38,228,Ernest,Stafford,Dickson Inc,Wyattmouth,Reunion,618.265.0958,001-363-876-5001x02830,tonyaruiz@farmer.com,2020-03-27,http://www.hatfield.com/
15-Sep-2020,Reversal,00.00,"220,598.08","882,392.30",dCF77D2BB96Cd8d,4995,Debbie,Simon,Kirk PLC,New Bianca,Singapore,(729)969-8630,+1-073-581-7087x279,davepitts@turner.org,2020-10-21,http://www.griffith-morton.com/
15-Sep-2020,Cash,00.00,"126,056.04","756,336.26",3D8aab00f29d9f0,8565,Rickey,Forbes,Michael-Woodward,Brandtport,Holy See (Vatican City State),430-967-1944x594,946-142-8257,marydavenport@blevins.org,2022-04-18,https://www.orozco-zimmerman.com/
15-Sep-2020,NEFT,00.00,"126,056.04","630,280.22",CAeaC9Ac43faf92,2671,Alexandria,Hurley,Estrada-Bernard,West Candice,Vanuatu,425-087-3263x360,245.259.4696x445,mirandatimothy@larson.org,2021-06-06,https://www.franklin-cox.com/
15-Sep-2020,NEFT,00.00,"63,028.02","567,252.20",0f7cA420697A5ba,4036,Sheena,Stafford,Mccoy LLC,West Mallory,Tanzania,(049)437-6283,519.166.0300x861,lestercody@fry-callahan.com,2021-12-21,https://www.lucero-frank.com/
15-Sep-2020,Miscellaneous,00.00,"141,813.05","425,439.15",Fd6F2FBcD6d0d47,6910,Briana,Sparks,"Walker, Blanchard and Combs",West Leeport,Slovenia,610-757-2217x04373,(540)644-0265x96202,qgentry@morrow.org,2020-03-19,https://www.hinton-hooper.biz/
15-Sep-2020,RTGS,00.00,"47,271.02","378,168.13",C94bE3EfEB2dD81,1535,Alice,Maldonado,"Francis, Alvarado and Montgomery",Prestonton,Netherlands,(414)909-5454,316.446.1681,harrisonguy@townsend-underwood.com,2021-11-22,http://david.com/
15-Sep-2020,IMPS,00.00,"126,056.04","252,112.09",6EF41fba31bfe2B,6581,Kristy,Stevenson,"Clements, Rasmussen and Edwards",Port Erinstad,Nigeria,+1-237-707-7926,(989)762-0965,pscott@oneal-riley.org,2021-08-04,http://www.mata-doyle.com/
15-Sep-2020,NEFT,"161,255.20",00.00,"413,367.29",ce6E7e8d603d928,9472,Mathew,Rollins,"Harvey, Acosta and Roman",Maynardshire,Lebanon,+1-556-004-4897,(864)319-5929x03147,barnettlee@price-charles.info,2021-01-03,https://www.huynh-stafford.info/
15-Sep-2020,IMPS,"39,643.00",00.00,"453,010.29",c2f06bA72D77F8E,9622,Holly,Peck,"Golden, Velazquez and Rasmussen",Schaeferville,Netherlands Antilles,+1-152-613-0981x4415,590-363-2553x4696,laura46@hahn.com,2021-07-24,http://www.conley-gould.com/
15-Sep-2020,Tax,"1,801.68",00.00,"454,811.97",c98E6cb1BcbE2a1,9748,Yvette,Estes,Cuevas LLC,Miahaven,Kazakhstan,(256)265-7057x849,(280)322-1933x10035,houstonmarvin@stein.com,2021-11-11,http://www.ball.com/
15-Sep-2020,Tax,00.00,"151,603.99","303,207.98",c3C7ABF384Fdb1a,1558,Kelli,Fry,"Joseph, Cooper and Delacruz",Popefurt,Bosnia and Herzegovina,5310598778,753-323-4406x7484,yharmon@wolfe-haley.com,2021-01-30,https://pugh.info/
15-Sep-2020,Commission,06.00,00.00,"303,213.98",5Cb5F774E18eD4E,4918,Tara,Duke,Kidd Group,Kaitlynmouth,Maldives,(406)761-3203x444,559-211-5351,traceymora@horne-farrell.info,2021-12-22,http://www.meyer.com/
15-Sep-2020,Bill,329.10,00.00,"303,543.08",27D970AE9DeaFCd,1786,Eileen,Knight,Jackson Ltd,Valerieport,India,2676815326,126-758-7046x060,woodsshawna@alvarado.net,2020-10-14,https://dillon.com/
15-Sep-2020,Transfer,00.00,"303,543.08",00.00,e2E1555d16Aeaf6,2952,Bob,Dyer,Abbott PLC,West Guymouth,Eritrea,263.865.8791,+1-366-628-9802x2520,nataliewu@french-cohen.com,2021-04-14,https://lam-duncan.com/
15-Sep-2020,Interest,"37,039.80",00.00,"37,039.80",2900d28b0bAEFC2,3844,Jesus,Oneal,"Maddox, Sanders and Burns",Charleneborough,Cook Islands,+1-033-633-4264x1125,6357255607,ginairwin@mcclain-ramsey.com,2020-11-06,http://waters.com/
15-Sep-2020,Tax,00.00,"37,039.80",00.00,aB989e37Eba5fD7,6743,Ronnie,Frazier,Pineda-Dudley,New Damon,Lithuania,001-309-095-3807,(889)461-4808x1053,ernest11@joyce-yang.com,2020-11-22,http://craig.info/
15-Sep-2020,IMPS,"243,467.50",00.00,"243,467.50",485cb41C4af792C,5892,Kylie,Martinez,Bautista Ltd,New Elijahport,Guinea-Bissau,800.903.0807,186-214-0822x915,wmiddleton@winters.com,2021-08-11,https://www.richards.com/
15-Sep-2020,Bill,"825,841.50",00.00,"1,069,309.00",147387Db3f806D9,5139,Marvin,May,Rivera Ltd,West Katrinaborough,Seychelles,001-320-865-0560x87977,(032)886-6695x04824,tfranco@campos-boyd.com,2022-02-16,http://www.kim.org/
15-Sep-2020,Tax,00.00,"118,812.11","950,496.89",0CEEec4Cf248929,346,Ronald,Bradshaw,Becker-Copeland,Port Priscillafort,United States of America,(338)657-8747x492,001-964-879-7515x5491,isabelburnett@kaufman-stevenson.com,2022-03-31,http://www.grimes.net/
15-Sep-2020,RTGS,"23,474.40",00.00,"973,971.29",DCAA56c14Daf152,6099,Thomas,Stokes,Kirk-Duncan,North Billy,Congo,810.675.1012x2432,001-485-421-7957,anastrong@stevenson-davidson.com,2020-10-05,https://munoz-phillips.biz/
15-Sep-2020,Interest,486.00,00.00,"974,457.29",6dF247a8294745a,9907,Andres,James,"Clark, Navarro and Bentley",Lake Sophia,Haiti,803.654.8431,(439)704-7958x74356,meaganholland@graham.com,2020-03-30,http://osborn.com/
15-Sep-2020,Commission,"132,780.50",00.00,"1,107,237.79",13fc1339AB7BA79,3616,Francis,Montoya,"Pollard, Decker and Young",New Kerri,Saudi Arabia,8324909128,796-533-2047x7347,vbuck@guerrero.com,2022-01-05,http://rocha.net/
15-Sep-2020,Cheque,54.00,00.00,"1,107,291.79",2C7eF6a798DdBCd,5519,Pedro,Montes,Ibarra Ltd,Washingtonview,Bhutan,670-415-5101x1057,001-384-880-7808,hhammond@stafford.biz,2021-02-06,http://johnson.com/
15-Sep-2020,Reversal,421.00,00.00,"1,107,712.79",07D06AAD0A0Dff7,7379,Jesus,Walsh,"Rowland, Michael and Case",Watersstad,Comoros,933-795-5466,348.941.4547,jeffersonselena@meyers.com,2020-11-10,http://harrison-maddox.net/
15-Sep-2020,Cheque,07.75,00.00,"1,107,720.54",9b88BDAbedfDcCA,3848,Clayton,Valentine,Norton Group,North Karifort,Iran,001-320-532-7752x9442,001-754-253-5568x51160,scott58@yoder-salas.com,2021-11-12,https://www.leach.com/
15-Sep-2020,Transfer,47.20,00.00,"1,107,767.74",bEE7450DEeAbF4E,5706,Paul,Glenn,"Carey, Donovan and Carlson",New Robertberg,American Samoa,378.908.5676x61959,(503)493-1276x071,suttonlonnie@callahan-stein.com,2022-05-13,https://castro-cruz.com/
15-Sep-2020,IMPS,00.00,"184,627.96","923,139.78",06338CDfD4a28F1,2531,Cassidy,Mcintyre,Henderson-Wall,West Kirk,Myanmar,+1-823-064-3134x27074,488-001-6150x527,eharding@salazar-wade.net,2021-03-02,https://www.simpson-ayala.com/
15-Sep-2020,IMPS,01.66,00.00,"923,141.44",67f68E6E6193c84,5768,Richard,Livingston,Sampson-Summers,South Hector,Norfolk Island,646-114-9951,+1-306-086-2819x0375,williamsricardo@glenn.com,2021-11-21,http://www.dawson.com/
15-Sep-2020,ATM,43.00,00.00,"923,184.44",6b612C90DfF1BaB,6562,Travis,Ali,"Cox, Macdonald and Pineda",Lake Brian,India,+1-995-411-2041x86598,+1-596-645-9818,derrickbeltran@harrington-gill.biz,2021-05-11,http://www.church-hendricks.com/
15-Sep-2020,Debit Card,06.60,00.00,"923,191.04",Ea428fdd89f7Dd4,9793,Vicki,Gaines,"Aguilar, Chaney and Douglas",Port Brandonchester,Comoros,+1-946-184-1457x407,855.306.7425x22328,phillipsshannon@cannon.com,2021-07-03,http://www.curry.com/
15-Sep-2020,Cheque,"9,881.00",00.00,"933,072.04",F0DcCEdEefdcBC9,6651,Ethan,Lucas,"Adkins, Sampson and Holloway",New Lanceshire,Christmas Island,0601147922,544-055-6222,tbarajas@sparks-mullen.com,2020-02-25,https://www.sloan-keith.com/
15-Sep-2020,RTGS,00.00,"466,536.02","466,536.02",9A1dF9Cd5e3A5c6,8604,Ruth,Fletcher,Reynolds-Schneider,Gabriellamouth,Lesotho,001-005-643-0714x479,932.626.1328x337,francis21@griffith.com,2021-02-22,http://www.berg.com/
15-Sep-2020,Cheque,"2,945.50",00.00,"469,481.52",Af93DD765df4ea8,9101,Keith,Kane,Finley-Gonzalez,Staceybury,Papua New Guinea,883.736.3668x0430,+1-093-724-2338x998,emilyhenderson@quinn.com,2020-05-08,http://www.arnold-hughes.com/
15-Sep-2020,Transfer,00.00,"46,948.15","422,533.37",C25dcD8dFFDCc2F,3835,Faith,Benson,Campbell-Jensen,Sueville,Botswana,001-630-599-4048x9519,+1-516-487-3316x99683,kathy27@rogers.com,2021-10-28,https://www.cooke.info/
15-Sep-2020,Miscellaneous,00.00,"84,506.67","338,026.70",e9A5A0fa9BDE8f5,3044,Max,Fitzpatrick,Barton-Duarte,Port Diamondmouth,Macao,001-783-850-6728x03276,815-776-3679,sheri17@terrell.org,2020-01-21,http://www.holt.com/
15-Sep-2020,Interest,00.00,"338,026.70",00.00,BDd397f32325492,7708,Mitchell,Todd,Ryan Group,West Yvette,Guadeloupe,(868)706-6893x920,8906340980,daryl81@delgado-nielsen.com,2020-08-23,https://www.stout.com/
15-Sep-2020,ATM,510.60,00.00,510.60,86d2884c8c2Eb1c,8636,Kelly,Higgins,Mcfarland Ltd,Port Alexburgh,Korea,(116)584-1850x669,001-801-605-8659x0957,farrelldarin@brooks.com,2021-01-22,http://crosby-brown.com/
15-Sep-2020,Commission,00.00,102.12,408.48,3668D9C0dCFf8eF,3355,Virginia,Matthews,Wall PLC,Roblesberg,Botswana,+1-647-637-7196x9733,716-658-9298x2143,grant17@lopez.com,2022-02-10,https://www.robinson-jennings.com/
15-Sep-2020,Tax,00.00,68.08,340.40,7fdFA5AD5aefEbD,9912,Herbert,Nguyen,Preston-Miller,Port Bradley,Turkmenistan,347-185-7413,+1-729-774-2367,gilbertodom@riggs.com,2020-01-30,https://valenzuela.com/
15-Sep-2020,Purchase,288.88,00.00,629.28,c5cdDcc3dD79dB3,8671,Kelsey,Hanna,Gates-Casey,Annville,Cayman Islands,(165)775-0821,120.853.8737x7571,kristysavage@russell.info,2020-07-18,https://hickman-todd.com/
15-Sep-2020,Debit Card,00.00,69.92,559.36,40977bCDb9d201B,9685,Sherri,Quinn,"Larson, Mccarthy and Johnson",South Kirsten,Vanuatu,994-503-5074,001-967-991-8564,qrodgers@peterson.com,2021-06-08,http://rios.biz/
15-Sep-2020,Interest,"1,615,027.50",00.00,"1,615,586.86",d1f6f0B7A48DA89,9398,Roberto,Morse,Vargas-Brown,Norrisborough,Mauritania,5207953813,(007)527-8078x4004,gilbert06@walter.com,2020-09-11,http://hamilton-dean.com/
15-Sep-2020,Cheque,00.00,"807,793.43","807,793.43",f8cE6F4B175AbF4,4033,Abigail,Nicholson,"Montgomery, Bird and Reid",New Lindsey,Eritrea,3686615279,451-547-3727,kristinoneal@patrick.com,2020-10-29,http://logan-owens.net/
15-Sep-2020,NEFT,23.00,00.00,"807,816.43",4ed105Ed3E2eE2E,6264,Cory,Bright,Solis-Kemp,Lake Kerry,Jamaica,+1-089-887-5391,377-365-4340x626,zfitzgerald@ortega.com,2021-03-10,https://mcknight-casey.com/
15-Sep-2020,Cheque,201.71,00.00,"808,018.14",bf25eA68C8F5A0A,1251,Adriana,Pittman,"Bennett, Moran and Bridges",West Briannaville,India,(682)028-5101x9375,928.856.2138x75019,christinebenitez@howell-oconnell.com,2020-09-03,http://holland-bolton.com/
15-Sep-2020,Bill,"54,630.00",00.00,"862,648.14",eDBe8ceFF4cd853,5413,Shane,Gonzales,Vincent-Hanson,North Miguelville,Macedonia,+1-568-310-9711,001-031-100-9057x119,greggcontreras@hunt-stevenson.net,2020-04-19,http://anthony.net/
15-Sep-2020,Cheque,"2,695.04",00.00,"865,343.18",dbaF05C15EE3f2c,8587,Beth,Best,Schmidt and Sons,Cherylville,Saint Pierre and Miquelon,880.976.4208x71465,128.069.4417x224,cindy63@gordon.com,2021-04-23,https://www.mcdonald.com/
15-Sep-2020,NEFT,38.00,00.00,"865,381.18",8B6ED5b3Aca7fCD,2024,Glenn,Petty,Gamble Inc,South Virginiamouth,Senegal,908.253.3077,+1-514-525-4825x578,cwalter@francis.info,2021-05-05,https://www.harrington.com/
15-Sep-2020,ATM,205.00,00.00,"865,586.18",1De6aB77Bf2bdBc,4595,Kristie,Mcclain,Roth-Buchanan,Tinachester,Venezuela,+1-296-237-3444,001-530-387-5614x74078,rogerstammie@hanna.org,2022-04-03,http://donaldson-maddox.biz/
15-Sep-2020,Miscellaneous,00.00,"432,793.09","432,793.09",EB73D3AFDB37254,9852,Emily,Bush,"Cordova, Joseph and Collier",New Christopherhaven,Gambia,(958)741-2389x213,3687859050,amberburch@watts.org,2020-06-09,https://www.hester-esparza.biz/
15-Sep-2020,Purchase,03.60,00.00,"432,796.69",ff8af69AecCdFCB,4021,Kelli,Wilcox,"Taylor, Hanna and Valdez",Lynnstad,Guyana,615-445-5255,+1-692-624-2700x3041,edward96@greene.org,2022-01-02,http://friedman.com/
15-Sep-2020,Commission,00.00,"108,199.17","324,597.52",19ccceE57F44C75,2918,Marc,Robbins,Keller Group,Aliside,French Southern Territories,001-577-324-0157,+1-563-664-2710,edgar80@gibbs.biz,2020-03-22,https://www.estrada.com/
15-Sep-2020,Cash,00.00,"64,919.50","259,678.02",22fCd7A2AD9C70b,6759,Karl,Knight,"Lawson, Murillo and Sellers",Bernardland,Kyrgyz Republic,(755)283-3944x2268,238.854.5930,heather30@gordon-reynolds.com,2021-01-02,http://www.archer.com/
15-Sep-2020,Interest,"1,638,148.50",00.00,"1,897,826.52",b0bFc35A998Ffcd,9088,Mark,Bennett,Martinez-George,South Mitchelltown,New Zealand,001-535-467-3408x2538,001-568-842-9114x2089,dmcguire@randall-mccarty.biz,2021-02-13,http://mcclain-wheeler.org/
15-Sep-2020,Tax,313.70,00.00,"1,898,140.22",5fBDE5cDc5F4B96,3499,Angel,Kim,Fox-Conrad,Thomasshire,Oman,635.882.8193x809,001-406-615-9671x81681,tomhall@kline.com,2021-08-25,http://www.grant.com/
15-Sep-2020,Debit Card,00.00,"949,070.11","949,070.11",d877afa38D1cA9b,9733,Mallory,Simon,Greer Ltd,Kaitlynview,Latvia,+1-677-772-5531x44267,+1-992-185-4751x2329,jennifer87@ware-le.org,2020-02-01,http://austin.com/
15-Sep-2020,Bill,00.00,"189,814.02","759,256.09",16e7F7b88F77fd2,3918,Bradley,Horne,Walsh LLC,Lake Anthonyside,Swaziland,+1-329-592-0360x702,2651828658,sherribush@sampson-hensley.org,2021-12-24,https://www.huynh.com/
15-Sep-2020,ATM,"12,433.00",00.00,"771,689.09",DA7fB3b0f560FbE,4294,Kathryn,Walters,Stone-Obrien,Marisaton,Morocco,(683)928-6127,184-813-4291,obarajas@gates.net,2021-11-26,https://www.taylor.com/
16-Sep-2020,RTGS,"549,535.00",00.00,"1,321,224.09",FaddddA784EdCeC,9481,Jordan,Nelson,"Roy, Fuentes and Rodriguez",Ianbury,Switzerland,+1-421-248-6063x3976,+1-314-678-9449x0866,gnielsen@walters.com,2020-06-18,https://www.shah.com/
16-Sep-2020,RTGS,00.00,"220,204.02","1,101,020.08",Af5cb1c65CEaaA0,3813,Don,Thompson,Clements LLC,New Max,Cambodia,255-615-1653x21995,9607537041,christinekrause@avery.com,2020-03-30,https://www.grimes.net/
16-Sep-2020,ATM,01.00,00.00,"1,101,021.08",448DF59C5bCCCEf,8526,Mariah,Le,"Hardin, Joseph and Ali",Maryshire,United States of America,(471)654-7244x616,680.905.5189x75923,vzhang@schaefer-mathis.com,2021-06-25,https://www.delacruz.biz/
16-Sep-2020,Tax,00.00,"1,101,021.08",00.00,b0BAD45C54EdAaC,3533,Kerri,Livingston,"Gould, Brooks and Randall",Lake Raymouth,Taiwan,001-615-265-5364x839,746.669.5758,barrymanning@estrada.info,2020-10-13,https://levine.com/
16-Sep-2020,ATM,06.14,00.00,06.14,161bd22cA80F75F,7917,Earl,Cochran,"Blevins, Villarreal and Hartman",Hatfieldberg,Hungary,001-609-859-1582x25977,001-761-549-1494x520,zrichards@cooke.com,2022-01-30,http://www.stuart.com/
16-Sep-2020,Miscellaneous,"2,148.70",00.00,"2,154.84",ed7cf6Ac7cEfDDe,6670,Malik,Garrett,Daniel and Sons,West Mikeborough,Mauritius,(796)329-3007x958,634-445-3652x9612,travisayers@rojas.com,2020-04-16,https://avery-woods.com/
16-Sep-2020,Commission,00.00,359.14,"1,795.70",84A596feF90a58a,4345,Steve,Lozano,Woods PLC,Ballstad,Ireland,440-629-1549,001-422-450-0505,yschneider@silva.com,2020-02-26,https://www.nichols.com/
16-Sep-2020,Tax,00.00,199.52,"1,596.18",dDCBd68d0bAC9DA,9367,Noah,Oliver,Salas-Villarreal,Masseymouth,Bosnia and Herzegovina,001-762-263-8935x57385,440.157.6504x19301,tanner18@ramos-snow.com,2020-02-09,https://www.hawkins-branch.com/
16-Sep-2020,Debit Card,"29,131.08",00.00,"30,727.26",adDD4Da93Dc13ed,2533,Keith,Luna,"Raymond, Sloan and Lowe",Pruittshire,Hungary,001-337-776-1125x7252,701.128.3984,gmacdonald@ramsey.info,2020-01-29,https://www.terrell-everett.com/
16-Sep-2020,Bill,452.27,00.00,"31,179.53",7fD6b78E5647793,3708,Sophia,Parker,"Johnston, Moss and Chase",North Valeriemouth,Estonia,423.574.3684x703,001-678-159-8315,annettebailey@sanders.com,2022-04-19,https://contreras.com/
16-Sep-2020,RTGS,36.29,00.00,"31,215.82",dD0AFa0092C39Ba,7285,Kurt,Schneider,Morton-Swanson,Harrisonbury,Mauritius,871-651-6029,(524)041-1404x458,bestmarcia@carrillo-mccarty.com,2021-01-18,https://www.harmon.com/
16-Sep-2020,Cheque,"254,534.06",00.00,"285,749.88",660D2B16f85dCAe,5401,Max,Ford,Vaughan Group,Port Aaron,Poland,(409)218-0392x3525,494.388.9026x934,dbird@robles-palmer.com,2022-03-03,https://osborne.biz/
16-Sep-2020,Tax,509.20,00.00,"286,259.08",97DE4aDEeAE20ea,8495,Tanya,Padilla,Montes-Andrade,Derekmouth,Canada,815.611.0339x11358,780.016.1349,heidirosario@wise.com,2020-06-06,http://benjamin-francis.com/
16-Sep-2020,Bill,00.00,"286,259.08",00.00,AFCd8F626cd7F12,2966,Breanna,Mosley,Mcintosh-Boyer,Mcconnellstad,Chad,001-851-317-7553,342.291.7747x3291,tabithavaldez@rubio-bradshaw.com,2021-03-06,https://aguilar-galvan.biz/
16-Sep-2020,Purchase,23.00,00.00,23.00,DFEA9B9e090469C,775,Sandra,Maddox,Everett-Ferrell,Lake Elaine,Central African Republic,727.973.4919,(034)917-9924x573,fred20@frederick.com,2020-09-17,https://www.mills.com/
16-Sep-2020,Tax,00.00,04.60,18.40,f8294aFE8dbD3D9,8633,Nicole,Becker,"Hamilton, Riley and Huffman",Jaimestad,Kazakhstan,(263)701-7001x475,601.814.0961x7514,acevedocalvin@frye-huynh.com,2021-01-09,https://www.ballard.com/
16-Sep-2020,Debit Card,"27,637.70",00.00,"27,656.10",EE80FfDDe9fb722,5586,Eileen,Craig,"Bailey, Sanders and Haley",Port Antonioshire,Tanzania,792-238-8526,360-976-9787x92393,isabella56@shepherd-wade.com,2020-06-02,http://www.shaw-ayers.com/
16-Sep-2020,Commission,"550,677.00",00.00,"578,333.10",7cbcfDb0BaC95C8,5121,Xavier,Walsh,Costa Inc,Priscillabury,Vietnam,(380)010-2685x472,737.747.8158,phillippollard@lambert-castillo.biz,2020-04-03,https://www.sanders.com/
16-Sep-2020,Interest,00.00,"57,833.31","520,499.79",CFefa76aB91EaD6,1621,David,Figueroa,Coleman Ltd,New Vicki,Norfolk Island,128.691.1808x0491,+1-251-523-4339x2439,maxwell03@whitaker-shaffer.com,2022-02-19,http://www.green.com/
16-Sep-2020,Commission,"1,606.00",00.00,"522,105.79",CBcfFC286FDc461,356,Rebekah,Barnes,Arias-Montgomery,Bethanytown,Pakistan,(472)810-4201,306-531-6684x302,christianmata@gates.com,2021-02-17,http://patel.biz/
16-Sep-2020,ATM,00.00,"104,421.16","417,684.63",EFcA3215C3be911,5184,Leonard,Ball,Stephens-Griffith,South Genestad,Bangladesh,927-310-2239x608,+1-627-097-5858x334,doris44@gallegos-bartlett.biz,2020-02-04,http://www.silva.com/
16-Sep-2020,NEFT,"11,675.50",00.00,"429,360.13",906cDAbEa82295D,4318,Kristie,Barnes,Singh-Gould,North Kelliefort,Gabon,001-283-756-0086x584,5697954807,cindyjackson@cowan.com,2021-09-14,http://franklin.com/
16-Sep-2020,Reversal,00.00,"47,706.68","381,653.45",0aA5e9F1edda48f,7313,Tabitha,Cameron,Carney LLC,Lake Brandyberg,Brunei Darussalam,038-520-5566x947,0382115577,justinmccormick@spence.info,2021-08-16,http://www.bradley.com/
16-Sep-2020,Tax,"1,972,385.50",00.00,"2,354,038.95",f8fdd6eb0aBEA56,3119,Hailey,Carson,"Cruz, Miranda and Strickland",South Madison,Tanzania,838.989.7473x2185,001-155-794-5873,andre51@doyle.biz,2020-10-30,http://haynes-olson.com/
16-Sep-2020,IMPS,"1,860,241.25",00.00,"4,214,280.20",a7d0EC4e58d4f96,6086,Devon,Winters,"Duarte, Best and Dickson",Kennethville,New Caledonia,001-181-585-8750,(500)554-8381x11926,kreese@barker.biz,2022-03-18,https://www.frey.biz/
16-Sep-2020,Miscellaneous,12.02,00.00,"4,214,292.22",A3872DfDeE7c365,6969,Dustin,Vega,Lutz-Mcconnell,East Lisafort,Cook Islands,754-525-9152x2253,978.609.6081,alyssa93@caldwell-burch.com,2021-12-03,https://frost-garrison.com/
16-Sep-2020,RTGS,00.00,"4,214,292.22",00.00,C26cED02b46aB8E,4583,Joy,Preston,Moore-Jennings,Port Ana,United States Virgin Islands,+1-412-391-4415x56548,001-938-645-3751,gillespieleonard@osborne-tyler.net,2021-08-27,https://www.dillon.info/
16-Sep-2020,Cheque,53.75,00.00,53.75,a9C874eE58b7a0A,9204,Nathan,Patel,Garcia-Wilkins,South Laura,Saint Vincent and the Grenadines,001-938-450-4307x31178,623.910.5075x0045,bartonmikayla@lambert.net,2020-12-03,https://www.dunn.org/
16-Sep-2020,IMPS,"218,786.50",00.00,"218,840.25",d2bd8DC7bb71169,2882,Leonard,Knight,"Hendricks, Lambert and Ashley",West Blakehaven,Benin,733-594-2727x115,(373)503-8797,leslieaustin@atkinson-brady.com,2021-07-30,http://watts-knapp.com/
16-Sep-2020,Bill,00.00,"43,768.05","175,072.20",dD2bD67aFcb8C55,8952,Marcia,Brooks,"Lang, Le and Flynn",Staceyhaven,Austria,001-774-727-2932x540,283-307-2605,zfoley@hubbard.com,2020-02-15,https://kane-edwards.com/
17-Sep-2020,Cheque,00.00,"87,536.10","87,536.10",E4fbA87cB10828c,6209,Cheyenne,Dunn,Duffy-Fuller,Port Tylerburgh,United Arab Emirates,986.886.7584x9792,+1-867-316-7874x419,brookehorn@kaiser.info,2020-12-17,http://dickson-calderon.com/
17-Sep-2020,Purchase,00.00,"10,942.01","76,594.09",6d7c45114cDDFcd,4531,Kyle,Hahn,Jefferson Ltd,Lake Elijah,Georgia,+1-079-281-0682x322,+1-130-510-2910,ohebert@adams.com,2020-12-27,http://www.acosta.info/
17-Sep-2020,Interest,16.00,00.00,"76,610.09",C03446cc839bFEe,7023,Melinda,Kelly,Dennis-Richardson,Bergview,Macao,001-134-209-1820x0690,(826)792-6625x2908,ypotter@hobbs.com,2021-12-15,http://www.cline-hall.com/
17-Sep-2020,Cheque,00.00,"9,576.26","67,033.83",FaaA8bfAdaB01f1,3321,Randy,Holland,Bishop-Douglas,Ashleyport,Mozambique,001-790-196-8507x55281,135-264-4255,jill04@barnett.net,2022-02-21,https://www.vazquez.net/
17-Sep-2020,Interest,30.20,00.00,"67,064.03",3dcD2320355d6eF,4719,Julian,Oconnor,Oneal Ltd,Leeville,Northern Mariana Islands,528-293-8215,475.106.3703x2179,fhuang@prince.com,2020-03-17,http://baxter.com/
17-Sep-2020,NEFT,00.00,"33,532.02","33,532.02",f5ffa85b5dad254,4718,Meghan,Rice,"Mitchell, Murray and Castillo",Zimmermanborough,Slovakia (Slovak Republic),(081)424-8450x2114,7420484061,zpratt@hale-newman.com,2020-01-24,https://fritz-cochran.info/
17-Sep-2020,Bill,00.00,"4,191.50","29,340.52",Eb17cE4feEb0100,436,Tricia,Fletcher,Franklin Inc,East Kirk,Myanmar,408.412.7123x30688,1024127095,bconner@hartman.com,2020-06-26,http://www.stark-oliver.org/
17-Sep-2020,ATM,00.00,"5,868.10","23,472.42",df7F2658A0fba7D,3842,Tamara,Meadows,Morris LLC,New Hector,Saint Pierre and Miquelon,805.083.4915x14617,001-586-747-5624,mariopotter@morales.com,2022-02-21,https://osborne.com/
17-Sep-2020,Bill,00.00,"2,934.05","20,538.37",D36F7eF8aBd5CbB,7376,Clayton,Dean,"Terry, Woodward and Weaver",North Kylie,Vanuatu,(522)845-3975x716,001-655-021-2632x1680,brookebauer@chavez.info,2021-07-15,http://www.coffey-blankenship.com/
17-Sep-2020,NEFT,00.00,"10,269.19","10,269.18",8538BCb0fA0f4Ac,9124,Cole,Burke,Sanders-Reilly,North Dakota,Croatia,915.431.8832,504-500-8868x16488,washingtonsharon@reed-wyatt.biz,2022-01-24,https://lindsey-downs.net/
17-Sep-2020,Interest,00.00,"1,711.53","8,557.65",AB73d3521DDf465,2998,Austin,Huber,Neal and Sons,West Mariaton,Sierra Leone,001-916-912-1940x959,468-368-7309x0505,rhondaheath@mason.info,2021-03-06,https://www.schmidt.com/
17-Sep-2020,Bill,"29,382.90",00.00,"37,940.55",CB31FdfAbFb64DE,5876,Thomas,Moyer,Coleman PLC,Sparksborough,Latvia,(799)996-0165x434,001-590-001-8568x9115,hoodryan@brewer.com,2022-04-27,http://hart-pruitt.org/
17-Sep-2020,Purchase,00.00,"7,588.11","30,352.44",34382663A4AEaB5,6752,Faith,Monroe,Lindsey LLC,Jonesport,Luxembourg,004-624-7123,663.234.6649x3084,ifrazier@andrews.com,2022-02-03,http://meza.com/
17-Sep-2020,Cheque,00.00,"10,117.48","20,234.96",B14CD282C976Eaf,4779,Shirley,Dorsey,Murray-Meyer,Wallershire,Samoa,682-901-8742,302-575-2167x68925,calhounbrooke@blake-mccann.com,2020-03-05,https://turner.info/
17-Sep-2020,Debit Card,00.00,"6,744.99","13,489.97",B3Bce7A98f23dbE,8574,Ebony,Holmes,Short Group,East Bridgetchester,Germany,778.157.1505,(071)131-0056,vhanson@stark.com,2022-01-12,https://browning.com/
18-Sep-2020,Cheque,"1,573,826.00",00.00,"1,587,315.97",8f8c02cFa024d07,3541,Craig,Church,"Medina, Watkins and Barnes",New Kristenshire,Turkey,001-950-991-3471x742,(806)962-2081,nbentley@mack.com,2021-03-31,http://novak-wright.com/
18-Sep-2020,NEFT,"92,612.00",00.00,"1,679,927.97",4E80b48Ae2f5493,4040,Bridget,Trevino,Krause-Stanley,Lake Aimeeside,Andorra,(468)936-1314,3381283810,kingerica@beck.com,2021-07-26,https://howard.com/
18-Sep-2020,Debit Card,07.00,00.00,"1,679,934.97",Ca1e0560c25dD4f,4221,Leah,Shields,Sullivan-Luna,South Mathew,Marshall Islands,612.064.5693x805,555-050-4728x58634,laurieleblanc@floyd.com,2021-05-13,http://walsh-dawson.com/
18-Sep-2020,Commission,"1,929,475.25",00.00,"3,609,410.22",44de5f1dFB08c5a,9455,Breanna,Mccormick,Carlson PLC,North Brianburgh,Equatorial Guinea,919-459-3721x467,9923718720,rfitzpatrick@pitts-castro.com,2022-02-28,http://www.holmes.net/
18-Sep-2020,Debit Card,00.00,"1,203,136.74","2,406,273.48",AE642068F9eBAa4,9466,Rose,Francis,Salazar PLC,Farmerberg,Senegal,(870)390-1588x755,+1-862-571-8518x49957,iperkins@macias.info,2020-12-26,http://bennett.com/
18-Sep-2020,IMPS,788.00,00.00,"2,407,061.48",D714f8EebcA6b80,4299,Patricia,Wise,Wall-Khan,Gainesfurt,Germany,973-818-8867,+1-109-429-8987x03818,sheri69@blanchard-burton.com,2022-03-29,http://www.woodward.com/
18-Sep-2020,Cash,02.34,00.00,"2,407,063.82",e2b607f76FC4bEb,5508,Brittany,Holden,"Haas, Li and Bond",Lake Cassie,Ireland,627-049-2595,659-068-7342,katelynhorne@gross.com,2021-05-25,http://long-hayden.info/
18-Sep-2020,Cheque,"8,285.10",00.00,"2,415,348.92",edc77AeC737eFE3,4156,Gwendolyn,Garner,Singh-Rowe,Kirkmouth,Germany,272.260.9947x31425,(635)171-7588,lorr@duffy.com,2021-03-13,http://little.biz/
18-Sep-2020,RTGS,00.00,"2,415,348.92",00.00,d3f3DCE6AC8C9cA,3758,Joel,Young,Montoya Inc,West Stacieborough,Mauritius,8809752212,3145185212,douglasstout@mccann-gutierrez.com,2020-01-15,https://valdez.net/
18-Sep-2020,Cheque,59.10,00.00,59.10,2aaeCCc007f43c5,5715,Albert,Bean,"Pennington, Kirk and Rasmussen",Jonesland,Paraguay,+1-759-876-1302x57722,001-647-109-9023x377,blanchardearl@butler.info,2020-07-17,https://www.rivas.com/
18-Sep-2020,Interest,"15,055.90",00.00,"15,115.00",D412297EB4CB168,4465,Collin,Osborn,Wilcox-Mason,West Gilbert,Belgium,(470)831-2228x69802,+1-528-279-9197x3584,maryhaynes@barnes-glenn.com,2020-05-27,https://www.bryant.info/
18-Sep-2020,Reversal,480.00,00.00,"15,595.00",1B4D97F5FB38069,4370,Jackson,Cobb,"Curtis, Peterson and Ho",South Don,Palestinian Territory,(832)103-2287x664,(095)304-9152,jeffreyvalenzuela@ross.org,2021-08-12,http://www.callahan-bryant.info/
18-Sep-2020,Purchase,00.00,"3,119.00","12,476.00",aa7d5a114a7cfde,275,Joanna,Carr,Blanchard Group,Farleyburgh,Monaco,457-448-6880,001-329-722-5570,chelsea29@brooks.org,2021-03-28,http://powell-kline.biz/
18-Sep-2020,Interest,00.00,"3,119.00","9,357.00",aeFbeDF92fdbFd3,9027,Thomas,Schneider,"Massey, Warner and Knapp",Port Bradleyfort,Norway,768-743-4708,0490679065,cunninghamkyle@rocha.info,2020-05-04,http://www.peters.com/
18-Sep-2020,Cash,"4,051.85",00.00,"13,408.85",b080f9aa3ABdBFE,5340,Alexandra,Vazquez,Stephenson and Sons,North Kelli,Hungary,2451623774,(114)099-9944,katrinalamb@mendoza.info,2021-02-28,http://sims.net/
18-Sep-2020,Commission,"554,924.20",00.00,"568,333.05",98bF938AbFa3Aab,3655,Candace,Gilmore,Esparza Ltd,Terryberg,Wallis and Futuna,2610336041,+1-001-883-0834x2378,elliottmichaela@jones.com,2021-06-03,http://www.delacruz.com/
18-Sep-2020,Reversal,164.00,00.00,"568,497.05",1c4C0d0BD6ed5c7,1549,Haley,Hendrix,Hogan-Bass,East Cory,French Guiana,+1-389-414-8203,357-981-4453x86295,orocha@hines.org,2021-10-13,https://richmond-johns.org/
18-Sep-2020,NEFT,"2,648.00",00.00,"571,145.05",F5683A50E4fdbF4,5554,Marissa,Hamilton,"Wolfe, Pratt and Knapp",Brittanymouth,Saint Pierre and Miquelon,9641430198,+1-095-178-4420x467,alan94@hanson.com,2020-01-26,https://juarez.com/
18-Sep-2020,Commission,00.00,"114,229.01","456,916.04",F19fBEcE1a740B2,1871,Michael,Davis,"Knapp, Mckinney and Pham",Ariasport,Kyrgyz Republic,148-954-7793x004,(910)768-4838x74095,byrdvanessa@turner.com,2021-10-04,https://petersen.com/
18-Sep-2020,Miscellaneous,00.00,"65,273.72","391,642.32",185BBB7e52feEDA,418,Jack,Maddox,"Welch, Gonzalez and Cardenas",Burnsbury,Estonia,(710)713-1916x5666,404-929-6015x0843,parkcorey@navarro.com,2021-08-31,http://crawford.com/
18-Sep-2020,Reversal,19.60,00.00,"391,661.92",6e5a91cE65CCD61,3325,Ernest,Hurst,Monroe and Sons,Joycechester,South Georgia and the South Sandwich Islands,001-371-539-0088,557.596.6312,camerongregory@camacho-clayton.com,2020-03-02,http://trujillo.com/
18-Sep-2020,Bill,48.00,00.00,"391,709.92",b25Ef74B2cBc04C,7742,Marco,Pineda,Sanders Inc,New Yesenia,French Guiana,267.679.3907x33073,800-361-2465,sharptanner@hawkins.org,2021-10-29,https://www.davis.com/
18-Sep-2020,Bill,00.00,"195,854.96","195,854.96",ef968C34824a798,2288,Sonya,Waters,Beard Ltd,Lake Mindy,El Salvador,127.286.1543x951,793-717-7460x10002,jo58@hanson.com,2021-09-22,https://www.webster-hudson.info/
18-Sep-2020,Cheque,58.00,00.00,"195,912.96",CfD5ED9Ce8b8777,4382,Jennifer,Marquez,Nicholson-Rowland,Lanceville,Equatorial Guinea,935-496-6952,001-624-704-7014x34974,robersoncurtis@huynh-blankenship.com,2020-01-31,https://www.schneider.com/
18-Sep-2020,Transfer,"1,366,820.00",00.00,"1,562,732.96",fE2283cb1B3d4Ed,7711,Diana,Callahan,Schroeder and Sons,Morenostad,Mongolia,+1-732-537-1204x41274,454-167-8992x94236,alexamoreno@stark.org,2020-06-29,https://www.baird.biz/
18-Sep-2020,Cash,00.00,"156,273.30","1,406,459.66",0c4597b8DC6A7CD,3280,Cory,Carr,Morris PLC,Paceside,Montenegro,7912045790,+1-686-883-2057x06271,sally15@hood-delgado.biz,2021-10-11,http://www.delgado.com/
18-Sep-2020,Cash,"159,509.00",00.00,"1,565,968.66",c5dFbBa2CFdcF2B,4655,Kaitlin,Dunlap,"King, Mckinney and Friedman",Lake Clarenceborough,Latvia,156.866.0320x1680,+1-430-285-1288,laceyphillips@leblanc.biz,2020-05-08,https://gray.net/
18-Sep-2020,Cash,11.36,00.00,"1,565,980.02",e4C0A6B675B3E0c,2352,Laura,Galvan,"Ewing, Potter and Townsend",South Levi,Togo,711.936.3917x01274,590.087.5677x3420,alisha76@foster.biz,2020-06-07,http://www.wolfe.biz/
18-Sep-2020,Purchase,00.00,"260,996.67","1,304,983.35",dB9EaFB87bAEfb9,1378,Cynthia,Charles,Powers Group,Leeside,Costa Rica,(675)391-9476,(181)824-1948,xhinton@mooney.com,2022-01-07,https://www.berger-chase.net/
18-Sep-2020,Debit Card,03.50,00.00,"1,304,986.85",A8c6cEDd0DadbD0,9780,Ebony,Price,"Torres, Clements and Barajas",New Mandyhaven,Iceland,095.917.9700,001-463-948-1097x07942,xstein@parrish-hunter.org,2020-09-18,http://watts-bender.net/
18-Sep-2020,RTGS,"250,972.00",00.00,"1,555,958.85",1F7cF53c7ebFc3D,408,Francis,Bradford,Contreras PLC,New Hayley,Sudan,(266)493-2713x08961,241.387.2339x4572,alejandra14@quinn.com,2022-01-11,http://maynard.com/
18-Sep-2020,Commission,00.00,"1,555,958.85",00.00,00bcE7218Abf9ae,8496,Dennis,Collins,Gallegos-Grimes,Arthurchester,Mozambique,6607178773,+1-015-419-8529x96690,kristybarry@chaney.net,2020-10-03,http://wang.net/
18-Sep-2020,Reversal,249.70,00.00,249.70,25CFb6d4DF3aA87,375,Carla,Wolfe,Becker-Howard,Alishaborough,Kazakhstan,520.277.0142x65524,+1-017-185-1301x606,aaron28@arellano-lang.net,2021-01-12,https://www.ayala.com/
18-Sep-2020,ATM,305.70,00.00,555.40,9bB8eC5BF8d309e,5432,Natalie,Underwood,Dorsey-Kelley,Port Annaside,Swaziland,138-428-8532,535-214-1109x6296,cody84@watts.org,2022-05-22,http://daniels-barrera.com/
18-Sep-2020,Reversal,"2,532.37",00.00,"3,087.77",4E7Be70DAB6Ffd0,5262,Kelsey,Alexander,"Sparks, Anderson and Moss",New Mariahview,Panama,(666)582-3953x01200,645.813.6338x37353,cameronregina@velazquez.com,2020-03-20,http://www.black.com/
18-Sep-2020,Commission,710.30,00.00,"3,798.07",f2eE78D1A6DEe5e,1021,Rachael,Benitez,Hester Ltd,Lawsontown,Mauritania,(694)376-3296x032,+1-774-787-5087x50986,mwalls@salinas-robinson.com,2022-04-29,https://horton-rubio.com/
18-Sep-2020,Debit Card,"304,837.00",00.00,"308,635.07",Ef91dcAdAB5cBce,4818,Jonathon,Juarez,"Lambert, Rodriguez and French",West Michaelville,Mexico,(246)335-5597x7534,001-611-385-0383x75796,pmanning@farmer.net,2021-09-26,http://www.melton.com/
18-Sep-2020,Tax,"1,550,760.80",00.00,"1,859,395.87",CCaef27aeB62b2b,7556,Brandy,Fitzgerald,Khan-Robertson,Baileyberg,Switzerland,113.240.8994,619-147-9560,mcgeenicholas@russell.biz,2020-11-24,http://www.novak.net/
18-Sep-2020,Debit Card,00.00,"265,627.98","1,593,767.89",2Eea6cb109d9d3A,2477,Shane,Kidd,"Donaldson, Duke and James",Rileyville,Guadeloupe,512.313.0252,+1-121-432-4001x0082,rachelwalsh@long-stuart.com,2021-10-30,https://ibarra-wall.net/
18-Sep-2020,ATM,00.00,"177,085.32","1,416,682.57",2Fa2CC4f2A2FE5F,3911,Sherry,Eaton,Norman-Bird,Port Caleb,Saint Barthelemy,067.847.9041,(441)811-3647x55239,antonioelliott@williams.com,2020-12-30,http://cannon-berg.com/
18-Sep-2020,Bill,254.00,00.00,"1,416,936.57",81EFBdAddBEb368,9729,Sean,Russo,Garrett-Hines,North Brady,Belize,163-319-5885x351,(893)331-4625,umarks@schaefer.com,2021-03-02,https://www.jenkins.org/
19-Sep-2020,Bill,03.79,00.00,"1,416,940.36",Ad9E80698c5b908,9344,Daisy,Pitts,Patel-Joseph,Gentryside,Somalia,+1-506-458-7905,+1-486-589-0943,bensoncalvin@garrett.com,2022-04-11,https://www.farmer-norris.com/
19-Sep-2020,Interest,00.00,"283,388.07","1,133,552.29",AF693CE1dFfC7ca,1230,Devin,Guerrero,Mcneil PLC,Parkerland,Seychelles,(004)386-7171x42814,791.074.7728x744,sydney91@shaw.com,2020-10-30,https://www.whitehead.com/
19-Sep-2020,Reversal,"738,753.20",00.00,"1,872,305.49",AeC147A9f936A31,6035,Ian,Richard,Christensen-Combs,Rowlandport,Guatemala,361-003-6410x806,657.765.2395x0409,xmathis@hughes.com,2020-11-26,http://www.holland.com/
19-Sep-2020,RTGS,00.00,"312,050.92","1,560,254.58",F6d0c75E3701EFa,1407,Isabella,Stanley,"Ali, Carroll and Carson",Kristineton,Burkina Faso,605.169.5443,001-616-953-7751,morsehelen@fox-serrano.com,2021-06-10,https://sandoval.com/
19-Sep-2020,Commission,00.00,"520,084.86","1,040,169.72",3bB4b2F634769EB,2778,Shari,Webb,Levine LLC,North Kerry,Congo,001-995-730-0093x996,964.216.3445,stacie84@stewart-lee.org,2020-08-14,https://www.duran.com/
19-Sep-2020,Bill,00.00,"104,016.97","936,152.75",C9dBA2f2e264d80,6741,Angie,Huber,"Boyer, Bennett and Kirby",Autumnshire,Bosnia and Herzegovina,960-570-1312x12031,5399319942,gspears@frederick.com,2021-01-04,http://franco.org/
19-Sep-2020,Commission,00.00,"133,736.11","802,416.64",aA9787B3AC0bcb5,6985,Tracie,Clayton,Case LLC,New Pennymouth,Saint Barthelemy,(999)569-0601,520.895.2679,andrewerickson@hurst.com,2020-10-05,http://howe.net/
19-Sep-2020,Commission,00.00,"133,736.11","668,680.53",Dbddb22E3b95AeF,8723,Beth,Boyer,"Moyer, Hicks and Mendoza",South Bob,Sao Tome and Principe,(091)695-6906x10743,889.404.1054x640,anita47@harvey-blair.com,2020-01-01,http://www.reeves.com/
19-Sep-2020,Transfer,"1,675,457.75",00.00,"2,344,138.28",07eea61711B52EE,7644,Abigail,Douglas,Evans PLC,Lake Coleview,Madagascar,0397487452,5464484049,cindyfranco@wyatt.com,2021-03-08,https://www.roy-archer.com/
19-Sep-2020,Interest,00.00,"468,827.66","1,875,310.62",1AacD8d00BB4d0C,6579,Jerome,Peterson,Ray-Cantrell,Armstrongland,Burkina Faso,001-799-619-4368,+1-058-743-7829x24010,jeremyspence@frazier-skinner.biz,2022-02-05,http://www.lindsey-glover.com/
19-Sep-2020,Reversal,00.00,"234,413.83","1,640,896.79",38ce4CDEad0d5de,961,Laurie,Klein,"Harmon, Orr and Shelton",Simsville,Hungary,808-983-7926x498,001-004-146-8210,buckleybrianna@howe-brooks.net,2020-01-10,http://www.sandoval.com/
19-Sep-2020,Tax,69.50,00.00,"1,640,966.29",09A1BEfe9fDBfC6,8303,Madeline,Duran,Goodman-Heath,Adkinsmouth,Suriname,+1-740-048-7084x6045,481.149.8554,fmack@mcknight-chase.com,2021-09-25,http://www.khan.com/
19-Sep-2020,Purchase,06.00,00.00,"1,640,972.29",e9654eCb1eACe2D,4054,Sue,Saunders,Daniel-Schneider,Heidifort,Holy See (Vatican City State),001-538-022-7121x7957,(401)104-8736,qbray@nguyen-cervantes.com,2020-05-04,https://www.barrera.com/
19-Sep-2020,Cash,00.00,"234,424.61","1,406,547.68",BCAB40FE65fE3AD,6260,Vicki,Jordan,"Singh, Velazquez and Mooney",Farmerberg,Taiwan,596.770.5777x8632,(030)096-0051,wcampos@murphy.com,2020-05-31,https://www.roman.com/
19-Sep-2020,ATM,73.40,00.00,"1,406,621.08",9faEb6110a8Ee4a,7627,Cassidy,Cole,"Stevens, Harrison and Hurst",North Cheryl,Finland,671.590.7446,270-560-2602x3653,andrefrancis@romero.com,2021-06-07,https://www.mcmahon.biz/
19-Sep-2020,Debit Card,"31,231.90",00.00,"1,437,852.98",DCFfe9Afb7c021E,2438,Andres,Mcclain,"Pruitt, Campos and Michael",North Charlotte,Tuvalu,(950)523-5640x859,215.140.3308,xmyers@forbes.info,2020-05-17,https://wu.biz/
19-Sep-2020,Reversal,00.00,"1,437,852.98",00.00,A57f47CEF3827Bd,345,Brady,Foster,Crawford PLC,Copelandmouth,Chad,973.879.7109,001-515-619-3114x890,shelby36@lawrence-love.com,2021-05-11,http://joseph.com/
19-Sep-2020,Miscellaneous,"3,704.00",00.00,"3,704.00",947E3b94CAeCEef,7442,Whitney,Neal,Flynn Inc,Freyborough,Romania,219.950.3125,001-499-049-3288x316,gonzalezmarco@moody-madden.org,2021-01-22,https://www.nunez.net/
19-Sep-2020,Miscellaneous,00.00,617.33,"3,086.67",A11c0C6C8c7dBcd,3081,Craig,Richards,"Brennan, Soto and Davenport",Dariusstad,Hungary,772-342-4978,550-900-2636x551,antonio32@bradford-collins.com,2022-01-26,http://reyes.net/
19-Sep-2020,Debit Card,"3,385.00",00.00,"6,471.67",03e4F70c30615cc,1632,Shaun,Miranda,"Fernandez, Cain and Andrade",Brettchester,Madagascar,001-643-182-6509x681,+1-014-206-4887,kwalsh@mccarthy.biz,2021-05-02,http://randall.com/
19-Sep-2020,Miscellaneous,00.00,"1,617.92","4,853.75",aFD13C6748814BC,706,Hunter,Gibson,"Landry, Gay and Reese",Ortizstad,Armenia,540.306.2855x158,895-759-7417x5017,jose08@valdez-friedman.com,2021-10-21,http://rose-mcmahon.net/
19-Sep-2020,Debit Card,00.00,539.31,"4,314.44",4D0407Be283add2,178,Claudia,Woods,Diaz-Rangel,New Angelica,Jamaica,+1-402-413-0629x783,440.385.1482,lonnieguerra@cooke.com,2020-10-17,https://wallace.com/
19-Sep-2020,Cash,00.00,"2,157.22","2,157.22",EAa24E17c1796a1,2670,Austin,Choi,"Mays, Chandler and Mccullough",Port Latoya,Pakistan,+1-374-615-2025x0776,582-087-7990,isaacschroeder@arellano.com,2022-04-21,http://www.frederick-snow.net/
19-Sep-2020,Bill,"258,862.00",00.00,"261,019.22",3f8f26799a8aA42,8543,Cassidy,Bush,Pittman LLC,Tylerland,Korea,9523568511,001-291-424-6590x7698,wooddarlene@stout.com,2020-07-03,http://www.turner.net/
19-Sep-2020,Miscellaneous,00.00,"29,002.14","232,017.08",5E871ea3890cf3c,9917,Ana,Walsh,"Pearson, Christensen and Munoz",East Edwin,Mexico,(642)554-1386x4362,0393261275,preston99@weber-suarez.com,2020-08-16,https://andersen.org/
19-Sep-2020,Tax,"22,504.30",00.00,"254,521.38",9bEeE9D7b6198A7,4724,Colin,Schwartz,"Crawford, Griffin and Walton",Newmanborough,Saint Barthelemy,001-385-081-8644x55451,(937)042-0225x2800,deandrew@alvarez-heath.info,2021-04-17,http://jackson.com/
19-Sep-2020,Interest,00.00,"63,630.35","190,891.04",D76b7da6f820338,8289,Mario,Hines,Gregory-Haas,Derekmouth,Hong Kong,+1-380-426-5692,704-003-8253,sylvia94@benton.com,2020-11-07,http://potter-middleton.net/
19-Sep-2020,Cash,00.00,"27,270.15","163,620.89",10dAcafEBbA5FcA,2,Kristina,Ferrell,"Horn, Shepard and Watson",Aaronville,Andorra,932-062-1802,(209)172-7124x3651,xreese@hall-donovan.com,2020-04-27,https://tyler-pugh.info/
19-Sep-2020,Cash,03.08,00.00,"163,623.97",c5Fe7BDDf600bc1,3586,Teresa,Daniel,Hamilton PLC,Bridgesbury,Western Sahara,+1-083-673-1822x04372,(456)902-6411x61912,cassie07@ross.net,2021-02-13,http://www.harrington.net/
19-Sep-2020,Interest,00.00,"16,362.40","147,261.57",e7EEB79Becdaa19,1767,Robin,Choi,Mason Inc,West Beverlyborough,Honduras,001-751-436-5472,608.680.5837,jordanhernandez@spears.com,2020-06-16,http://christensen.org/
19-Sep-2020,Purchase,00.00,"14,726.16","132,535.41",7fAd6E61F69Cf6D,5200,Alexa,Pena,Steele-Holt,North Priscilla,Saint Helena,+1-265-297-2223,9411190844,sheryl27@olsen.com,2020-03-05,https://johnson.info/
19-Sep-2020,RTGS,03.00,00.00,"132,538.41",594Baf152FE9D31,2731,Michelle,Gay,Schaefer-Archer,Amberburgh,French Polynesia,(437)851-1584x5546,001-362-441-0969x891,jball@marsh.com,2022-01-26,https://pugh.com/
19-Sep-2020,ATM,00.00,"44,179.47","88,358.94",eFd88b7DFC290D8,7100,Steve,Ashley,Washington-Mejia,Soniaside,Australia,(607)586-7753,491-853-2516x6434,tristancollins@donovan.com,2022-01-16,https://bush.biz/
19-Sep-2020,RTGS,378.00,00.00,"88,736.94",7290EbcB2CD6BC5,4029,Toni,Shah,"Burns, Kaiser and Daniels",New Stefanie,United States Virgin Islands,560.336.1443,177-113-6583,tasha29@campos.com,2020-10-18,http://www.stewart-flores.com/
19-Sep-2020,Debit Card,"3,610.00",00.00,"92,346.94",5FbAa0Be5DBfcC8,2747,Jaime,Yu,Weiss Group,East Denisefurt,Singapore,0048330008,4685878041,kendra22@pearson.info,2020-04-11,http://www.mcdonald.biz/
19-Sep-2020,Cash,00.00,"10,260.77","82,086.17",1083767cB9d88Cb,2414,Christopher,Golden,Sanchez-Gregory,North Glen,Cayman Islands,5864021958,6501593062,martinamanda@gaines-cooley.net,2021-10-13,http://osborne.biz/
19-Sep-2020,Bill,"838,790.80",00.00,"920,876.97",34aD98D4ffC2Bf7,8346,Sonya,Oneal,"Peterson, Cochran and Townsend",Parkerville,Botswana,879-240-9912x9047,2727013606,cruzjackie@watts-meza.com,2020-09-28,http://rosario-kidd.org/
19-Sep-2020,Cash,00.00,"153,479.50","767,397.48",ADB1d34A75a39d7,892,Erin,Mora,Singh PLC,East Grant,Western Sahara,(838)235-2113,034.960.0468,leslie18@farmer.info,2021-10-04,https://www.miles.info/
19-Sep-2020,Debit Card,00.00,"95,924.69","671,472.80",c8Cb9D2CcB2C3Ce,2558,Kristi,Pruitt,Freeman-Hernandez,New Amy,Central African Republic,001-821-200-6934x41681,750-473-3631x8420,iwatson@moss.com,2020-07-10,http://bowman-macdonald.com/
19-Sep-2020,Debit Card,255.47,00.00,"671,728.27",f18Da7AFa0436e1,532,Cory,Church,Huynh LLC,Jordanhaven,Czech Republic,141.787.0937,+1-865-621-2697x2755,johnnyhebert@case-erickson.com,2020-03-23,https://cochran.com/
19-Sep-2020,Miscellaneous,"86,843.20",00.00,"758,571.47",b461884Af519dbA,8105,Ebony,Nicholson,Koch-Poole,Cervanteshaven,Nauru,749-788-0219,2071258062,ybean@pittman.org,2021-01-06,https://stuart.com/
19-Sep-2020,Cheque,18.58,00.00,"758,590.05",cDC814CAeCFcbba,2513,Patricia,Austin,Cook-Donaldson,Port Mariomouth,Honduras,+1-442-028-1258x08419,001-134-721-9329x1968,kelly13@adams.com,2021-03-24,http://krueger.info/
19-Sep-2020,Debit Card,77.10,00.00,"758,667.15",bfCcdaFA3086F2C,8233,Rick,Morgan,Robertson Group,New Kelliburgh,Saint Vincent and the Grenadines,+1-198-971-9606,(708)016-3510x3838,robindean@yates.com,2020-12-07,http://whitney-cochran.com/
19-Sep-2020,ATM,00.00,"75,866.72","682,800.44",eC4B194dEbfA1cF,1763,Wyatt,Jennings,Stone-Wallace,Sheashire,Malaysia,4835747678,8557569201,tammynewman@vazquez-diaz.com,2020-11-14,http://www.whitney.com/
19-Sep-2020,IMPS,00.00,"227,600.15","455,200.29",C1dca4AB4BDeFFB,5087,Linda,Mccarthy,Fletcher-Griffith,Port Kirkland,Cambodia,6789256093,3897711337,howestephanie@khan.info,2021-02-22,http://mcdaniel-brady.net/
19-Sep-2020,RTGS,00.00,"91,040.06","364,160.23",aBAfDAF3CA90EC2,2192,Jacob,Perez,Roach-Anthony,Chamberston,Palestinian Territory,+1-098-965-7583x4101,(317)606-3649,katie06@greene-pham.com,2021-06-21,https://mcgee.com/
19-Sep-2020,Reversal,00.00,"121,386.74","242,773.49",bFAC3d409AB5CB2,1084,Lynn,Browning,"Winters, Cook and Preston",Hayeston,Cocos (Keeling) Islands,001-115-781-3358,+1-354-308-7458x51264,asoto@faulkner-bridges.com,2020-07-27,https://www.fields-barber.com/
19-Sep-2020,IMPS,"20,890.50",00.00,"263,663.99",BBBC9D845b9cCf9,6589,Rodney,Massey,Boone Inc,West Rachaelborough,United States Minor Outlying Islands,+1-554-973-9375,(080)267-1052,lindsay08@wilkerson.com,2021-10-17,https://drake.com/
19-Sep-2020,Interest,"2,633.20",00.00,"266,297.19",10778bb483F1c0C,1098,Stacy,Long,Blankenship Ltd,South Katelynton,Congo,(126)344-6570x544,600.473.7761,baileyhardy@burton-brewer.com,2020-03-10,https://www.durham.net/
19-Sep-2020,Bill,00.00,"29,588.58","236,708.61",083E212Babb5CaC,2314,Rebekah,Schwartz,"Gallagher, Small and Mcguire",Garyton,Yemen,001-777-207-2397x10879,976.872.0504,marygross@nguyen.info,2022-01-23,http://www.coleman.com/
19-Sep-2020,Cheque,00.00,"47,341.72","189,366.89",249Fa5FBcaC04bf,8527,Kaylee,Harvey,Payne-Dominguez,West Brittany,Madagascar,115.030.9033x603,(160)939-1663,fritzbrady@evans-barajas.com,2021-07-25,http://www.shannon.info/
19-Sep-2020,Debit Card,06.50,00.00,"189,373.39",d7EdAC9469e30F8,336,Janet,Cisneros,"Mack, Buckley and Vega",Averyport,French Guiana,+1-497-007-0822x525,478-404-8942,jimmymcfarland@mcdonald.net,2020-04-21,https://carlson.com/
19-Sep-2020,Commission,"31,062.30",00.00,"220,435.69",E8A97381Afe1EF3,6716,Jeffery,Carney,Hunt Inc,Port Eduardo,El Salvador,682-695-6846,795.054.9612x92212,jaredsimon@henson.info,2022-03-18,http://roth.com/
19-Sep-2020,Interest,06.50,00.00,"220,442.19",69BCaa79fD11033,8787,Brooke,Proctor,Mcguire-Mitchell,Freemanbury,Heard Island and McDonald Islands,907.544.3388,+1-592-994-6885x766,ymoody@elliott-dalton.com,2020-06-29,https://mata.org/
19-Sep-2020,Tax,00.00,"44,088.44","176,353.75",f2A8dB8a58FF9Ee,1888,Glenn,Lopez,"Norton, Casey and Little",Lake Erinbury,Israel,444.836.0932,(579)185-2818x685,kerickson@summers.com,2021-10-02,http://gray.com/
19-Sep-2020,Debit Card,00.00,"176,353.75",00.00,CB5f4d9842996A2,8729,Jackie,Valenzuela,Chandler Group,Mejiamouth,Ukraine,+1-138-385-9596,049-917-8735,kristaterrell@gilmore.com,2020-11-07,https://mcdaniel-mckinney.info/
19-Sep-2020,NEFT,06.80,00.00,06.80,E3b1341eef400aA,6800,Jody,Bowen,Bolton-Hale,Dyerville,Aruba,(398)706-5415x013,2256173456,randallwesley@santana.com,2021-10-23,https://www.hansen.com/
19-Sep-2020,NEFT,33.00,00.00,39.80,FB9bF1c3ed2bd1D,9835,William,Callahan,"Gill, Ayers and George",Lake Joannbury,Holy See (Vatican City State),(375)325-8218,(157)180-8947x345,andrecastaneda@cook-sweeney.biz,2021-09-06,https://www.cowan-ramirez.org/
19-Sep-2020,Purchase,00.00,13.27,26.53,bbF53eAFa3fc07c,3302,Shelia,Wagner,Humphrey and Sons,Port Jimview,Gibraltar,(620)981-1444x754,108.991.0585,huffmanmichele@kent.com,2021-07-21,http://www.dominguez.net/
19-Sep-2020,Commission,29.05,00.00,55.58,5fE4Fb23Ccee4BA,8405,Tom,Richard,Holden-Moody,New Oliviaburgh,Palestinian Territory,145.373.0443,001-140-867-8884x26696,wellsadrian@hatfield-hardy.biz,2021-05-08,http://hart.org/
19-Sep-2020,Cash,00.00,06.18,49.40,Ba5d97ccb36E6B6,6902,Denise,Sawyer,Lyons LLC,North Warrenshire,Belarus,001-565-991-9313x05394,1194644018,kerri33@gates.com,2020-10-17,https://zamora.com/
19-Sep-2020,Transfer,00.00,04.94,44.46,Af95cfECB6D65f2,8261,Julia,Norris,Terry PLC,North Joelfurt,Aruba,001-558-065-5323x75759,300-092-0951x079,ericksonsuzanne@rocha-pineda.net,2022-03-19,http://glenn.com/
19-Sep-2020,Interest,153.07,00.00,197.53,62C7851C12fe8F9,9894,Chelsea,Peterson,"Pineda, Santiago and Todd",New Glen,Cameroon,755.093.5558,558-875-2788x95565,hendrickstraci@acevedo-olson.biz,2020-01-04,http://www.arnold-waller.biz/
19-Sep-2020,Tax,03.49,00.00,201.02,95459DBFDed3C6F,8606,Shelby,Day,"Campos, Holloway and Sanchez",New Gavin,Mali,1842604672,001-247-758-4393x553,brownashlee@rose.biz,2020-07-18,http://cantrell.com/
19-Sep-2020,Bill,460.68,00.00,661.70,7d23AeaedBEbbDF,5317,Kiara,Berger,Choi-Kline,Lake Cheyenne,Fiji,986-802-9508x19430,+1-550-657-9327x0777,carlhess@cole-todd.com,2021-03-25,http://wright-deleon.org/
19-Sep-2020,Tax,00.00,66.17,595.53,F4A35f06EF4c308,8625,Sydney,Cochran,"Horne, Rose and Roberts",Gutierrezfurt,Greece,034.341.6865,001-227-986-7381x2578,zashley@kerr.com,2020-06-03,http://www.ward.info/
19-Sep-2020,IMPS,"8,995.77",00.00,"9,591.30",e45181925F6b9d6,7822,Robyn,Combs,Conley Group,Port Kristiechester,Trinidad and Tobago,6664906401,001-496-526-2050x14428,tonya38@acosta.com,2021-01-14,https://sheppard.com/
19-Sep-2020,Debit Card,"5,407.00",00.00,"14,998.30",EdC595c710f313f,1909,Caitlin,Boyd,"Frazier, Li and Landry",Wandaville,Austria,496-245-3496x550,366-275-4738x261,javierconner@saunders.com,2021-07-30,https://www.harper.com/
19-Sep-2020,Interest,"2,452.30",00.00,"17,450.60",dEECf5ee84cFe16,5992,Carl,Haley,Johnson-Carson,East Diamondburgh,Tuvalu,567.131.1897x75593,6033767997,nortoncrystal@levy.com,2020-03-31,http://terrell.com/
19-Sep-2020,RTGS,"1,976.40",00.00,"19,427.00",fa6a8a7bfB4dE52,1449,Colin,Skinner,"Potter, Ball and Cherry",Penaville,United States of America,342-908-0660x705,2990684092,dillonbernard@johns-boyd.net,2020-04-30,https://www.gillespie.com/
19-Sep-2020,Purchase,00.00,"4,856.75","14,570.25",46916b29b5AaBDC,2902,Kim,Herrera,"Ewing, Buck and Downs",East Julieland,Falkland Islands (Malvinas),349.270.1548,(600)303-9255x3746,zlane@riddle.info,2021-12-26,http://mosley.org/
19-Sep-2020,Purchase,02.00,00.00,"14,572.25",1C2EB2EbF185cB4,4183,Duane,Pierce,Cooke Group,New Briannaview,Nepal,001-883-608-5731x81952,001-174-852-9037x2935,mstanton@hines-weeks.com,2021-12-04,http://www.conley.org/
19-Sep-2020,Miscellaneous,00.00,"1,457.23","13,115.02",c76Ee68BAC6eA3E,6647,Tara,Trujillo,Medina and Sons,Port Destiny,Mauritania,129.571.7116,632-750-1918x20812,bethanymarquez@vega.com,2021-01-11,http://vazquez.com/
19-Sep-2020,Bill,437.40,00.00,"13,552.42",Ef8b718ab8f0fC6,3416,Warren,Barron,"Jones, Austin and Pollard",West Christieview,Spain,738.351.8061x95718,(611)948-8804x131,hesskaitlyn@haney.com,2022-04-26,http://www.chen.com/
19-Sep-2020,Purchase,00.00,"1,936.06","11,616.36",6cDfAaf87cd992F,104,Terri,Hurst,"Shannon, Patterson and Martinez",Lake Omarbury,Luxembourg,+1-012-633-1812x604,(454)485-5374x59454,vernonrush@harvey.com,2020-06-30,http://www.hurst-johnston.info/
19-Sep-2020,Debit Card,00.00,"2,323.27","9,293.09",2d3EE83ce44AbB2,121,Curtis,Middleton,Bridges-Cortez,Briannashire,Luxembourg,(206)189-5437,+1-667-386-1208x677,vernon36@browning.info,2021-06-28,http://parrish.com/
19-Sep-2020,Tax,"1,949,156.75",00.00,"1,958,449.84",60Ba8E9950f91bD,3880,Elizabeth,Berry,Kramer Inc,Oneillbury,Colombia,(977)177-7586,(571)450-7101,dleach@chase-charles.com,2021-06-12,http://www.walls-swanson.com/
19-Sep-2020,Bill,00.00,"652,816.61","1,305,633.23",e296c0eCD7e0597,8575,Shirley,Schmidt,Friedman Ltd,North Paige,Kuwait,958.456.9495x2791,+1-822-953-1597x7953,owong@kerr.com,2022-04-18,http://winters.com/
20-Sep-2020,Commission,00.00,"1,305,633.23",00.00,c579ECe62f518EB,2825,Willie,Suarez,"Koch, Orozco and Rivera",West Jorge,Grenada,(573)520-7857,007-752-4010,anitaclayton@carey.biz,2021-06-25,https://house-vincent.biz/
20-Sep-2020,IMPS,50.01,00.00,50.01,F32c88af72E729D,8051,Karl,Braun,Benson-Everett,Gravesbury,Eritrea,552.080.6560,001-722-132-5633x52949,zchurch@schmidt.net,2021-03-07,https://www.burch-bender.com/
20-Sep-2020,Commission,00.00,08.34,41.68,f4C0f2DBFbDfeBE,6062,Meredith,Goodman,Meyers and Sons,Richardsberg,Nepal,8683799879,(856)331-1559x60430,ronaldbrady@merritt.com,2020-02-21,http://www.becker-burnett.com/
20-Sep-2020,Cheque,"235,181.50",00.00,"235,223.18",E30e361B14eD1Ec,1639,Bridget,Benton,"Beck, Butler and Duran",Erinfort,Russian Federation,612-119-6547,092-153-0362,wesleywalter@whitaker.com,2022-04-21,https://greer.net/
20-Sep-2020,Purchase,"138,839.70",00.00,"374,062.88",23a1CeD8A626af7,1578,Traci,Cooper,Mcneil-Rose,Karinahaven,Norway,587-562-4038,+1-131-774-0910x143,gloverjeffery@hart.com,2020-12-31,http://www.jordan.com/
20-Sep-2020,NEFT,886.79,00.00,"374,949.67",Cd937a5568Dec2C,8203,Trevor,Travis,Heath Inc,New Kirstenburgh,Honduras,919-740-4577x381,001-129-647-6961x814,gonzalezrobin@small.com,2020-10-07,http://www.hubbard.com/
20-Sep-2020,RTGS,"1,983,915.00",00.00,"2,358,864.67",E8Fbf1f9F918b55,3486,Sonya,Hoover,Cordova Inc,Katrinachester,Ethiopia,4388402490,844.959.0964x9302,mindygregory@campbell-matthews.com,2020-10-16,http://www.goodwin.biz/
21-Sep-2020,Transfer,"903,144.50",00.00,"3,262,009.17",EeDF7F5EFD15f7A,6428,Erika,Hays,Hatfield-Bowman,Shelleystad,Ukraine,290.642.5436x7796,001-898-473-1189x92995,ucarson@rivers.com,2021-05-03,https://www.murillo.org/
21-Sep-2020,Cash,31.00,00.00,"3,262,040.17",4ee662b0fC4B856,7115,Dalton,Montgomery,Sellers-Rich,North Dan,Marshall Islands,+1-755-838-4960x21124,7590908630,noah45@petersen-herrera.info,2022-03-04,https://hensley-peterson.org/
21-Sep-2020,Debit Card,"577,314.00",00.00,"3,839,354.17",42Bd7A50B093dBA,1002,Thomas,Nielsen,Barron-Dickerson,Craigburgh,Nauru,972-236-1317,(728)308-8370x09839,ewilliams@buckley.net,2021-01-06,http://www.fox-kennedy.org/
21-Sep-2020,Transfer,00.00,"959,838.54","2,879,515.63",9d5B02B71952Fa3,9376,Mathew,Howe,Pierce Group,South Lisamouth,Brunei Darussalam,(119)106-1861x643,(960)285-9649,tayloralison@mosley.org,2020-11-10,http://www.weber.org/
21-Sep-2020,Cash,257.30,00.00,"2,879,772.93",e1bF4771028CB13,7047,Bryce,Lara,Carlson and Sons,Bonnieside,Cameroon,(871)437-5366,+1-528-045-7520x5148,gina58@wagner-gomez.com,2020-03-05,http://fox.com/
21-Sep-2020,Commission,32.00,00.00,"2,879,804.93",0A80BAF5eA107CD,1531,Frances,Benjamin,Gonzalez Group,Nancyview,Uzbekistan,9068218250,4690404798,aimee74@morrow.com,2021-12-18,http://horne.com/
21-Sep-2020,Transfer,00.00,"719,951.23","2,159,853.70",aFb3A7eDDBc01dE,9358,Spencer,Murphy,Wallace-Bradford,Flemingville,Saint Martin,+1-220-825-0451x617,+1-827-031-3235,shelleyevans@obrien.com,2021-01-03,http://www.mcmahon.biz/
21-Sep-2020,IMPS,08.00,00.00,"2,159,861.70",cdc1D2a87296EFB,7937,Larry,Powell,"Hancock, Barker and Arroyo",Paulaburgh,Denmark,385.365.9380,(425)392-1565x8247,barnettgilbert@howell.com,2021-11-06,https://briggs.org/
21-Sep-2020,Tax,00.00,"539,965.43","1,619,896.28",d3a6660eeA3cF0E,830,David,Sawyer,Swanson-Hatfield,Alexashire,Burkina Faso,0417685257,204-936-9002x5542,tabitha63@cline.com,2020-04-19,http://pennington.com/
21-Sep-2020,Bill,00.00,"231,413.75","1,388,482.53",d5BC7c20eDDfE31,8474,Jasmin,Moran,"Proctor, Cuevas and Avila",Schroederport,Guyana,7026191274,373.877.6354x1859,theresarivera@hunt-doyle.biz,2020-11-12,http://www.sweeney-floyd.com/
21-Sep-2020,Debit Card,29.27,00.00,"1,388,511.80",6c925e307a5E149,6816,Logan,Lucero,Best-Compton,South Elaine,Solomon Islands,(995)906-2540x998,785.192.8557x801,brichmond@adkins.com,2021-03-22,https://www.keith-allison.net/
21-Sep-2020,RTGS,00.00,"462,837.27","925,674.53",2D5E1ee98d4EfDe,6104,Kyle,Carney,"Foster, Huber and Torres",Lake Alejandro,Sierra Leone,(748)934-3172,+1-513-642-4682,penamikayla@vega-chambers.biz,2022-01-13,http://www.charles.com/
21-Sep-2020,Debit Card,00.00,"925,674.53",00.00,fCdf35dcc0ba4F4,2141,Dylan,Nunez,Robles-Deleon,Gentrymouth,Sao Tome and Principe,(755)537-0900x019,+1-166-079-8569x77574,agreer@wolf.com,2020-11-07,https://www.cooke.com/
21-Sep-2020,NEFT,144.00,00.00,144.00,Fd48683cC1c7f45,5648,Henry,Dickson,Baird Inc,South Diamondville,South Georgia and the South Sandwich Islands,491.915.6303x638,001-430-460-8857x96134,laurenraymond@lozano.com,2021-01-22,https://ali.com/
21-Sep-2020,IMPS,"10,166.05",00.00,"10,310.05",7d8BbfCC9D589aE,7297,Jimmy,Bridges,Acosta-Marshall,Marieland,French Guiana,011-937-0083x486,001-781-076-5363x898,edward53@kemp.com,2020-05-29,http://www.lang.com/
21-Sep-2020,Transfer,00.00,"1,718.34","8,591.71",c4C7fF768a8Dc09,1019,Tami,Olson,Harper PLC,Atkinsberg,Solomon Islands,639-743-0184,(133)407-2922,lstrickland@wang-reid.com,2022-05-19,https://www.burton.com/
21-Sep-2020,Tax,00.00,"1,718.34","6,873.37",294a696c0d8F792,3140,Philip,French,"Dickerson, Russell and Nash",New Daisy,Turks and Caicos Islands,660-138-6815,823-391-6091x3801,aterry@townsend.com,2020-09-27,https://www.parsons.net/
21-Sep-2020,Commission,00.00,"6,873.37",00.00,6df1fB89Dc83DF0,5369,Norma,Morgan,Marshall-Kaufman,South Eduardo,Antarctica (the territory South of 60 deg S),(571)454-3788x68448,001-852-281-1858x693,lwang@ford-lang.info,2021-06-24,http://www.velasquez-diaz.com/
21-Sep-2020,Commission,"515,470.00",00.00,"515,470.00",C1DBc8d4CB9b8F2,338,Carrie,Downs,Barker PLC,New Miaburgh,Jamaica,001-208-863-9743x44787,001-634-376-4921,marilynandrews@cobb-watkins.com,2021-01-05,http://www.leach.com/
21-Sep-2020,Bill,00.00,"85,911.67","429,558.33",8b019Fc206f7601,2365,Amanda,Thompson,"Jacobson, Curtis and Montgomery",Leviburgh,Saint Kitts and Nevis,+1-333-869-4717x79570,(190)186-1138x2786,huertarandy@burnett.com,2021-09-17,https://morris-sutton.org/
21-Sep-2020,Transfer,00.00,"47,728.70","381,829.63",4E6eEF1a78Ab0c5,8916,Theodore,Carson,"Mays, Johns and Landry",Port Laurieborough,United Kingdom,001-082-961-0596,530-044-8762x92319,rachaeldonaldson@byrd-schaefer.com,2021-02-03,https://www.hooper.biz/
21-Sep-2020,Miscellaneous,00.00,"38,182.96","343,646.67",8bcfEc9e49CD708,7961,Billy,Everett,Weber Ltd,East Dustinmouth,French Guiana,001-604-266-9430x6237,+1-607-259-9851x64726,brownmichelle@zuniga-cross.com,2020-01-20,http://www.estrada.com/
21-Sep-2020,IMPS,04.09,00.00,"343,650.76",E7B18739F8AcF0e,9318,Bernard,Marks,Bryant-Jordan,Cliffordport,Nepal,440-371-8918x4073,709.523.8295x42720,simpsonchelsey@clark-morgan.com,2021-07-26,https://andrews.biz/
21-Sep-2020,Cash,00.00,"49,092.97","294,557.79",53eE38FD8B6BabC,2790,Sydney,Atkinson,"Hamilton, Frederick and Browning",New Emma,Netherlands Antilles,304-900-4716x25933,(976)590-6582,crossgreg@gamble.biz,2021-02-21,https://kline.com/
21-Sep-2020,RTGS,55.43,00.00,"294,613.22",BBA220FBFC502E3,3054,Chloe,Chen,Weaver-Evans,Shawntown,France,9822818500,+1-835-475-1323x051,jason36@boyd.com,2022-03-17,https://www.franklin.com/
21-Sep-2020,Interest,"65,694.28",00.00,"360,307.50",CaCCED837B2D6Fc,3663,Kaylee,Keller,Allen-Dyer,Tracieshire,Reunion,635-057-5512,(763)405-9912,lunablake@hebert.com,2020-12-11,http://www.koch.com/
21-Sep-2020,Miscellaneous,00.00,"40,034.17","320,273.33",0e36f9a5AcB10EE,7165,Cole,Munoz,Norris LLC,Michaelaland,Egypt,216.125.1071,878.785.7708x719,pconner@combs.com,2021-10-30,https://www.lyons-mayo.com/
21-Sep-2020,Commission,00.00,"53,378.89","266,894.44",E74b239786C3aeb,2105,Karen,Morgan,"Whitney, Navarro and Williamson",New Yvonne,Egypt,2131743899,589.389.3273,pdalton@rivera.com,2022-01-25,http://www.pace.org/
21-Sep-2020,Debit Card,00.00,"44,482.41","222,412.03",2bB866DaeAb167f,8536,Kiara,Waller,Kaufman PLC,East Marchaven,Taiwan,4468420096,6830074718,melanie03@zuniga.org,2021-07-07,http://rosario.org/
21-Sep-2020,Debit Card,00.00,"31,773.15","190,638.88",Dfe8e5318F1de42,415,Pam,Atkins,Chase and Sons,Lake Leslieborough,Taiwan,7209726342,783.775.8921x2153,gdoyle@hooper-johnston.com,2021-08-25,https://webb.com/
21-Sep-2020,NEFT,"3,235.72",00.00,"193,874.60",aF8D41f3c6D63B9,3482,Kristopher,Butler,Cervantes Group,Soniaside,Georgia,869.376.3007,009.925.7153,imorrison@krause.com,2021-02-26,http://hendrix.com/
21-Sep-2020,Bill,00.00,"96,937.30","96,937.30",3dcD2320355d6eF,4719,Julian,Oconnor,Oneal Ltd,Leeville,Northern Mariana Islands,528-293-8215,475.106.3703x2179,fhuang@prince.com,2020-03-17,http://baxter.com/
21-Sep-2020,Interest,"17,041.00",00.00,"113,978.30",B26fA9cF14Aa65F,5862,Bonnie,Graham,Rowe-Gates,Quinnbury,United Arab Emirates,001-021-184-4884x907,402.848.8587x4544,durhamsonia@acosta-sheppard.net,2020-07-28,https://adams.com/
21-Sep-2020,IMPS,00.00,"56,989.15","56,989.15",7e5DFDD7dFE1BDF,1388,Curtis,Hicks,"Mcfarland, Sheppard and Pineda",Lake Anthonyfurt,Chile,725-107-5500x62862,782.072.7071x164,agentry@rosales-james.com,2022-03-21,https://shaw.net/
21-Sep-2020,Cash,00.00,"9,498.19","47,490.96",4b8BfCd1cf834F2,5254,Raven,Walters,"Nunez, Weeks and Ingram",New Jorge,Bouvet Island (Bouvetoya),001-958-462-0151x591,475-847-5692x4151,rasmussenjeremiah@huber-mccullough.org,2020-01-31,http://richmond-good.org/
21-Sep-2020,Commission,00.00,"23,745.48","23,745.48",3E8Cf7E3A659dE7,9007,Tracy,Hendricks,"Wade, Hinton and Stanley",Khanburgh,Ethiopia,303-000-9339x149,001-198-627-4223,stacey18@davis.com,2020-03-12,https://bautista.biz/
21-Sep-2020,Commission,384.00,00.00,"24,129.48",e1C8646babA6eaE,3150,April,Parrish,"Perry, Morse and Nunez",Pattonhaven,Cayman Islands,+1-982-427-0881x85478,418.246.4531,barrypacheco@atkins.com,2020-11-18,https://www.rowland.com/
21-Sep-2020,Cash,00.00,"2,412.95","21,716.53",7bbb0fD595c6B7D,2727,Christina,Miller,Trevino-Novak,Port Tracieshire,Slovenia,001-224-361-6675,155-904-1270x05264,vhoffman@doyle-bowen.net,2020-05-18,http://www.melton.com/
21-Sep-2020,Reversal,00.00,"10,858.27","10,858.26",f9bb5128EFc5AFF,7588,Billy,Choi,"Hudson, Escobar and Hale",Weberport,Lesotho,(813)201-0450x650,498-440-9723,coffeyrachael@townsend-boyle.com,2020-01-02,http://stephens.info/
21-Sep-2020,Transfer,"13,576.10",00.00,"24,434.36",CF5EDe060e5fCA5,2360,Alec,Page,"Blanchard, Davis and Khan",Joanport,Spain,+1-478-663-0978x6910,452.968.6511x7832,michael46@rosales.biz,2021-03-23,http://www.fitzpatrick.com/
21-Sep-2020,Cash,"3,328.00",00.00,"27,762.36",107A505E4ED6aCf,298,Deanna,Larsen,"Kirby, Berg and Cantu",North Mathewtown,Angola,993.934.2508,001-526-821-9561,arthur45@valencia.net,2020-06-09,https://duarte.com/
21-Sep-2020,Commission,54.30,00.00,"27,816.66",ACEFbfCc013240F,1668,Leonard,Clayton,Acevedo Ltd,Morrowport,Guam,001-894-504-6202x44380,320.174.9665x004,sheena51@oneill.com,2022-02-02,http://www.marshall.info/
21-Sep-2020,Purchase,"373,744.00",00.00,"401,560.66",Aa93B2ef1fdCB80,9754,Martin,Wagner,Mullins-Olsen,Port Tristan,Norfolk Island,(666)360-2604x5646,2686075516,changmark@robertson.info,2022-03-24,http://lynn-beard.net/
21-Sep-2020,Interest,00.00,"401,560.66",00.00,8E975D89df2B5d5,5764,Jared,Carrillo,Benitez Ltd,West Tiffany,Senegal,129-101-8493x03492,001-533-872-1334,christieatkins@goodwin.com,2020-08-07,http://www.clay-tanner.info/
21-Sep-2020,Purchase,"133,782.00",00.00,"133,782.00",8df0CcABE5B8115,3283,Debra,Meadows,Erickson-Daniels,Colonborough,Switzerland,(040)297-2193,243-715-8311,annette96@house-serrano.com,2021-10-29,http://rowland-bonilla.biz/
21-Sep-2020,Tax,00.00,"19,111.71","114,670.29",0b8CfA0897d2C01,3979,Maurice,Harrell,Mathews LLC,West Janice,Kiribati,043-877-8798x60483,1403236697,maddenbrooke@garrison.org,2020-01-01,http://www.estrada-cain.com/
21-Sep-2020,Reversal,00.00,"11,467.03","103,203.26",0B1E3ADB88e0141,9073,Carolyn,Farrell,"Durham, Costa and Deleon",Mariamouth,Timor-Leste,(590)800-3740x2967,2900899021,jacksharp@rojas-maxwell.org,2021-06-26,https://yoder.com/
21-Sep-2020,ATM,00.00,"51,601.63","51,601.63",6618Cf94dEDdC37,6683,Doris,Sawyer,"Moss, Case and Camacho",Bernardstad,Bolivia,071-621-4097,353.944.7625x510,tinasuarez@charles.com,2022-05-08,https://www.tyler.info/
21-Sep-2020,Tax,00.00,"12,900.41","38,701.22",38baedECE07dA6A,272,Jesus,Haynes,Swanson-Glenn,Warrenhaven,Namibia,(592)022-9626,808.651.7562,zramsey@gallagher-briggs.biz,2021-11-13,https://watkins.com/
21-Sep-2020,Bill,"3,214.00",00.00,"41,915.22",1b2ADA1EBbaaa2F,6038,Angelica,Shah,Salinas and Sons,South Cliffordbury,Norfolk Island,922.729.3515,(975)310-7454,alejandro48@graham.info,2020-07-07,http://willis-brooks.info/
21-Sep-2020,Interest,"1,198,182.00",00.00,"1,240,097.22",Ed3Cd4E4ac82cfd,4453,Joanna,Mercado,Wang-Rios,Aimeeland,Hong Kong,530-940-3896x3661,0664740652,ojennings@wong-hampton.com,2020-02-03,http://www.stephenson-rogers.org/
21-Sep-2020,Interest,362.00,00.00,"1,240,459.22",aC11e5F7EdC4DBf,4459,Herbert,Walters,"Huber, Miles and Mcconnell",Kentstad,Wallis and Futuna,(911)965-0929x5709,811.627.2835,pughrandall@velazquez.org,2022-04-17,http://www.willis.net/
21-Sep-2020,Debit Card,"76,232.00",00.00,"1,316,691.22",Ee3ebbc2B0EAE15,6775,Jenna,Quinn,Castillo LLC,New Rebeccaland,Isle of Man,547.660.1202x498,001-397-383-7290,stokesjoel@ryan.biz,2021-04-20,https://www.deleon.net/
21-Sep-2020,Miscellaneous,47.06,00.00,"1,316,738.28",edED0Ab5Ab59eaf,6200,Tanya,Atkins,Rodriguez-Oliver,Aaronstad,Estonia,907.576.5980,+1-096-479-7358x00652,kimwiggins@douglas-marks.com,2020-03-07,https://www.kirk.com/
21-Sep-2020,RTGS,00.00,"164,592.29","1,152,146.00",613BB3cfbd365dE,1592,Brian,Farmer,Boone PLC,Dwayneville,Faroe Islands,724-004-2127x37544,718.868.1908x08464,fmccormick@cowan.info,2022-02-28,https://patel.com/
21-Sep-2020,ATM,67.00,00.00,"1,152,213.00",deEfc43CaB3bB49,6043,Crystal,Cortez,Hays Group,Whitakerland,Grenada,(599)960-0048x42784,493-174-4405,jasminebrennan@cochran.info,2020-03-23,http://www.white-sharp.net/
21-Sep-2020,Reversal,00.00,"115,221.30","1,036,991.70",c25C9c8F6FeCBa4,378,Sydney,Edwards,Hines LLC,New Emma,Denmark,(944)427-1207,050.915.6610x8821,flemingvernon@bean-le.com,2020-04-03,https://www.gibson.com/
21-Sep-2020,Cash,00.00,"172,831.95","864,159.75",FDfd6F4f3b5F4B8,8240,Mariah,Price,Galvan-Serrano,West Mckenzieport,Antigua and Barbuda,001-520-449-3814x917,916.185.1363x08165,frederick50@roth-herman.org,2021-03-07,https://www.johnston.net/
21-Sep-2020,Commission,00.00,"86,415.98","777,743.78",Ab1AEfEaa60Ce5C,7875,Luke,Vaughan,"Knox, Glover and Weber",Gregstad,Bahamas,+1-210-508-7139x12060,779.029.0907,cathycoffey@shah.com,2021-04-04,https://santos-garrett.com/
21-Sep-2020,RTGS,"106,356.97",00.00,"884,100.75",26DA623bcf8BFB2,1806,Joy,Mercer,Cain-Smith,Johnnyview,Cote d'Ivoire,(429)672-7636x6097,944-407-6115x221,maysalyssa@preston-whitaker.com,2020-11-14,http://www.hanna-butler.net/
21-Sep-2020,Bill,"211,883.70",00.00,"1,095,984.45",AD0F1A7b11DeAa0,7173,Troy,Mueller,"Meadows, Pruitt and Powell",Teresahaven,Western Sahara,533-472-0887x81797,0543846659,qstafford@vasquez.com,2021-05-28,http://ibarra-soto.com/
22-Sep-2020,Purchase,00.00,"219,196.89","876,787.56",Beb0D2e4BA54a51,22,Roy,Brock,Becker-Woodard,Port Martha,Zimbabwe,001-102-869-0189x1414,303.040.0780x2768,ldelacruz@spence.com,2021-06-27,https://www.norman.org/
22-Sep-2020,Transfer,00.00,"292,262.52","584,525.04",b7Ea7eE509100FE,3138,Eugene,Washington,Fernandez-Marks,South Anne,Azerbaijan,001-735-929-3910x3271,7019136522,tbruce@spencer.com,2022-04-23,http://holt-robles.com/
23-Sep-2020,Transfer,00.00,"292,262.52","292,262.52",90A0f1E4Fc0CDff,6151,Yolanda,Vincent,Le Group,Walltown,Timor-Leste,+1-787-621-3809x6465,(698)729-9753x13382,adriana01@mack.info,2021-05-26,https://jefferson.com/
23-Sep-2020,Tax,06.60,00.00,"292,269.12",5Feb1837B61cA9f,1747,Alvin,Leon,"Anthony, Salazar and Ashley",Cabrerafort,Guatemala,564-691-5494x42730,8497549506,qcervantes@morton-huerta.com,2020-08-20,http://www.page-hampton.com/
23-Sep-2020,ATM,00.00,"146,134.56","146,134.56",75d998AB58C6E7f,9050,Leon,Mckee,Hartman-Ashley,Port Ebony,Cuba,001-565-864-1872x3520,080.320.8712,autumn51@stuart-monroe.com,2021-05-06,http://www.wood.com/
23-Sep-2020,Tax,00.00,"20,876.37","125,258.19",a1826431dD7449D,3071,Roger,Love,"Melton, Duke and Pineda",Dudleytown,Guam,001-700-047-7198x33688,572-770-2168x075,gabrielle47@kim-allen.com,2020-08-29,http://www.palmer-gaines.com/
23-Sep-2020,Purchase,00.00,"13,917.58","111,340.61",cF7F3FFD67aCC5d,6724,Jade,Hoover,"Robles, Horton and Banks",Tammiefort,Lebanon,3233292648,+1-871-415-3647x629,hickmancameron@moreno-randolph.net,2021-10-27,https://www.perez.com/
23-Sep-2020,NEFT,00.00,"18,556.77","92,783.84",D738bdE54ce14f6,9592,Jasmine,Hammond,Weaver LLC,South Marcview,Kazakhstan,(363)137-4115x33296,630.027.3000x23175,lvillanueva@orr-gutierrez.com,2020-06-11,http://bush.info/
23-Sep-2020,Cheque,"11,194.30",00.00,"103,978.14",3b1F09D26B6b666,8555,Melissa,French,Hurley-Bradford,Fredbury,Mauritania,+1-187-896-6110x93624,001-293-525-9920x217,arianagood@wilkerson-gomez.com,2020-05-20,http://www.bean.com/
23-Sep-2020,Transfer,00.00,"17,329.69","86,648.45",3c4A0F6eC172711,1962,Denise,Medina,Singh Ltd,Nicolasbury,Norway,343-029-3561x287,+1-183-867-2005x8687,greggcortez@simpson.info,2022-03-05,https://www.montoya.com/
23-Sep-2020,Cheque,"250,244.09",00.00,"336,892.54",fB6CF51BBe93581,5490,Steve,Banks,Gibbs LLC,Bonnieburgh,Bolivia,754-800-2044x1732,(707)308-7814,kentpatton@potts.net,2020-12-06,https://www.lester.org/
23-Sep-2020,Cheque,00.00,"112,297.51","224,595.03",a54Ccdf893A10eA,5697,Darryl,Flynn,Gibson-Salinas,Tracytown,Montserrat,(378)466-4147x7865,372-745-6798,amanda77@price.biz,2020-02-02,https://www.owen-roberson.com/
23-Sep-2020,Debit Card,"1,110,742.00",00.00,"1,335,337.03",0889389B1c9bf63,2066,Tanya,Holmes,Kaufman-Marshall,South Thomas,Turks and Caicos Islands,639.257.4677,001-642-440-7290x57943,bridgetbarton@schmitt-case.net,2021-12-20,http://www.watson-graves.org/
23-Sep-2020,Purchase,178.80,00.00,"1,335,515.83",cB6700a0aBcdDD2,5329,Angela,Robertson,Kerr-Schaefer,Caitlinville,United States Minor Outlying Islands,+1-827-877-7887x618,3128707987,calhounpam@mcfarland-blankenship.com,2021-05-22,http://giles.com/
23-Sep-2020,Transfer,00.00,"667,757.92","667,757.92",afdB01fb4CC3ebe,3730,Betty,Peck,"Vincent, Nichols and Hebert",North Darryl,Myanmar,654-694-7354,919.785.8208x4390,freemanjenna@carey-quinn.org,2020-07-27,https://www.wu.biz/
23-Sep-2020,Tax,00.00,"222,585.97","445,171.95",AFa9Bb0e32bfD60,9491,Wayne,Roberts,Brady and Sons,Mitchellville,Iraq,+1-984-991-6960,287.937.6081,wilkinsonrick@suarez.com,2021-02-11,https://www.stout-castillo.com/
23-Sep-2020,IMPS,09.00,00.00,"445,180.95",df1d9e4BDC126d1,889,Sydney,Singh,Maxwell Inc,Eileenmouth,France,009-677-5689x250,+1-541-183-2145x803,dominique06@raymond.biz,2021-09-13,http://walsh-dennis.org/
23-Sep-2020,RTGS,00.00,"44,518.10","400,662.86",Ff6adCd1bdFbac5,4861,Madeline,Moyer,"Bowers, Daugherty and Key",Lake Blake,French Guiana,(710)702-7943,428.564.3700,ilowery@melton.com,2021-02-11,https://prince.org/
23-Sep-2020,Cheque,00.00,"40,066.29","360,596.57",9ccb7ED7CE792D5,3313,Gregg,Moreno,Wood-Preston,Flynnfort,Hong Kong,001-961-208-4968x7047,+1-690-780-8987x532,mccoyryan@simon-vang.com,2021-03-03,http://joyce.info/
23-Sep-2020,ATM,51.00,00.00,"360,647.57",92cC1bEA51B1fdA,3905,Yolanda,Burton,"Blair, Hahn and Mcpherson",New Eddieport,Micronesia,675.506.9832x2301,001-007-313-9532x9738,pedrodougherty@ramos.org,2021-01-16,https://brennan.com/
23-Sep-2020,Interest,13.60,00.00,"360,661.17",c4f04892ee673bE,7252,Melvin,Jenkins,"Mccarty, Browning and Mclaughlin",Port Theodoremouth,Mayotte,001-740-236-4310x0088,308.514.0641x585,marisanewman@drake.com,2022-04-17,https://www.phillips.com/
23-Sep-2020,Transfer,00.00,"360,661.17",00.00,cedFD0EfcFFcab6,6859,Cody,Miles,"Oconnell, Willis and Cortez",Port Fredchester,Faroe Islands,(023)214-9747x52158,307.970.1166,ebonyharmon@kemp.com,2020-08-04,https://www.preston.biz/
23-Sep-2020,ATM,"544,314.00",00.00,"544,314.00",edbbCB5cc47f6Bd,9802,Eileen,Wiley,Moyer Group,New Kristieburgh,Uruguay,651-778-9885x393,+1-411-206-6449x891,cmerritt@wheeler.info,2022-02-04,http://finley.com/
23-Sep-2020,Tax,"323,359.50",00.00,"867,673.50",BA8E2beEeDb11a5,1545,Samuel,Fowler,Fritz and Sons,Louiston,Guernsey,011-473-3474x84387,836.593.3271x90274,lukemejia@pacheco.org,2020-10-29,http://www.farrell.com/
23-Sep-2020,IMPS,443.96,00.00,"868,117.46",Ad13C3a372D7dbe,8151,Fred,Dunlap,"Strickland, Edwards and Chambers",East Dalton,Saint Vincent and the Grenadines,(703)764-8701,(438)683-4357x638,erin07@cherry.biz,2020-05-27,https://www.lloyd-greene.net/
23-Sep-2020,IMPS,00.00,"868,117.46",00.00,Db65bC4bF2d88DE,6061,Tanya,Lowe,"Randolph, Sweeney and Peck",East Joseph,South Georgia and the South Sandwich Islands,590.689.2256,580.202.2754x734,carlhuang@mejia.info,2020-01-10,http://www.mcconnell-ball.com/
23-Sep-2020,Commission,"28,545.00",00.00,"28,545.00",E44e163EB7B0E5f,7733,Leroy,Bernard,Short and Sons,Port Marisa,Turkey,419-084-1803,+1-355-740-5479x22563,qkelley@bernard.biz,2021-12-19,http://mullins-chaney.com/
23-Sep-2020,RTGS,00.00,"7,136.25","21,408.75",ec75Fb9C6A0DcF1,39,Joyce,Foster,Randolph LLC,Nataliestad,Korea,655.928.6486,+1-966-669-6464,samuel97@wyatt.com,2020-10-29,https://www.schmitt.com/
23-Sep-2020,Bill,00.00,"2,676.09","18,732.66",71ddadEfB8ce6cf,9506,Carl,Ray,Stafford-Figueroa,West Summer,Chad,+1-625-385-1844x180,001-464-130-7168,benjaminkim@holder-blake.com,2020-02-07,https://www.huffman-wilcox.com/
23-Sep-2020,Interest,00.00,"2,081.41","16,651.25",AD11aee28Ecc768,413,Jasmine,Brennan,"Conway, Jones and Morton",Charleneview,Tunisia,561.311.5283x5492,398-406-9441x95528,uarroyo@david-greer.net,2021-07-15,http://www.zuniga.com/
23-Sep-2020,Purchase,00.00,"2,081.41","14,569.84",FA40E012DDc1cfd,517,Larry,Davis,"Johns, Mays and Trevino",East Albertborough,Indonesia,357-597-6977x2627,952.479.7884,isabelcooley@newton.com,2022-01-11,http://www.novak.org/
23-Sep-2020,Debit Card,00.00,"1,821.23","12,748.61",C46cEBBCddbA7E8,4972,Wendy,Cole,Dyer-Dawson,New Andreafort,Namibia,573-285-0310x9287,613-520-5408x17089,vbautista@patel-espinoza.com,2022-03-06,https://hansen-holt.info/
23-Sep-2020,Purchase,00.00,"1,593.58","11,155.03",c98E6cb1BcbE2a1,9748,Yvette,Estes,Cuevas LLC,Miahaven,Kazakhstan,(256)265-7057x849,(280)322-1933x10035,houstonmarvin@stein.com,2021-11-11,http://www.ball.com/
23-Sep-2020,Cheque,"1,818.00",00.00,"12,973.03",a3d167a14c934e8,3947,Carlos,Cooley,"Larsen, Gallegos and Ray",Keithshire,Cayman Islands,798.718.5041x29254,001-418-828-6953,rossrusso@larson.com,2020-01-20,https://lindsey.com/
23-Sep-2020,RTGS,58.00,00.00,"13,031.03",f8d8F42fDcE868B,9281,Kayla,Rowland,"Mckenzie, Rhodes and Carpenter",Carolshire,Morocco,820.124.2247,823.999.8276x834,collingay@mckay.com,2021-02-09,http://www.stone.biz/
23-Sep-2020,Bill,"3,156.00",00.00,"16,187.03",5dB06C3Fab5CCCb,9999,Evan,Humphrey,Gould Ltd,Camachochester,Niger,001-465-242-9979,001-639-955-2116x751,velazquezjessica@villegas-wilcox.com,2020-04-14,https://www.payne.info/
23-Sep-2020,Interest,00.00,"8,093.52","8,093.52",0aA69Cdcdddc5a3,3304,Sylvia,Schwartz,"Hahn, Andrade and Ramsey",Meyersside,Bhutan,001-073-347-1249x11972,241-903-3306,kerry64@little-reilly.com,2020-08-24,https://johnson.com/
23-Sep-2020,Tax,725.80,00.00,"8,819.32",ffa51f5D9A3c1B6,8634,Alison,Khan,"Lynn, Curry and Soto",West Lorraine,Uzbekistan,(476)771-5493,4118695896,fbrock@turner-henson.biz,2021-12-19,http://www.king-luna.com/
23-Sep-2020,Commission,"13,511.10",00.00,"22,330.42",88aa37c1B5Bb4Cc,3958,Sophia,Whitney,"Wolf, Hobbs and Houston",North Brooke,Ghana,097-355-9437x28801,+1-139-580-4154x19391,frederickcandice@mata-collins.com,2020-06-02,http://cochran.com/
23-Sep-2020,Purchase,"22,051.18",00.00,"44,381.60",B14CD282C976Eaf,4779,Shirley,Dorsey,Murray-Meyer,Wallershire,Samoa,682-901-8742,302-575-2167x68925,calhounbrooke@blake-mccann.com,2020-03-05,https://turner.info/
23-Sep-2020,RTGS,00.00,"8,876.32","35,505.28",bb60556b68C94fb,5203,Dominique,Salas,Heath PLC,Port Kelly,Serbia,656-092-7456,(868)325-2114x3350,yvonne58@elliott.com,2021-01-16,https://wade.biz/
23-Sep-2020,NEFT,22.30,00.00,"35,527.58",04Bd5F8854C0BB2,1858,Jack,Gordon,Estes-Norton,Lake Mallorymouth,Syrian Arab Republic,560.171.1559,001-717-520-9659x236,beverly55@curry.com,2021-01-31,http://www.price.info/
23-Sep-2020,Cash,00.00,"8,881.90","26,645.68",01edC7DffC4d6cE,9700,Jasmine,Buck,Wang LLC,Pattersonside,Cayman Islands,978-437-2464,(935)947-7473,jacksonruiz@barnett.com,2022-01-17,https://lowery-burton.org/
23-Sep-2020,Cash,00.00,"8,881.89","17,763.79",02FB4f17aCd93E0,9916,Desiree,Beltran,"Wilson, Shepard and Mcbride",Warrenland,Iceland,084-805-4742,+1-620-196-1365x88367,welchlisa@cooke-roberts.com,2021-02-25,http://www.beltran-farmer.com/
23-Sep-2020,IMPS,00.00,"3,552.76","14,211.03",51F91DB8ECaEA2c,3698,Paula,Davenport,Stout-Oconnor,East Jermainefort,Vietnam,863-139-6807x86316,(090)756-1758,watersgabriella@abbott-collins.info,2022-04-08,http://barrett.biz/
23-Sep-2020,Cheque,00.00,"1,776.38","12,434.65",1C6be3affF9cCFe,343,Alexandria,Walters,Obrien-Wise,East Brendaborough,Slovenia,001-480-013-2079x644,642-251-4234x321,clifford91@combs.com,2022-02-10,https://blankenship-mcpherson.com/
23-Sep-2020,Cheque,00.00,00.00,"12,434.65",5E1A0Cd772d3CbF,1156,Shelly,Leach,Glover Inc,South Meaganstad,Nicaragua,001-939-978-0544,+1-783-669-1039x887,arellanoronald@huff-cantu.com,2022-01-26,https://noble-charles.biz/
24-Sep-2020,IMPS,"2,668.20",00.00,"15,102.85",7dDD2eBAAFdc8cE,6421,Sheryl,Barnes,Marshall LLC,Randallmouth,Mongolia,710.217.5270,+1-126-465-1335x8799,shane41@hooper.biz,2020-03-30,http://diaz.info/
24-Sep-2020,Miscellaneous,"128,490.00",00.00,"143,592.85",92aE6a04aA7A906,3762,Marilyn,Blair,Henson-Russell,Moranberg,Mali,+1-174-172-2391,6095577652,kaitlynsimmons@krause.com,2020-09-24,https://long-castillo.com/
24-Sep-2020,Commission,"2,529.40",00.00,"146,122.25",95ACb1DBaB8bf6a,9542,Elizabeth,Santana,Miller Ltd,Port Audrey,Namibia,766-319-5715x460,+1-862-614-3940x908,darrell56@boyd.com,2020-04-15,http://kerr.net/
24-Sep-2020,IMPS,00.00,"18,265.28","127,856.97",f1DEcBE80e6d1C2,6181,Darryl,Dickerson,"Bean, Clay and Finley",Molinamouth,Seychelles,+1-282-684-8402x4846,+1-794-340-8944x005,kaitlynreeves@knox.com,2021-10-02,http://www.ramos.com/
24-Sep-2020,Debit Card,00.00,"21,309.50","106,547.48",E14a4c782E21d11,4694,Dillon,Hogan,Rivers LLC,West Sydneychester,Zimbabwe,529-516-8667,001-868-273-6214x29101,monica18@brennan.com,2022-02-21,https://www.andersen.org/
24-Sep-2020,Reversal,"207,316.00",00.00,"313,863.48",FaaCDAE3c4dbed1,9232,Marissa,Oneill,Schwartz-Charles,Lake Patty,Faroe Islands,0140132738,(838)801-1430,blake12@rodgers.com,2021-06-17,http://www.cruz.org/
24-Sep-2020,Cash,00.00,"78,465.87","235,397.61",45bBbaB4A13AB5c,3002,Leon,Beasley,Gamble-Schmitt,Katherinemouth,Guyana,+1-381-384-2716x7728,(590)235-3858,carneygeorge@daniel.biz,2021-08-31,http://wright.com/
24-Sep-2020,Bill,"246,762.22",00.00,"482,159.83",1D2E4BdDf7eEFde,9824,Caitlyn,Mora,"Liu, Murphy and George",Bowenchester,South Africa,(989)536-5020x567,0791660507,chloehiggins@montes.org,2020-08-02,http://www.gamble-joseph.com/
24-Sep-2020,IMPS,00.00,"48,215.98","433,943.85",baa2B8DaD0720Fa,6279,Mariah,Lowe,"Beltran, Riggs and Franco",Wendymouth,Panama,275.794.3202,+1-461-775-5461,aschmitt@collins.com,2020-10-31,http://www.wheeler.biz/
24-Sep-2020,Miscellaneous,00.40,00.00,"433,944.25",aCAD76DE5cbC79f,5107,Karen,Morton,Mayo and Sons,Dyerbury,Singapore,+1-296-202-4311x5003,001-704-007-9668x9979,ernestunderwood@moore-branch.com,2020-08-24,https://www.haley-graves.net/
24-Sep-2020,Tax,00.00,"43,394.43","390,549.82",F783f58F65e466e,2743,Austin,Jackson,"Gonzales, Padilla and Hudson",West Ricardo,Bouvet Island (Bouvetoya),+1-067-698-6722,264.566.3490,lydia43@ritter.com,2020-08-26,http://russo.info/
24-Sep-2020,Transfer,"253,128.60",00.00,"643,678.42",A1FBac2dDdA8F4C,6613,Peggy,Conley,Dudley and Sons,Domingueztown,Colombia,852-554-2833,202.645.4482,pkline@morris-francis.org,2020-01-15,https://padilla.info/
24-Sep-2020,Debit Card,"26,425.80",00.00,"670,104.22",CF7ad8FF9d0779B,1992,Mariah,Richmond,Patel and Sons,North Sophiamouth,Malawi,299-735-5157x046,001-728-578-5919x896,katherinepatrick@frost-wagner.com,2020-01-06,http://www.hanson.com/
24-Sep-2020,Cheque,"174,935.00",00.00,"845,039.22",eD96b58cbf4aAC5,9057,Autumn,Sims,Guerrero and Sons,Lake Rebekahchester,Sierra Leone,+1-352-652-3975x765,(844)463-4376,qmccormick@walter.com,2021-12-13,http://wood-orozco.com/
24-Sep-2020,RTGS,"89,250.00",00.00,"934,289.22",1d5eE82086E98A7,3160,Gabrielle,Bridges,Rosales LLC,North Yesenia,Azerbaijan,765-096-4468x4093,+1-816-464-0818,andres09@ryan-payne.com,2020-06-25,http://www.bishop-huang.com/
24-Sep-2020,Commission,32.10,00.00,"934,321.32",DD80bF3EA8c49De,8386,Jerome,Stewart,Daugherty PLC,Trevorberg,Qatar,001-502-264-9831x55541,159-409-1076x96655,pollardhelen@moran.com,2020-12-08,http://oconnor.net/
24-Sep-2020,Bill,64.00,00.00,"934,385.32",8dc574003edE1aC,9482,Anthony,Conner,"Henderson, Carlson and Barr",Coleburgh,Serbia,(825)940-3624x8594,282.032.8750x0243,qwalsh@higgins-spears.com,2020-11-13,http://ford-frost.org/
24-Sep-2020,Miscellaneous,00.00,"233,596.33","700,788.99",48aF63FadeDdAa9,1690,Elaine,Davis,Robinson-Schneider,Lake Kristina,Belize,(642)083-1297x9038,001-805-820-6288x787,goldenbridget@rivers-harris.info,2020-08-16,http://www.castillo-lynch.com/
24-Sep-2020,IMPS,00.00,"700,788.99",00.00,14c5dB5d7A7b47f,9009,Rhonda,Simpson,Lester Ltd,South Melindachester,Somalia,710-717-0077,+1-201-825-1891x855,hmejia@stevens.biz,2020-02-29,http://patterson.com/
24-Sep-2020,Tax,"12,993.00",00.00,"12,993.00",4bcdb8D6e19134d,4027,Anthony,Valentine,"Mendez, Frazier and Strong",North Carrie,Turks and Caicos Islands,+1-518-513-8838x0571,(251)891-6871x420,alisonrobinson@mcconnell.com,2022-05-01,https://mason.com/
24-Sep-2020,Debit Card,00.00,"12,993.00",00.00,EA3Ce80DDEB462d,2847,Ana,Haas,Bird LLC,Leeburgh,United States Minor Outlying Islands,001-214-798-8963,654-482-9824x8698,teresa21@mcfarland.biz,2022-04-11,http://powers.com/
24-Sep-2020,Interest,"153,120.20",00.00,"153,120.20",8fdF60b0DA8e78c,8785,Isaac,Evans,"Snyder, Medina and Fowler",South Reneefurt,Seychelles,(568)422-1975x35564,001-975-544-5197,parkstyrone@horton-cooley.com,2020-04-29,https://www.merritt-rich.com/
24-Sep-2020,Debit Card,00.00,"153,120.20",00.00,fd2cEEB0A2DAca5,5372,Cody,Brock,Vaughan-Luna,South Terry,Jamaica,+1-244-071-9879x65702,017-512-9102,padillaalec@dean-rose.com,2021-01-17,https://www.vaughan-heath.com/
24-Sep-2020,Purchase,"14,427.46",00.00,"14,427.46",b3A18AFBb5CFb82,9125,Christine,Daniel,Burnett-Sloan,Melanieton,Samoa,328-249-4605x8660,592.668.0365x207,shortalexis@townsend.com,2020-11-04,http://www.richmond.com/
24-Sep-2020,IMPS,00.00,"1,603.05","12,824.41",81dcffffDB34C5c,7315,Elizabeth,Wiggins,"Duke, Logan and Craig",Jillianton,Philippines,674-984-2963,714.430.9338x4455,kristacarey@cain.com,2020-10-12,https://flynn.org/
24-Sep-2020,Cash,"1,879,491.20",00.00,"1,892,315.61",87317F5Aa68EE3d,4136,Jacqueline,Peters,"Jensen, Walker and Mcguire",Woodstown,Hungary,231-048-8784x47938,+1-112-243-6589x702,larsonbilly@vang.info,2022-01-03,http://humphrey.net/
24-Sep-2020,Cash,00.00,"630,771.87","1,261,543.74",2fEAcdbcC15cc74,247,Renee,Serrano,"Phillips, Hutchinson and Walter",West Erika,Ethiopia,501.240.0629x1686,684.959.9553x518,tammyspence@day.org,2020-03-28,https://www.haley.info/
24-Sep-2020,Tax,"694,353.00",00.00,"1,955,896.74",0ac5c95CeaEFdCe,789,Veronica,Griffin,Moreno and Sons,Port Bradhaven,Uruguay,2441427940,(637)700-3679,esantos@case.com,2020-06-05,http://whitehead.org/
24-Sep-2020,Cheque,"200,275.81",00.00,"2,156,172.55",BBfD2d0dE8a7fe9,9079,Sylvia,Maynard,"Garrett, Giles and Townsend",Ellenburgh,United Arab Emirates,093-728-5767x4339,456-425-3027x0379,jackson92@mora.info,2020-11-29,https://www.riley.org/
24-Sep-2020,ATM,"949,254.25",00.00,"3,105,426.80",cf8ae6f2F8fb7fE,8935,Cathy,Boyd,Coleman and Sons,Buckleyberg,Haiti,7445930888,001-174-248-2637x6291,teresavillanueva@clements-moon.com,2020-04-24,http://hebert.com/
24-Sep-2020,Interest,00.00,"3,105,426.80",00.00,BB60B5cC15cF7d2,172,Bridget,Guerra,Dyer and Sons,Lake Debraside,Estonia,7457637395,827-598-8367,frederickmisty@carpenter-nielsen.net,2021-01-25,http://palmer-chan.org/
24-Sep-2020,Interest,"185,548.50",00.00,"185,548.50",bA939dE996CF4BF,1495,Ian,Pennington,Roy-Riggs,West Patrick,Algeria,+1-500-645-4371,999.108.0534x8807,danielewing@mcgrath-dunn.com,2021-05-09,https://bond.info/
24-Sep-2020,ATM,"2,071.36",00.00,"187,619.86",8cFbfc3dbE47Cf8,8977,Earl,Mcguire,"Keith, Ritter and Robles",Velazquezton,Cote d'Ivoire,405-267-1804x8169,+1-331-810-8808,kelly70@sellers.com,2020-01-21,https://gardner-andrade.com/
24-Sep-2020,ATM,00.00,"37,523.97","150,095.89",BFD257E7a62F43f,622,Bill,Dunlap,"Hoffman, Mccarty and Mcmillan",Peggyfort,Saint Barthelemy,098.661.3555x48646,+1-137-479-0704,nicholsjared@odonnell-weaver.com,2020-08-06,https://moses.net/
25-Sep-2020,Bill,00.00,"16,677.32","133,418.57",Ea5c0e13f25520D,7348,Glen,Herrera,"Clements, Morrison and Wright",East Sydneymouth,Malawi,189-066-6270x893,(555)039-3934x9581,jackhale@lyons.com,2021-12-05,http://christensen.info/
25-Sep-2020,Tax,00.00,"33,354.64","100,063.93",65BBDEda3B60c95,8612,Sandy,Day,"Harmon, Michael and Johns",Stanleychester,Swaziland,(765)469-7342x6567,(188)518-5918x568,everettyvonne@soto.com,2021-12-13,https://hardin.info/
25-Sep-2020,Cheque,00.00,"20,012.79","80,051.14",2f9F0c87EEbfBd7,6742,Shelia,Garza,Leon-Bell,North Andrewhaven,Czech Republic,+1-643-748-3369x166,(908)142-7018,morristravis@castro.com,2021-02-09,https://downs.com/
25-Sep-2020,Reversal,00.00,"40,025.57","40,025.57",F24Eb26bFAE93E1,9306,Earl,Hebert,"Hester, Mcdaniel and Wiley",South Katie,Kenya,001-719-999-6391,001-894-633-3827,deborahgentry@mayo-bolton.org,2021-12-25,https://www.hawkins-goodwin.com/
25-Sep-2020,Tax,00.00,"10,006.39","30,019.18",0B6ceBA30dDB59F,9828,Jim,Spence,"Torres, Harris and Morales",Sharonview,Mozambique,+1-558-892-2126,+1-379-311-9552,peckcaroline@arroyo.com,2021-06-26,https://www.davidson.info/
25-Sep-2020,Interest,00.00,"5,003.20","25,015.98",151AB7444E1C0fA,4346,Chloe,Sanford,"Ortiz, Cummings and Mason",Fordview,Georgia,0075980914,628-422-9674,jle@soto.com,2022-05-05,http://rasmussen.com/
25-Sep-2020,Miscellaneous,00.00,"12,507.99","12,507.99",FbdB4CF8A3D2396,6817,Leslie,Pitts,"Green, Brennan and Coleman",Mariohaven,Tunisia,+1-877-729-1574x52997,001-920-518-7888,kdavidson@baird-schwartz.com,2020-06-12,https://kelley-gill.com/
25-Sep-2020,RTGS,00.00,"12,507.99",00.00,3Fece5dEfBdeAcC,3228,Kathy,Hogan,"Benitez, Wolf and Mccann",Lawsonborough,Hong Kong,556-471-6461x8936,672.991.0423x009,mason78@washington.com,2021-04-11,http://farrell.biz/
25-Sep-2020,ATM,"880,281.00",00.00,"880,281.00",9fb7A55B76aAaEd,1733,Anthony,Mendoza,"Moon, Benitez and Hanna",Mccoytown,Barbados,471.344.9899x828,(182)765-1091,brewerannette@costa-winters.com,2020-03-17,https://www.estes-chapman.com/
25-Sep-2020,Purchase,00.00,"880,281.00",00.00,2e8c6aeF849a45D,9011,Samantha,Cohen,Church Inc,Karinaland,Mexico,001-689-971-2443x22978,9500490906,epreston@moore.com,2020-05-27,http://cervantes.com/
25-Sep-2020,Purchase,05.00,00.00,05.00,6b21EbdEdE08A2f,7728,Debbie,Conrad,Bartlett Inc,Brandthaven,Grenada,275.855.8366,+1-875-493-4139x9666,qbooker@hays.org,2020-06-09,http://brooks.biz/
25-Sep-2020,RTGS,59.56,00.00,64.56,c14e74C2AFcc2DB,661,Gabriel,Day,Mccarty PLC,South Kristie,Lithuania,(661)314-0847,676-142-0275,tamiwilkerson@schneider-howard.com,2020-02-08,https://www.short.net/
25-Sep-2020,Interest,00.00,32.28,32.28,DA8bBeAEf08Ca22,1199,Donald,Powers,Willis-Clarke,East Devin,Senegal,(315)017-2011x553,6737668705,mckenziecristian@pollard.com,2020-09-29,http://sellers-robertson.biz/
25-Sep-2020,Transfer,00.00,10.76,21.52,1B40A2cf45E6af2,6887,Clifford,Atkinson,Khan Ltd,West Audrey,Tanzania,578.766.3997x453,+1-514-164-3868x6259,garzaricky@ortega.com,2022-01-23,http://www.good.com/
25-Sep-2020,Bill,"1,609.70",00.00,"1,631.22",2ccaCBBDcB6d382,3713,Bernard,Crosby,"Banks, Holloway and Orr",North Traciborough,Bahamas,001-690-054-7045x58113,+1-626-472-0251x003,urusso@riddle-bryant.org,2020-09-25,http://www.rowe-mcpherson.biz/
25-Sep-2020,Cash,00.00,163.12,"1,468.10",19EE920b5514dD6,6685,Latasha,Peterson,Wyatt-Mendoza,West Dalton,France,+1-540-861-2915,327-464-8511x77153,claire01@stevens.com,2021-04-03,http://www.conrad.com/
25-Sep-2020,RTGS,00.00,183.51,"1,284.59",085eCea4bB31F10,9193,Destiny,Koch,"Li, Wang and Arias",Stephanieshire,Sao Tome and Principe,001-030-542-5931x9391,+1-801-820-0455x4587,bruceyolanda@elliott.com,2021-03-30,https://www.burnett.com/
25-Sep-2020,Cash,22.60,00.00,"1,307.19",7FC5Bf7cF6A4AdC,9762,Andres,Weber,"Wagner, Avila and Mcclain",Pageland,Haiti,001-571-346-7011x25367,440-780-8773x740,randybruce@lawson-lambert.com,2020-04-24,http://hoffman.biz/
25-Sep-2020,ATM,04.00,00.00,"1,311.19",B0ee2FCAAfBFeBF,4799,Steven,Heath,Cortez LLC,New Garrett,Micronesia,+1-825-961-4006x627,001-435-957-0162,roger82@manning.net,2020-02-21,https://ross-burgess.com/
25-Sep-2020,Miscellaneous,00.00,218.53,"1,092.66",C5EBbE976cDa63B,8083,Ana,Yu,"Winters, Holmes and Jones",South Angiefurt,Namibia,125.010.8339,(206)401-7441,mcguirelee@lowery.biz,2020-08-29,http://gardner.com/
25-Sep-2020,Reversal,53.90,00.00,"1,146.56",65Eaafef5E243CB,9374,Jeremiah,Porter,Stephenson-Aguilar,Kylieport,Israel,001-634-872-5059,001-452-936-9811x9029,jareddavis@hays-boyle.com,2022-03-10,http://www.costa-leblanc.com/
25-Sep-2020,NEFT,"2,961.98",00.00,"4,108.54",b6ddabb55E323F5,505,Summer,Burns,Morris-Eaton,Fisherberg,Uruguay,394.768.1649x41296,031-374-5929x0192,hartcassidy@whitney.com,2020-07-20,https://www.young.biz/
26-Sep-2020,RTGS,00.00,456.50,"3,652.04",F5BCbC9AFfAcb6a,5179,Leon,Norton,Roberson Ltd,West Douglasfort,Mali,920-392-8668,787-990-8685,jonathonellis@shaffer.biz,2020-12-17,https://www.rangel.com/
26-Sep-2020,Tax,"18,469.00",00.00,"22,121.04",309E4a099951Da1,9719,Joseph,Contreras,Kaufman PLC,North Sheenatown,Timor-Leste,636.135.0525,001-571-817-3043x12415,glenda32@gamble.com,2020-06-20,http://davidson.com/
26-Sep-2020,Cheque,07.47,00.00,"22,128.51",6BefAaDaa443B53,4894,Hunter,Manning,Kennedy Inc,North Dennis,Libyan Arab Jamahiriya,001-171-693-3187x283,182-925-5101x2389,wdudley@combs.com,2021-10-14,http://price.com/
26-Sep-2020,Tax,342.00,00.00,"22,470.51",aCf1FEdbb2Eb42f,2985,Corey,Price,"Wilson, Walter and Wiggins",Kerryview,Colombia,819-595-1517x78342,(194)638-6694x2749,apruitt@mayer-calderon.com,2021-08-29,http://www.lambert.net/
26-Sep-2020,Miscellaneous,00.00,"5,617.63","16,852.88",8eb7148232CE4FE,5419,Phillip,Arroyo,"Gibson, Cantu and Fuentes",Anitahaven,Turkey,(741)619-2706x8521,6501417831,acostabreanna@cooley.com,2020-05-07,https://www.dodson-lynn.info/
26-Sep-2020,RTGS,00.00,"8,426.44","8,426.44",97FD7134aA26d09,7340,Wyatt,Mccann,"Harmon, Benitez and Walker",Garretttown,Timor-Leste,(573)461-7817,974.377.8659x630,grantbrenda@gardner-orr.com,2021-10-08,https://www.reed-wang.net/
26-Sep-2020,IMPS,"132,944.00",00.00,"141,370.44",38E5c8280BB2cE9,3358,Gregory,Mitchell,Armstrong-Dodson,South Shawna,Maldives,928-947-7639,781.844.1826,herbert79@west.com,2022-03-12,http://www.hays.info/
26-Sep-2020,Tax,"3,262.70",00.00,"144,633.14",dcCbdebbfedbf5E,8653,Lance,Brown,Santiago Ltd,New Derekport,Tajikistan,306.206.6517,772.985.2111,bellbryan@watson.net,2021-10-10,https://contreras.org/
26-Sep-2020,Cheque,"130,626.00",00.00,"275,259.14",90cd0eBFcFaDB3f,8628,Carlos,Delgado,Garza-Frye,South Marie,Turks and Caicos Islands,102.018.0758,355-029-9122,sheliaarmstrong@gardner.net,2020-09-25,https://waters.com/
26-Sep-2020,Transfer,06.00,00.00,"275,265.14",Eba494D3300fBeC,7518,Clarence,Leon,"Lindsey, Mckenzie and Brandt",Bradleyshire,Suriname,(761)356-8355,(230)477-9738x163,annette07@burch-villegas.com,2021-03-16,http://www.molina.net/
26-Sep-2020,Commission,00.00,"137,632.57","137,632.57",ffEC198AAb6b2C4,7799,Mia,Leblanc,Alvarado-Hooper,Port Emily,Russian Federation,001-615-515-6787x098,001-969-388-0238x09302,sheliajacobson@schmidt-vega.info,2020-01-01,https://www.duran.com/
26-Sep-2020,Miscellaneous,00.00,"22,938.76","114,693.81",266b2AAb9887Ee0,2087,Kristine,Lane,"Tanner, Mathews and Carson",New Meghanburgh,Vanuatu,812.662.7950,942-421-9038,sydney92@house.org,2020-12-24,http://barton.com/
26-Sep-2020,Reversal,"359,116.50",00.00,"473,810.31",86Df56BFCc0a7CA,15,Catherine,Blackwell,"Mack, Garcia and Schaefer",Lake Seth,Dominican Republic,001-915-961-8896x5744,(310)185-3032x0974,calhounalisha@hardin.net,2021-03-30,https://barker-bishop.info/
26-Sep-2020,RTGS,02.00,00.00,"473,812.31",d6e8c838F9ba64b,7553,Alfred,Ferguson,"Shepherd, Franklin and Buchanan",South Jakestad,Ukraine,(478)808-7409,818-024-0687,garciavirginia@ramsey.com,2020-06-30,https://walter.com/
26-Sep-2020,Bill,06.00,00.00,"473,818.31",46FbAe9eC21094F,9864,Frances,Rosales,Roy-Church,Lorihaven,Gibraltar,952-306-9035x272,(488)113-2379,fergusoncristina@benson.com,2021-03-21,https://www.riley.com/
27-Sep-2020,IMPS,356.00,00.00,"474,174.31",A54D024Bebd2Aa5,1375,Levi,Barry,Hernandez Group,West Maxwellside,South Africa,937.668.5003x885,(770)378-2636x659,mollybaird@stephenson.com,2022-01-28,http://schmidt-horton.info/
27-Sep-2020,ATM,00.00,"67,739.19","406,435.12",E2E1d8f5b4Db626,6241,Joann,Krueger,Molina-Cameron,Wongland,Greenland,585.937.5798x8911,001-097-427-3609,sramirez@allison.com,2021-11-07,https://sanchez.com/
27-Sep-2020,Bill,"2,347.00",00.00,"408,782.12",bF67FEDfF32A0DC,1460,Lee,Bowen,Hill Ltd,New Patrick,Madagascar,444-193-5315,(133)049-4309x18470,mliu@hurst.com,2021-04-04,https://bean-mercado.org/
27-Sep-2020,Interest,00.00,"204,391.06","204,391.06",55E1718272aC049,6081,Faith,Ross,Davidson Group,West Dominic,Pitcairn Islands,(043)795-7842,254.665.9770x40021,ahendrix@winters-ramos.com,2021-05-30,http://hendrix-fletcher.net/
27-Sep-2020,Debit Card,"216,398.60",00.00,"420,789.66",C3B6ab1b4Cb563d,1118,Jackson,Mccall,Holloway LLC,Rowlandview,Niue,940-629-0533x1254,016-443-9290x80844,diane27@donaldson.com,2020-03-10,http://www.riddle.com/
27-Sep-2020,RTGS,00.00,"52,598.71","368,190.95",90D853A55e68d3e,5702,Regina,Wheeler,"Sims, Hardy and Esparza",Clairehaven,Guinea-Bissau,2979664806,559.551.0348x515,isaacmercer@kelley.com,2021-10-19,http://www.douglas.com/
28-Sep-2020,Tax,22.00,00.00,"368,212.95",97e39Adf972722F,3552,Shawn,Day,Delacruz-Lloyd,Reillybury,Venezuela,+1-393-938-4080x49649,525.174.9514x2368,shahevelyn@ware.org,2020-02-01,https://hess.com/
28-Sep-2020,IMPS,01.00,00.00,"368,213.95",CF04ed55A5EFF3E,9418,Nichole,Jackson,"Frazier, Hernandez and Bentley",Port Adam,Nepal,022-424-1498,772-764-7053x2941,stacie72@salinas-tucker.com,2022-01-08,https://carlson.org/
28-Sep-2020,Reversal,00.00,"40,912.66","327,301.29",cEF3C4e03b4d98B,6042,Briana,Schaefer,"Haley, Spencer and Small",Goodview,Congo,(019)700-6574x2793,(822)253-3589x2520,shahtabitha@duke.com,2020-10-07,http://www.macias-coleman.com/
28-Sep-2020,Transfer,00.00,"46,757.33","280,543.96",f826accf8E21ceC,8364,Hayley,Best,Kaiser Inc,Danielsborough,Liechtenstein,883-358-5193,(606)937-1426x626,noah80@mora.com,2022-05-22,https://www.dyer.biz/
28-Sep-2020,Interest,00.00,"140,271.98","140,271.98",Ebe45ac4Ae5e20C,24,Alan,Stanton,Munoz and Sons,Lake Isaiahview,Costa Rica,(510)542-0174x853,995.008.2375x973,yhebert@hays-rivera.com,2020-01-23,http://young.com/
28-Sep-2020,NEFT,00.00,"28,054.40","112,217.58",BC45DEf0A2a05fD,9062,Edward,Yates,"Graham, Mendoza and Hale",West Lindsey,Italy,858-408-7425,(633)900-8832x4199,sawyervickie@french.org,2022-05-20,http://maynard.com/
28-Sep-2020,Cash,290.90,00.00,"112,508.48",D9ecedcc7bAA421,1431,Joseph,Maldonado,Fitzpatrick-Bryan,Andrewschester,Afghanistan,157-955-9779,001-452-719-4324x95019,hayley95@sullivan.com,2020-10-06,https://www.terrell.com/
28-Sep-2020,RTGS,105.00,00.00,"112,613.48",B7A38CEFF3c04F6,9960,Carl,Lin,Chapman Group,Timothychester,Antigua and Barbuda,001-054-077-3590x9538,4210511927,stevensonstuart@leon.com,2022-02-28,https://sandoval.com/
28-Sep-2020,Cheque,"11,949.30",00.00,"124,562.78",0aee1acDdbF6d3D,3158,Catherine,Lyons,"Davila, Krause and Henry",Port Randall,Bahrain,001-249-694-1733x458,416-351-8900x246,rebekah91@hubbard-ware.org,2021-02-01,https://paul.com/
28-Sep-2020,Bill,227.00,00.00,"124,789.78",16e8f82E1BdD8bd,279,Tiffany,Bruce,Joseph-Lyons,East Alishaport,China,451-922-4817x107,+1-720-469-0819x964,latashaburch@woodward.com,2021-10-24,https://levy.org/
28-Sep-2020,Miscellaneous,00.00,"124,789.78",00.00,17aeFc6C8f41bBf,3768,Richard,Choi,Hartman-Harrington,East Arthur,Benin,(510)089-0181,142.068.1101x227,campbelloscar@downs.org,2022-02-27,http://stein-charles.com/
28-Sep-2020,Bill,"795,860.00",00.00,"795,860.00",f5C49181E858D45,3415,Dave,Crosby,Coffey-Leon,Autumnberg,Dominica,318.579.6837,+1-101-345-1857x72159,beckmarissa@lawrence-grimes.biz,2022-03-21,https://www.avery.com/
28-Sep-2020,Miscellaneous,00.00,"397,930.00","397,930.00",D58eEE41BF8e77D,7338,Mckenzie,Farmer,"Williamson, Mcintosh and Grimes",Rodriguezmouth,Marshall Islands,239.350.3151,+1-722-563-0704x857,dchavez@mckay.org,2021-05-14,https://joseph.com/
28-Sep-2020,Cheque,00.00,"132,643.33","265,286.67",a51bbA1EC46f00D,7730,Cesar,Cain,Dickson-Buck,West Sethmouth,Czech Republic,973.267.7800x8200,144-081-0597,ryanjamie@stokes.com,2020-08-23,http://www.caldwell.info/
28-Sep-2020,Debit Card,"3,346.01",00.00,"268,632.68",F2f5a0036C063cC,5738,Kristie,Benton,Lowe-Griffith,Kristinville,United States Virgin Islands,001-433-681-3844x0318,+1-283-255-9746x00247,olsondean@solis-glenn.com,2020-07-05,http://martinez.org/
28-Sep-2020,Bill,"239,849.80",00.00,"508,482.48",df0dC07031AfBBe,274,Kristina,Larson,Vargas-Garrett,Beltranland,Ireland,(843)172-1473,237.668.4393,sloanmeagan@key.com,2021-01-09,https://fowler.com/
28-Sep-2020,Commission,00.00,"101,696.50","406,785.98",3cBafb5f05ff27A,3515,April,Everett,"Estes, Odom and Sellers",Lake Claytonshire,Italy,001-108-085-2305,001-729-816-4001x683,marvindelacruz@preston-rocha.com,2021-12-15,http://www.elliott.info/
28-Sep-2020,Bill,"140,293.00",00.00,"547,078.98",A3cCFd318b1daDf,8539,Alexandria,Lynn,"Pearson, Woodard and Fitzpatrick",Port Faithstad,Panama,(174)183-3720,(672)487-9019x32309,emccann@walton.biz,2022-03-12,https://www.shepard.com/
28-Sep-2020,Tax,"20,370.00",00.00,"567,448.98",b0fd5F30cf65A2c,8491,Sandy,Beck,Ryan-Morton,South Robinside,Solomon Islands,+1-975-516-3824x6205,(550)122-8468x121,jcisneros@marquez-herring.org,2020-08-28,https://gallagher-miles.info/
28-Sep-2020,Tax,00.00,"70,931.12","496,517.86",3c2b39F1CF1b0bB,9759,Jaime,Levine,"Hess, Welch and Bender",Coltonchester,Turkey,+1-933-083-4847,7130127981,glenkeller@rosales.com,2020-07-03,http://herman.biz/
28-Sep-2020,Cheque,00.00,"165,505.95","331,011.91",49D0c593E7ffAa3,7184,John,Warren,Costa-Shea,Lake Carlosfurt,French Polynesia,001-405-110-6416,240.492.1667x799,pruittkendra@thornton.biz,2020-06-10,https://www.meza.org/
28-Sep-2020,Miscellaneous,437.54,00.00,"331,449.45",823CF2d5B6f8a82,6722,Alexander,George,"Alvarez, Hardy and Boyle",North Dalemouth,Congo,(580)576-4772x65826,3811161676,marissa50@howell.info,2021-11-02,https://greer.info/
28-Sep-2020,Reversal,00.10,00.00,"331,449.55",ba71bf712Ba06B3,9158,Jody,Odom,Mooney-Ali,Lake Caseyburgh,Solomon Islands,329-025-9011x3344,107.375.8234x93258,joanne71@payne.com,2020-05-08,http://leblanc.net/
28-Sep-2020,NEFT,03.80,00.00,"331,453.35",Deb6f8A1EFFC7Fb,8706,Rachel,Moreno,Villarreal-Quinn,Brockport,Iceland,5044809426,349.860.4569x620,lancemorgan@castaneda.com,2022-03-09,https://www.harrison.com/
28-Sep-2020,IMPS,00.00,"331,453.35",00.00,c1204d27800378B,6436,Jonathon,Hurst,Marquez Inc,Shermanhaven,Cambodia,094.596.6730x681,+1-753-052-5092x21382,vcarson@nelson-schmidt.com,2021-12-08,http://tanner.net/
28-Sep-2020,Reversal,135.00,00.00,135.00,ca3fD1faaEDdAC4,9384,Melissa,French,Gibbs LLC,Kimside,American Samoa,619-705-6052,291.007.6887,odomkelli@salas-carson.com,2020-10-13,http://blackwell.com/
28-Sep-2020,ATM,00.00,45.00,90.00,dA74AfF69d1Bd52,2881,Carl,Ochoa,Nguyen PLC,Katherinebury,Zimbabwe,256.115.9477x5119,(287)292-2464x253,gravesthomas@curry.com,2021-04-01,http://santos-johnson.com/
28-Sep-2020,Miscellaneous,"31,826.00",00.00,"31,916.00",AdAdE69E6a75FAa,4954,Shawn,Horton,Mason-Clarke,Lake Jefferyshire,Cyprus,927.485.9116x054,463-428-8804,sabrina20@maddox.info,2021-04-13,https://galvan.com/
28-Sep-2020,ATM,"13,495.00",00.00,"45,411.00",36BdBAE5ED6bb1f,3809,Frances,Hays,Norton-Ruiz,Josephbury,Mongolia,523-110-8071,836.401.7868x1806,randyallen@lozano.net,2020-02-17,http://www.wolfe.com/
28-Sep-2020,Miscellaneous,00.00,"5,676.38","39,734.62",afcACDAae7ae7cC,6951,Bob,Bonilla,Sawyer-Acevedo,North Terrance,Barbados,+1-954-175-5823x340,(987)517-1030,opalmer@cooke.net,2020-11-14,http://www.ray-cochran.com/
29-Sep-2020,Bill,00.00,"39,734.62",00.00,5D406213eE1D5BB,733,Yesenia,Kramer,Barrett-Huber,Vegahaven,Malta,616.611.2079,(024)515-7102x255,tlogan@mooney.com,2021-04-17,http://hatfield.biz/
29-Sep-2020,Tax,"197,039.00",00.00,"197,039.00",d29Ed9CDdAa3CE2,8744,Rebekah,Velazquez,Goodwin PLC,Robertaside,Benin,181-767-3457x847,(210)341-7652x7668,steeleisaiah@buckley-bradford.com,2021-10-19,http://gallegos-winters.org/
29-Sep-2020,Cash,00.00,"28,148.43","168,890.57",56c0FFdA30AA2B4,9976,Damon,Steele,Barnes-Wiggins,Doughertystad,Swaziland,+1-124-543-5317,1998011698,bmayer@thornton.net,2020-12-31,https://collins-woods.org/
29-Sep-2020,Transfer,409.20,00.00,"169,299.77",a1f54b63BFA2F9b,9494,Lori,Sparks,"Vazquez, Sanchez and Burke",Debbieland,Azerbaijan,893-693-6405x944,859-193-1300,monique43@travis.biz,2021-03-20,https://sampson.com/
29-Sep-2020,Debit Card,"51,999.75",00.00,"221,299.52",eEeacBeD3EeAdc3,5887,Jo,Spears,Campos Group,Jackton,Benin,(656)726-3890,285-420-4420,grichards@mason-sheppard.net,2022-03-14,http://www.murray-ballard.com/
29-Sep-2020,RTGS,"1,174,037.50",00.00,"1,395,337.02",ECaddfAE6EEd2ED,9021,Bryan,Haas,"Hopkins, Chapman and Roman",East Robert,Thailand,5171125529,(396)374-4895x05701,jlawson@robinson.com,2021-03-05,https://santiago.biz/
29-Sep-2020,Tax,"31,959.58",00.00,"1,427,296.60",10dc0C00C72FdcB,2742,Jay,Stewart,"Hooper, James and Davis",Yangstad,Argentina,322.116.6159x30686,393-835-8490x3094,elijah12@pugh-david.com,2020-12-06,http://www.warner-gilmore.com/
29-Sep-2020,Purchase,"204,111.90",00.00,"1,631,408.50",bed9aF4B7e23556,4011,Nicolas,Mccormick,"Giles, Gibbs and Copeland",New Elizabethland,Korea,040.033.6490x7784,260.004.9265x69234,waltonstacey@porter.com,2021-12-16,https://glass.com/
29-Sep-2020,RTGS,03.55,00.00,"1,631,412.05",E77Db548dEB2Dac,6850,Rachael,Bonilla,"Richards, Baird and Keith",Lake Debrahaven,United States Virgin Islands,927.325.7860,+1-146-418-9576x6231,karinablair@esparza.com,2022-02-23,http://zavala-henry.com/
29-Sep-2020,Bill,"1,758,800.50",00.00,"3,390,212.55",1dFB22F16d11e25,7201,Marisa,Bowman,Guzman and Sons,Nicholasside,Serbia,(150)212-0745,(890)658-6895,maureenblankenship@mcintyre.com,2020-08-24,https://www.francis.net/
29-Sep-2020,Reversal,00.00,"1,130,070.85","2,260,141.70",379c7bB7CDb3AC2,4437,Dustin,Velasquez,Pace-Melendez,South Elaineside,Taiwan,+1-371-857-0128,129-007-2393,smalone@greer.net,2020-06-23,http://navarro.com/
29-Sep-2020,Debit Card,00.00,"376,690.28","1,883,451.42",4f44fe880bce4eE,7146,Alicia,Rich,Ingram-Richardson,East Javierburgh,Myanmar,330-246-1481,(606)388-0466,tyronebaird@griffin-barrera.com,2020-08-03,http://www.rollins.org/
29-Sep-2020,ATM,00.00,"1,883,451.42",00.00,0DdF6Fe25EBb121,3626,Dana,Crane,"Le, Oliver and Hull",Haasfort,Iceland,558.227.9880,(824)406-3128x9078,qwiley@buck.net,2021-10-10,http://delgado-pacheco.com/
29-Sep-2020,Purchase,01.90,00.00,01.90,aD2Fe51F22249Bd,5865,Christian,Townsend,Lindsey-Lawrence,Skinnertown,Thailand,568.590.8059x14579,(920)130-5020x3209,levimcdonald@shah.com,2021-11-03,http://www.holland.com/
29-Sep-2020,Transfer,00.00,00.38,01.52,25AA85EefA355CA,7670,Katherine,Bond,"Cochran, Strickland and Hobbs",Davidshire,Norway,001-309-984-6582x495,(406)994-5478x39344,charlesbryant@vaughn-osborne.org,2020-09-06,http://www.villarreal.com/
29-Sep-2020,ATM,00.00,00.15,01.37,2eC63FaDdFaF7dd,5926,Erin,Murillo,Leblanc-Morales,Lake Julian,Namibia,001-546-513-0586x9465,155-853-3438x003,amanda21@hayes.com,2021-02-28,https://www.duran.org/
29-Sep-2020,Interest,00.00,00.34,01.03,5D328DEaCdff8Af,8773,Jenna,Brewer,Lowery Group,Danielsburgh,Kazakhstan,100-182-1362,106.910.1333x8683,merrittomar@rosales.com,2020-06-18,http://santos.net/
29-Sep-2020,Transfer,"3,126.60",00.00,"3,127.63",0DBfD7D7Cd3CA18,9347,Ray,Conley,Le LLC,South Christopherstad,Madagascar,001-908-611-3506x71290,001-095-912-0829x864,heidi50@duran.com,2021-05-02,https://www.robles.com/
29-Sep-2020,Cheque,"4,058.90",00.00,"7,186.53",CDDAB7c349e5aAd,9038,Gwendolyn,Mosley,Lin Group,Greenchester,Botswana,(091)050-1265,(369)479-5518x522,huntergalvan@mercer-norton.biz,2021-09-19,http://www.olsen-gray.com/
29-Sep-2020,IMPS,"434,432.00",00.00,"441,618.53",5ac476d798a9EE1,7242,Megan,Robinson,Mills Inc,North Bryce,Serbia,575.089.1288,(507)636-6186x4214,dcrawford@cisneros-daniels.org,2021-12-07,http://love-chung.com/
29-Sep-2020,RTGS,00.00,"110,404.63","331,213.90",4EAB3f9cfC43520,8213,Shelia,Page,"Golden, Turner and Wolf",Josephfort,Norway,472.851.6574,4036500092,marissakaufman@sheppard.com,2020-06-29,https://thompson-cuevas.com/
29-Sep-2020,Interest,00.00,"33,121.39","298,092.51",83F0B1D11A63aEB,7284,Ellen,Mcintosh,"Schroeder, Ramirez and Parker",Cynthiastad,Croatia,001-443-067-2044x65930,+1-051-015-0774x924,mullinstyrone@henry-weber.com,2020-06-06,https://www.winters.com/
29-Sep-2020,Cheque,00.00,"49,682.09","248,410.42",bfCAE9E1ecFcBA6,5034,Douglas,Cochran,Rowland-Vazquez,Shaneland,Aruba,607.886.2704x02651,259.901.0085x330,montoyatrevor@haley-craig.com,2020-03-11,http://owen.net/
29-Sep-2020,Reversal,"18,265.67",00.00,"266,676.09",0c7cE200C288D83,2174,Sarah,Combs,Mills-Davila,North Teresaburgh,Hungary,309-811-9174x03152,(005)640-0371,riverscarmen@wyatt.com,2020-01-27,http://foley.com/
29-Sep-2020,ATM,00.00,"53,335.22","213,340.87",bF4e8A45B33A1fb,6631,Megan,Benitez,"Mccarthy, Chapman and Estrada",Rickybury,Tunisia,(081)008-4992x84631,001-192-048-8872x635,blakegillespie@ashley-mccall.com,2021-07-20,https://www.serrano-perez.com/
29-Sep-2020,Miscellaneous,521.70,00.00,"213,862.57",aBb1F2AC72C757B,4916,Stanley,Malone,"Patterson, Davis and Holloway",Wandaland,Italy,001-557-685-1110x224,001-653-071-3851x414,wernerlarry@riggs.com,2020-01-11,https://www.shah.info/
29-Sep-2020,IMPS,"468,020.25",00.00,"681,882.82",8BeFeec19df55B5,8146,Penny,Camacho,Ford-Logan,Jefferyland,Taiwan,001-062-873-6673x92369,(231)924-8827x424,joehansen@brandt-mcdaniel.info,2020-09-28,https://mcintyre.net/
29-Sep-2020,NEFT,00.00,"97,411.83","584,470.99",D9ecedcc7bAA421,1431,Joseph,Maldonado,Fitzpatrick-Bryan,Andrewschester,Afghanistan,157-955-9779,001-452-719-4324x95019,hayley95@sullivan.com,2020-10-06,https://www.terrell.com/
29-Sep-2020,Cheque,62.00,00.00,"584,532.99",Bbd9cBc4177C31A,523,Adam,Davenport,Gill-Snyder,Port Olivia,Marshall Islands,164.438.9583x14077,250.588.7898x682,terrence66@holder.com,2021-01-29,http://www.pham.com/
29-Sep-2020,Commission,01.00,00.00,"584,533.99",F2E8FEf85dDAb1E,3452,Patricia,Case,Ewing-Cobb,Lake Ericaville,Bouvet Island (Bouvetoya),001-311-622-4594x0034,+1-327-366-3845,sfreeman@boyle-aguirre.org,2021-11-23,http://may-glenn.net/
29-Sep-2020,Miscellaneous,"1,238.70",00.00,"585,772.69",9263b42fcE03b7E,3686,Tristan,Ellis,Thornton-Tate,Littleborough,Nicaragua,4145507534,+1-049-598-4878,miguelmartin@dickerson.com,2021-01-18,http://arias.com/
29-Sep-2020,Tax,00.00,"292,886.35","292,886.34",09aC4D0ec877e3B,6453,Jaclyn,Callahan,"Giles, Mckinney and Fuentes",New Brett,Venezuela,001-361-152-7082x5276,(512)494-0953x9823,lpowers@barnes.info,2020-04-19,http://walters.info/
29-Sep-2020,Tax,00.00,"48,814.39","244,071.95",Da00c81eFbe77Ed,7525,Kristie,Adkins,"Fuentes, Ritter and Salas",Leahchester,Cote d'Ivoire,001-845-179-3700x90030,+1-408-319-1444,howard93@giles-clayton.net,2020-10-10,https://dudley.com/
29-Sep-2020,Reversal,06.00,00.00,"244,077.95",E2F2dBf731f4E3b,9145,Annette,Hardy,Beltran LLC,Lake Theodorehaven,Greenland,881.775.9562,(361)728-9276,qfrye@ortiz.com,2021-07-25,https://price.net/
29-Sep-2020,IMPS,00.00,"40,679.66","203,398.29",bBe2e6b601fA522,9004,Andres,Frost,Mccormick-Maynard,Rangeltown,Sudan,+1-652-018-2734,613-640-9657x05050,judyreynolds@griffith-carpenter.net,2020-08-14,https://wagner.com/
29-Sep-2020,RTGS,"26,894.00",00.00,"230,292.29",9aD772d3c5dBeF3,4295,Sarah,Duffy,Blankenship Ltd,Tonymouth,Tonga,757.561.7313x7076,001-564-372-4578x938,sdalton@summers-orr.com,2020-02-02,http://www.zuniga.com/
29-Sep-2020,Bill,"2,051.11",00.00,"232,343.40",F21fFE44D5Fa5A0,5674,Rickey,Casey,Gay LLC,Jessicafurt,Macedonia,001-812-651-9751x1806,2229632880,zhanggordon@holmes-briggs.biz,2021-01-01,https://anthony-mann.com/
29-Sep-2020,Commission,"3,385.00",00.00,"235,728.40",f2eE78D1A6DEe5e,1021,Rachael,Benitez,Hester Ltd,Lawsontown,Mauritania,(694)376-3296x032,+1-774-787-5087x50986,mwalls@salinas-robinson.com,2022-04-29,https://horton-rubio.com/
29-Sep-2020,Miscellaneous,00.00,"23,572.84","212,155.56",3c1ef3bbF22CC3D,5904,Dale,Montes,Marshall and Sons,Herreraberg,United Kingdom,(683)045-8687x99613,(770)206-0159x4153,perkinslatoya@golden-mcdowell.biz,2020-11-06,https://mclaughlin.info/
29-Sep-2020,Reversal,04.30,00.00,"212,159.86",9A479F7D485ea5e,6767,Ricky,Kane,"Collier, Sanchez and Valencia",North Paula,Peru,001-947-085-1450x6338,514.175.5819x863,staffordshirley@zamora.org,2022-04-28,https://www.gillespie.com/
29-Sep-2020,NEFT,00.00,"26,519.98","185,639.88",75cED527bBCCddB,3567,Stacey,Christian,Mclaughlin-Meyer,Lake Jeanette,Czech Republic,(523)335-9743,575.547.4915x13527,cathylewis@hogan.com,2021-08-12,http://drake.com/
29-Sep-2020,Purchase,00.00,"92,819.94","92,819.94",7Ea6Fe8CF9d5f4D,9855,Jeanette,Nelson,House Inc,New Edgarport,Qatar,001-769-610-0233x9502,(221)765-1000,zvaughn@elliott.com,2022-04-16,https://mckinney.org/
29-Sep-2020,Debit Card,00.00,"9,281.99","83,537.95",57a3fE70eFEcc4d,5162,Shari,Michael,"Olsen, Leonard and Lynch",South Kaitlinbury,Austria,(451)313-9050x9308,(011)955-3747,bethany24@frederick.com,2021-02-11,http://www.huber.com/
29-Sep-2020,Cheque,"244,924.00",00.00,"328,461.95",3079eE405B9cC7f,1025,Chelsea,Cuevas,"Chen, Butler and Tapia",Russellfort,Wallis and Futuna,+1-073-936-9044x475,642.504.2102x457,bingram@horton-holder.com,2021-09-02,http://leonard-dudley.net/
29-Sep-2020,Reversal,"1,260,349.80",00.00,"1,588,811.75",B145eEDDD7D0Aea,9865,Matthew,Elliott,Mcdaniel and Sons,Port Shawna,Malta,457-768-5682x8910,+1-338-719-4442x5843,yward@carlson-robertson.org,2021-12-13,http://medina.com/
29-Sep-2020,Transfer,00.00,"794,405.88","794,405.88",B0ee2FCAAfBFeBF,4799,Steven,Heath,Cortez LLC,New Garrett,Micronesia,+1-825-961-4006x627,001-435-957-0162,roger82@manning.net,2020-02-21,https://ross-burgess.com/
29-Sep-2020,Bill,00.00,"397,202.94","397,202.94",2C8fD3b5b9B9Fa3,8892,Patricia,Byrd,Aguilar-Mckay,New Corey,Monaco,(865)674-4330x677,(879)602-2338,uguerrero@oconnor-hutchinson.biz,2022-01-12,https://bender.org/
29-Sep-2020,Debit Card,47.00,00.00,"397,249.94",BA880CAeF9bcCe2,4263,Preston,Adams,"Oconnor, Brown and Nash",Debraview,Costa Rica,7566662510,5103729025,kirstenberger@strong-wallace.com,2021-09-15,https://parrish-cunningham.com/
29-Sep-2020,Cash,"70,166.09",00.00,"467,416.03",a8D993bf0eBb1b6,4149,April,Ali,Ferguson-Wise,Anthonyberg,Oman,(053)375-8083x62192,+1-246-926-3721x4480,ggallagher@lowery.com,2021-03-04,https://ford.com/
29-Sep-2020,Interest,00.00,"66,773.72","400,642.31",109b3c8B741bdfb,2071,Herbert,Tanner,Medina-Haynes,Mckayfurt,British Virgin Islands,073.350.8264x27123,(165)025-0287,ealvarado@ayala-christensen.com,2021-10-13,https://price-clayton.com/
29-Sep-2020,Miscellaneous,"1,142,374.20",00.00,"1,543,016.51",f5dd3cD6fACA03f,7414,Brianna,Horn,Archer Inc,New Tracimouth,Zimbabwe,(133)569-2914x9380,+1-858-722-9597x75665,bblackburn@lowery.net,2021-10-31,https://sosa.com/
29-Sep-2020,NEFT,00.00,"171,446.28","1,371,570.23",ed60A96e608F2e0,3324,Colleen,Livingston,Burnett-Scott,South Alishatown,British Virgin Islands,993.448.7497x51929,140.230.8276,shaunyoder@savage-ingram.com,2020-05-05,http://www.church.com/
29-Sep-2020,Commission,00.00,"457,190.08","914,380.15",224b2c596c942F7,4681,Brittany,Benson,Cole-Mcgee,Morafurt,Moldova,6462930426,+1-761-916-5950x37346,chamberscolleen@welch.com,2020-08-26,https://owen.com/
29-Sep-2020,Transfer,"2,010,138.00",00.00,"2,924,518.15",a4F3ABf15aC5af0,1320,Mark,Orr,"Odonnell, Hunter and Sanchez",Port Lauratown,Venezuela,606.359.9955x800,9453305908,fbarnes@burke.net,2021-05-05,https://www.drake.net/
29-Sep-2020,Commission,"14,925.00",00.00,"2,939,443.15",6Fecdbe3D32D557,680,Kylie,Sellers,Frost-Moreno,East Anna,Sierra Leone,0807147436,561.188.4914x29747,mcfarlandbilly@ford.biz,2021-11-09,http://mendez.info/
29-Sep-2020,IMPS,222.13,00.00,"2,939,665.28",51f787dBbddd8fD,6489,Adam,Morgan,Howard LLC,West Pam,Japan,(482)230-8599x83276,475-836-2860,pam66@fowler.com,2021-07-20,http://www.kent.com/
29-Sep-2020,Tax,"25,013.90",00.00,"2,964,679.18",EB796F1cc5464cc,6997,Tracie,Wright,Cardenas PLC,West Samanthafort,Korea,001-953-761-1211,001-215-181-5284,ginaprice@gardner-ruiz.net,2020-11-27,http://www.house-ewing.biz/
29-Sep-2020,Interest,"227,195.00",00.00,"3,191,874.18",afDB6eda83bcb9d,3019,Tara,Bass,Melton-Dalton,Kristenside,Chad,057-557-4618,(544)284-1589x4103,savageregina@yates-nicholson.biz,2021-01-20,https://villa-church.com/
29-Sep-2020,Cheque,"170,201.53",00.00,"3,362,075.71",AE8ac9a0B48e3Fd,5129,Ethan,Hayes,Hester LLC,North Tommy,Solomon Islands,518-357-2198x748,910.157.0086,lindseyconner@wood-wagner.com,2020-01-30,https://www.good-swanson.org/
29-Sep-2020,Purchase,"184,969.75",00.00,"3,547,045.46",fA97B43BEBE62Da,9223,Katie,Myers,"Petty, Olsen and Riley",Shelleyport,Turkey,001-134-055-7460x586,689.557.7249,javiertate@ochoa.com,2020-09-12,https://www.carney.biz/
29-Sep-2020,Tax,00.00,"591,174.24","2,955,871.22",E0aCD3BDCC238EB,7985,Mario,Carpenter,Gray Group,Alisonmouth,Faroe Islands,001-076-663-9152,001-070-410-8842x376,victoria77@malone.info,2020-05-28,https://www.beasley.org/
29-Sep-2020,Bill,04.00,00.00,"2,955,875.22",CE7a979fba79b49,5373,Maurice,Huerta,"Dickson, Wall and Acosta",West Marciaville,Netherlands Antilles,(557)067-2738x387,(326)306-5251,tonya48@johns-valentine.com,2021-07-28,http://www.cline-bradshaw.net/
29-Sep-2020,Purchase,"32,595.70",00.00,"2,988,470.92",3eC1Bfd767484E2,1158,Hailey,Pratt,Tran and Sons,Acevedobury,Belize,(334)568-8298x757,312.203.5970x1752,rick08@shepard.com,2022-02-16,https://stephenson-landry.org/
29-Sep-2020,Purchase,15.87,00.00,"2,988,486.79",0c3BFAea87873e4,8276,Kirk,Hull,Cunningham LLC,Deborahhaven,Nepal,+1-177-273-5731x350,9020051327,brittany74@warren-williams.info,2022-03-02,http://merritt-maynard.com/
29-Sep-2020,Transfer,174.40,00.00,"2,988,661.19",fe51ef5bEcb9B3a,9553,Breanna,Moran,"Maddox, Cabrera and Donaldson",Oscarburgh,Honduras,073.104.4157,367.206.8377x7278,jilliandoyle@bridges-walker.biz,2021-08-18,https://www.salinas.com/
29-Sep-2020,Reversal,00.00,"426,951.60","2,561,709.59",b233b3dF0bC98Dd,9286,Diane,Montgomery,"Heath, Duarte and Estrada",Ronniebury,Nauru,001-945-446-8566,(875)179-6581x740,frank64@santiago.com,2020-11-15,https://www.norman.net/
29-Sep-2020,IMPS,"30,758.80",00.00,"2,592,468.39",AEee37Bb80cd75a,8231,Jane,Chambers,"Henry, Brooks and Malone",North Brendashire,Bolivia,+1-795-073-9423x42121,646.784.6266x56110,sharonschmidt@brooks-jefferson.org,2021-09-06,http://www.dalton-nixon.com/
29-Sep-2020,Purchase,00.00,"324,058.55","2,268,409.84",6efE2e5A94a8a4B,7220,Lydia,Abbott,Chandler-Long,Nancyshire,Nepal,740.931.8971,138-398-4179x5581,mterry@fletcher-allison.com,2020-07-18,https://www.thomas.com/
29-Sep-2020,Transfer,02.82,00.00,"2,268,412.66",EbA5ea84B9Eba6a,8834,Terri,Reilly,Rocha Inc,Walkerfurt,Mexico,4645996218,001-993-058-8483,chunter@ferrell.net,2020-08-02,https://rodriguez.com/
29-Sep-2020,Interest,"56,345.00",00.00,"2,324,757.66",A6Dd3dB5bA44D3e,6165,Brian,Mccormick,"Foley, Cortez and Durham",Natashaland,Angola,001-545-162-9350x33238,316-806-7075x645,wwatts@dalton.com,2020-02-10,http://www.mcpherson-fischer.biz/
29-Sep-2020,NEFT,00.00,"2,324,757.66",00.00,ef2E35aaBbd01D2,2394,John,Hickman,"Hammond, Webster and Stewart",Faithchester,United States of America,+1-384-821-8201,(141)082-0694x4352,ngates@escobar-merritt.com,2021-10-28,https://www.may-owen.net/
29-Sep-2020,Debit Card,03.70,00.00,03.70,9BDca2Fca26EDf0,5798,Brandi,Mathews,"Rhodes, Howell and Perkins",North Dianatown,Sierra Leone,533.952.7323,1684097267,kchristian@hamilton.com,2020-11-09,https://herman.com/
29-Sep-2020,Purchase,735.26,00.00,738.96,bd175dabc90C9FE,9226,Jordan,Faulkner,Giles-Eaton,Farmerhaven,Malta,754.747.8995,(098)888-4164,kristinkane@dorsey.com,2021-06-20,http://www.mcmillan.info/
29-Sep-2020,Reversal,00.00,00.00,738.96,eCBaf733F3bCB28,1282,Jackson,Hodges,"Butler, Singh and Montgomery",Lake Gregg,Cape Verde,100-709-0573,(883)620-3883,crystal91@fields.com,2022-03-23,http://www.greer-macias.com/
29-Sep-2020,Bill,"1,227.55",00.00,"1,966.51",2c8b0b037Fc6b43,6440,Charlene,Church,Hanna-Short,Lake Veronicatown,Luxembourg,226-137-1386x41879,(864)120-1596,jerryberg@velez.com,2021-07-04,http://www.morrow.com/
29-Sep-2020,IMPS,00.00,491.63,"1,474.88",8D4A1B8aDd8eCec,3279,Andres,Rubio,"Willis, Burton and Griffith",East Dawn,Tonga,143-893-7884,114.962.9738x85245,sharon62@pace-barr.com,2021-01-19,http://jones-mayer.org/
29-Sep-2020,Bill,00.00,294.98,"1,179.90",aE35B96fad807Bc,554,Tanya,Beasley,"Hopkins, Monroe and Fitzgerald",New Cathy,Albania,599.260.0269,(177)331-7253x46538,tlittle@lam.org,2021-08-29,http://www.huffman-preston.com/
29-Sep-2020,Commission,00.00,131.10,"1,048.80",baF6BF63c8fD59F,4522,Carol,Ponce,"Oconnor, Munoz and Webster",West Laurachester,Mozambique,(521)086-0721x0897,202.271.3030x5913,daryl26@hutchinson-perkins.com,2022-03-07,https://kerr.org/
29-Sep-2020,RTGS,00.50,00.00,"1,049.30",7Ad7a3eB29216A1,5938,Kendra,Evans,Little Ltd,North Destiny,Malta,815-471-7619x463,(502)534-8449x3569,pattonnina@bradshaw-krause.com,2021-03-20,http://nash.biz/
29-Sep-2020,Interest,196.00,00.00,"1,245.30",ebeFbC8a56EE6db,9519,Zachary,Conner,Rowe Group,New Oscar,Slovenia,4471594397,032.249.7249x40901,glenda11@richard.com,2020-03-10,https://www.watson.com/
29-Sep-2020,Tax,255.00,00.00,"1,500.30",5aFAEDB6FA9332E,8048,Karen,Fuentes,Mack-Weaver,East Anita,Senegal,+1-782-421-7657x0331,727-112-6472,terrenceacevedo@obrien.com,2021-04-18,https://mcgrath.com/
29-Sep-2020,Bill,00.00,300.06,"1,200.24",b080f9aa3ABdBFE,5340,Alexandra,Vazquez,Stephenson and Sons,North Kelli,Hungary,2451623774,(114)099-9944,katrinalamb@mendoza.info,2021-02-28,http://sims.net/
29-Sep-2020,ATM,00.00,133.36,"1,066.88",85C2dE54bF40DBF,7211,Erik,Hanson,"Cisneros, Merritt and Arnold",Ninamouth,Rwanda,(829)731-8205x30667,(622)684-2708,morrowdon@hutchinson.net,2020-05-29,http://www.mcintyre.biz/
29-Sep-2020,Debit Card,01.00,00.00,"1,067.88",D91ADf42fC62B5D,7632,Jonathan,Coffey,"Gaines, Waters and Davidson",West Daisyhaven,Wallis and Futuna,+1-517-452-5092,7686237419,plamb@goodman.com,2020-12-21,https://www.hodge.com/
29-Sep-2020,Cash,00.00,177.98,889.90,e3d2bDBAD208dD0,1865,Christy,Lutz,Walker Inc,New Hunterstad,Japan,2019250766,(951)793-2121,tomterry@gilbert-livingston.biz,2021-07-10,https://www.jimenez.info/
29-Sep-2020,NEFT,"115,182.00",00.00,"116,071.90",d6e2A2cb6BA9D9C,6761,Wanda,Fry,Hensley-Maddox,Dianeborough,Morocco,001-498-541-5482x5780,+1-765-226-9719x1525,mollywilson@hinton.biz,2020-04-09,https://www.graham-ryan.com/
29-Sep-2020,Transfer,47.44,00.00,"116,119.34",AddDfA1DD8d20dA,3937,Joy,Thompson,Tanner LLC,Kellybury,Macao,001-994-610-0215x8669,7423911087,dzamora@horton.org,2021-11-01,https://www.suarez-black.org/
29-Sep-2020,Debit Card,00.00,"116,119.34",00.00,c0Cef0B6D7dbBf6,993,Monica,Ramsey,Rogers Inc,Jacobsonland,Uganda,(596)548-0115x457,857.160.8353,vazquezkerri@hays.com,2020-08-20,http://sims.com/
29-Sep-2020,Transfer,"150,321.80",00.00,"150,321.80",6aFe67Fa630bffA,7090,Miranda,Hodges,Solomon LLC,North Debbiechester,Cook Islands,545.298.4243,001-281-077-3424x794,chelsey96@hahn.biz,2022-01-01,https://dodson.com/
30-Sep-2020,NEFT,"937,004.00",00.00,"1,087,325.80",D9FaEfd9f2E71b2,1986,Sierra,Case,Reeves PLC,Davenportberg,Slovenia,+1-257-768-8102x55218,(636)141-3663,charleswalls@phillips.com,2020-08-22,https://mora.com/
30-Sep-2020,Cash,00.00,"1,087,325.80",00.00,03D5DDC0B1CeCa0,3239,Karl,Mejia,Molina-Durham,East Selenafort,Hong Kong,001-715-402-2928x82037,538.454.8560,kthomas@simpson.net,2020-09-28,https://barron.com/
30-Sep-2020,Cash,543.57,00.00,543.57,757c5420e96dd59,6046,Loretta,Stewart,"Sheppard, Mccormick and Cortez",Port Austin,French Southern Territories,001-424-076-7760x0918,(503)926-1142,dana89@gregory-little.biz,2022-04-22,http://frederick-mckay.com/
01-Oct-2020,Interest,06.10,00.00,549.67,040517eff707929,1566,Lindsey,Benjamin,Riggs-Greene,New Candice,Norfolk Island,001-844-110-1921x107,1164704437,adam20@wong-downs.com,2021-02-20,http://www.oconnell-gonzales.com/
01-Oct-2020,Transfer,00.00,274.84,274.83,2EcCF9B4972ABC8,4442,Loretta,Powell,"Norton, Phelps and Mckee",Port Kim,Falkland Islands (Malvinas),815-835-7979,981.446.7488x203,jacquelineschaefer@blackburn.com,2021-03-31,https://glenn.com/
01-Oct-2020,Reversal,01.90,00.00,276.73,a5191Bf5fd82ecd,9569,Debbie,Humphrey,Middleton Ltd,Sweeneyborough,Ethiopia,(120)602-6039x63632,134-940-4009,stoneregina@michael.com,2021-01-03,http://www.glass-wilkerson.net/
02-Oct-2020,RTGS,08.80,00.00,285.53,01eAD452b7A4B6a,3451,Isaac,Valenzuela,Harvey-Blanchard,Lake Brandon,Oman,+1-398-144-8701x161,791.188.0081x2856,mikaylacantu@meza-jarvis.net,2021-10-04,http://www.duarte.com/
02-Oct-2020,RTGS,00.00,95.18,190.35,7ADcFb7bc7D1663,2201,Mandy,Meza,"Blair, Vazquez and Hurst",Devonmouth,Faroe Islands,324-726-7199x738,(959)136-2277,dianedickson@jimenez.com,2021-09-27,http://www.lang.com/
02-Oct-2020,IMPS,"249,488.31",00.00,"249,678.66",Ef8b718ab8f0fC6,3416,Warren,Barron,"Jones, Austin and Pollard",West Christieview,Spain,738.351.8061x95718,(611)948-8804x131,hesskaitlyn@haney.com,2022-04-26,http://www.chen.com/
02-Oct-2020,Cheque,00.00,"49,935.73","199,742.93",AB4a3db2FEa2b0c,2685,Kristen,Decker,Raymond-Perry,Rosemouth,Kiribati,+1-486-152-9872x64911,068.601.4438,guzmanmonique@henderson-davila.net,2021-03-14,http://carroll-armstrong.com/
02-Oct-2020,Reversal,03.50,00.00,"199,746.43",Ff935DE2ab1fd1D,5141,Becky,Esparza,Lynch-Morse,East Luketon,Iran,224-533-0860x1210,697.565.5561,andrea26@nelson.com,2022-03-08,https://beltran.com/
02-Oct-2020,Cheque,00.00,"39,949.29","159,797.14",27AacEA1eBf1bEc,7230,Lawrence,Parrish,"Bartlett, Mendoza and Holland",East Sergio,Russian Federation,+1-157-084-7432x1070,485.246.4071,elliottjesse@solis.com,2020-04-30,http://www.wolfe.com/
02-Oct-2020,Cheque,"1,948.00",00.00,"161,745.14",c7Ff4269Dad0642,2363,Helen,Solis,York-Hayden,Sheliastad,Burundi,179-155-8734,857-362-2131x78008,lestercory@schwartz.org,2021-03-10,http://holland.com/
02-Oct-2020,RTGS,06.04,00.00,"161,751.18",be35Bddfe87CcC7,1697,Carlos,Hudson,Hays-Lynn,Lake Linda,Belarus,(414)354-5504x6813,465.876.9771x16879,alexsutton@nixon.net,2021-12-20,https://logan.net/
02-Oct-2020,Cheque,155.50,00.00,"161,906.68",0A8CDa9FF9DeCEd,3445,Franklin,Hale,"Patton, Walters and Perry",North Darrellport,Gabon,(013)297-9332x3515,+1-013-365-2630x92686,huangjillian@mathis.com,2022-01-17,http://hardin.info/
02-Oct-2020,Debit Card,"1,130,138.75",00.00,"1,292,045.43",760FE1bb4727eCC,4237,Mark,Hendricks,"Horton, Sanders and Matthews",Huertachester,Belgium,001-892-084-0399x83092,654.227.4185,reginald38@orozco-hahn.com,2020-06-19,https://www.mcdaniel.com/
02-Oct-2020,Cash,02.34,00.00,"1,292,047.77",52f9E859d4f4dF4,9873,Vincent,Russell,Poole Ltd,New Chelseahaven,Eritrea,081-284-0785x1134,001-128-461-6612x5841,kiddkathleen@richardson.com,2021-06-28,http://house.biz/
02-Oct-2020,Transfer,00.00,"129,204.78","1,162,842.99",61Cb08E7F99C1A3,6217,Tanner,Terry,"Cameron, Bolton and Crane",New Natalie,Mauritania,210.369.9372x187,+1-541-306-3180x06908,billsilva@beasley.com,2021-02-07,http://www.watson.org/
02-Oct-2020,Purchase,00.00,"232,568.60","930,274.39",Ca16CaC3DC9D0B0,7639,Susan,York,Lutz PLC,South Thomasberg,Liechtenstein,484-792-5095x069,+1-107-478-8291x80545,sparksmarcia@rodgers.com,2020-04-06,http://www.rosario.com/
02-Oct-2020,ATM,00.00,"310,091.46","620,182.93",6e5c9338F2fbBE9,8372,Christie,Brady,Vazquez Ltd,Lake Tammy,United States Minor Outlying Islands,531-309-6548x340,(774)478-5200,nathanarnold@pratt-spencer.com,2020-02-10,http://www.bender-reed.org/
02-Oct-2020,Bill,"5,096.80",00.00,"625,279.73",F4195E9e1621bD7,960,Alison,Riggs,Hall-Blackburn,Judithbury,Ethiopia,960.068.4536,(071)103-8359x4594,duranshawn@bowers.com,2022-03-30,http://www.mullen-morris.com/
02-Oct-2020,Cash,"210,282.00",00.00,"835,561.73",e5ADB2f9Ec70Bb6,4915,Grant,Peters,Marks Ltd,East Darinmouth,Palestinian Territory,(852)839-7345x4649,001-946-307-5639x9791,cwoodard@barnett-franco.org,2021-03-24,http://hebert-hayden.com/
02-Oct-2020,Bill,00.00,"119,365.96","716,195.77",087F7e1B651EFBC,7831,Cristina,Woods,Morales LLC,Waynechester,Falkland Islands (Malvinas),7985164709,667.031.1098x55676,rhuff@reyes-mcintosh.info,2020-08-04,http://www.duarte-rich.com/
02-Oct-2020,RTGS,"27,123.50",00.00,"743,319.27",FCb5B1D13ed8834,7646,Russell,Delgado,"Haney, Christensen and Burke",West Albert,Costa Rica,+1-414-829-6459x62048,310-780-3184,santanacassie@johns-casey.biz,2020-06-14,https://gaines-gilbert.com/
02-Oct-2020,Cash,04.00,00.00,"743,323.27",75dd96d0CFED490,3982,Andre,Andrews,"Yu, Decker and Tran",East Judy,Malta,9630265064,480-720-5976x1716,afoster@mccann.biz,2022-05-02,https://flynn.biz/
02-Oct-2020,Purchase,00.00,"92,915.41","650,407.86",824819341ec367f,5193,Kelsey,Roach,Vazquez and Sons,Kathrynfurt,United Kingdom,816-551-9052x61034,0068791886,janesilva@york-fleming.biz,2020-06-16,https://mann-fritz.com/
02-Oct-2020,Tax,00.00,"65,040.79","585,367.07",3bfEE48D2A38B98,111,Chad,Henry,"Gaines, Galvan and Goodwin",Hansonburgh,Cyprus,001-014-140-8925x13758,(560)696-8482,mathisgloria@house-hamilton.org,2020-07-05,https://silva.com/
02-Oct-2020,Debit Card,00.00,"292,683.54","292,683.53",c6B64EF177D53BD,836,Toni,Strong,Marquez LLC,New Malik,Cape Verde,371.095.6717,433.748.1155,mauricemosley@harvey-li.com,2021-11-12,https://www.richard.com/
02-Oct-2020,IMPS,"43,865.20",00.00,"336,548.73",3F9241ebD6bA4af,9429,Tammy,Ayers,Dillon-Wilcox,Mollyland,Iceland,001-793-724-1718,854.490.6605x8736,glassdana@bernard-barker.com,2021-11-01,http://www.house.com/
02-Oct-2020,Cash,00.00,"168,274.37","168,274.36",b40Ab47Ae0dCEc9,6390,Austin,Wilcox,Bennett-Clark,Boonefurt,Nicaragua,649-255-8311x245,+1-634-927-7887x6236,nicolas82@logan.biz,2021-07-02,https://butler.biz/
02-Oct-2020,Reversal,"14,079.80",00.00,"182,354.16",90cd0eBFcFaDB3f,8628,Carlos,Delgado,Garza-Frye,South Marie,Turks and Caicos Islands,102.018.0758,355-029-9122,sheliaarmstrong@gardner.net,2020-09-25,https://waters.com/
02-Oct-2020,Transfer,00.00,"26,050.59","156,303.57",EbEd31AB1596CA7,299,Jackson,Sawyer,"Simpson, Zhang and King",Hooverburgh,American Samoa,(991)556-3832x548,(729)282-0184,hectorlewis@gay-goodman.org,2022-05-04,http://ali.com/
02-Oct-2020,RTGS,00.00,"22,329.08","133,974.49",dA1edadCCE4CB8e,6668,Melanie,Mcdaniel,"Townsend, Compton and Goodwin",North Alvinmouth,Uzbekistan,828.617.2884x66695,(456)682-6363,zbridges@floyd.com,2021-05-04,http://malone-silva.com/
02-Oct-2020,Cheque,00.00,"66,987.25","66,987.24",d1654CCFDBc92Dd,7476,Edward,Townsend,"Mccoy, Bass and Yu",Bobport,Solomon Islands,001-998-926-3118x757,(515)058-7774x906,dustin11@stout-landry.org,2021-08-18,http://roberts-mcconnell.info/
02-Oct-2020,Tax,00.00,"9,569.61","57,417.63",5Da583a3aA4aCBA,2348,Timothy,Lowery,Simpson-King,Cookland,Canada,001-075-643-4986x728,072.214.8315,ellen38@rush.com,2021-03-05,https://www.avila.com/
02-Oct-2020,Cheque,00.00,"14,354.41","43,063.22",75578FB58Dcfe6E,5474,Margaret,Casey,Maxwell Inc,Port Erinville,United Kingdom,001-429-525-8997x7292,156.138.8305,bethany89@hartman.com,2021-05-25,https://evans.com/
02-Oct-2020,Reversal,00.00,"5,382.90","37,680.32",9FE1fBadf36D6c3,8954,Edward,Norris,Nielsen-Schneider,West George,Benin,4037606499,001-494-596-6957x46209,pcervantes@preston.com,2020-11-01,http://www.ellis.com/
02-Oct-2020,Bill,401.80,00.00,"38,082.12",4EDA8a0D021dd89,7440,Glenn,Pennington,Mcintosh Ltd,Lozanoview,Sri Lanka,+1-054-577-7573,001-390-833-9137,omathis@andrade.net,2020-07-18,https://mclean-hughes.com/
02-Oct-2020,Transfer,00.00,"12,694.04","25,388.08",d7a1c828dc04Ff7,515,Bonnie,Booker,"Pearson, Hubbard and Alvarez",South Christine,India,6961498901,412-244-1070x4570,penafrancisco@flowers.org,2021-02-25,https://gray-bowers.net/
02-Oct-2020,Interest,"232,990.00",00.00,"258,378.08",F5679f328DD6c68,5591,Logan,Cunningham,Gonzalez-Flowers,New Norman,Congo,646-568-2263x5298,843-746-1283x152,wrightjeanne@cortez-moore.com,2021-12-15,https://holden.com/
02-Oct-2020,Cheque,00.00,"43,063.01","215,315.07",f21CF91B332Dac8,9967,Margaret,Hines,"Wilkinson, Lamb and Holt",Gouldview,Guyana,727-808-0986x9527,868.979.0956,cheyenneboyd@tucker.biz,2022-01-15,https://www.mann.com/
02-Oct-2020,NEFT,"1,710,818.00",00.00,"1,926,133.07",4F1c6bA9Ded6D33,4215,Maria,Mayer,Mckinney-Humphrey,Hoovermouth,Afghanistan,+1-437-477-6649x4282,001-925-817-6769,michelecarney@norris.biz,2021-08-22,http://odom-costa.biz/
02-Oct-2020,NEFT,00.00,"192,613.31","1,733,519.76",fDe3575BF7f4ad3,9660,Kimberly,Cordova,"Klein, Scott and Mcintyre",Chrischester,Gabon,599.138.4408x557,001-171-529-3947x6754,charlesmoore@lowe.com,2022-05-03,https://wells-jennings.org/
02-Oct-2020,Bill,"1,363.70",00.00,"1,734,883.46",DeF4B9e08eAE8a7,229,Olivia,Saunders,"Sanchez, Coleman and Leon",Lisaville,Korea,298.311.2706x59582,+1-498-562-7577x9389,triciarichards@shelton.net,2021-03-30,http://www.hurley.com/
02-Oct-2020,RTGS,22.90,00.00,"1,734,906.36",baBDfE3ACE109be,8924,Mikayla,Roach,Yang-Alvarado,East Karen,Chad,(287)827-6054x274,7878571847,dpowers@wolfe.org,2020-12-18,https://caldwell.com/
02-Oct-2020,NEFT,"4,070.00",00.00,"1,738,976.36",ED25dffeb77d20c,6212,Darryl,Mcpherson,Mathis LLC,North Alexis,Iran,0882968937,230.144.3636x016,priscillarogers@wagner.com,2022-01-25,http://www.williamson.com/
02-Oct-2020,Cash,"214,076.00",00.00,"1,953,052.36",597df5C8A75B14D,1430,Dale,Solis,"Knapp, Huff and Garner",Spencertown,Jersey,(027)060-5731,054.420.9064x49651,jorge56@mendez-nicholson.biz,2021-08-04,https://coleman.info/
02-Oct-2020,Interest,"1,173,171.00",00.00,"3,126,223.36",bA85ddBFDfEaE56,6172,Michele,Grant,Good Ltd,North Amanda,Italy,+1-886-638-6340x6219,8761390739,porterjorge@powers.com,2022-02-18,https://www.huber.com/
02-Oct-2020,Reversal,"1,118.76",00.00,"3,127,342.12",23B6b53e4533122,5625,Jay,Reese,Juarez-Clayton,South Kyleton,Germany,898-115-5975,+1-436-034-0166x974,kreese@cherry.com,2020-03-14,http://www.cantrell.com/
02-Oct-2020,Debit Card,"2,750.00",00.00,"3,130,092.12",6dD1659A6CDC3F7,1340,Joyce,Robles,Lane PLC,Silvaport,Iran,001-268-180-7682x2159,001-939-453-4769,rittermeagan@beasley.com,2021-12-19,http://www.salazar.net/
02-Oct-2020,Purchase,00.00,"1,565,046.06","1,565,046.06",fCA2DadDeA0FdDe,7944,Angie,Stanley,Lucero Ltd,Beckybury,Northern Mariana Islands,611-927-2651x693,+1-204-779-2090x4058,bobchambers@mendoza.com,2020-09-04,https://velazquez.com/
02-Oct-2020,RTGS,"202,576.70",00.00,"1,767,622.76",47d09bef881fAFe,969,Renee,Hurley,Lyons Group,North Wayne,France,001-462-409-3330x678,308-650-7271x505,alvarezjoanna@cochran-peters.com,2021-03-31,https://carr.com/
02-Oct-2020,ATM,00.00,"220,952.85","1,546,669.92",EF179Df56d2C046,9895,Tamara,Fry,Levy Group,Kirbymouth,Mali,(611)848-1217x06285,+1-672-558-0003,rileytanner@joseph.com,2021-08-11,http://johnson.com/
03-Oct-2020,Cheque,"587,499.25",00.00,"2,134,169.17",2Ae4d9df594d9Ed,1530,Tamara,Terrell,Mckay Ltd,Braunbury,Tokelau,620-559-6905x9594,020.850.2233,millersergio@bray.net,2020-03-19,http://church.com/
03-Oct-2020,Bill,"8,082.00",00.00,"2,142,251.17",F55308bdbcB2230,4436,David,Stephens,"Acosta, Santiago and Newman",Hernandezburgh,Aruba,+1-965-357-7162x27711,001-770-529-1592,jaime60@keller.org,2021-09-03,http://castaneda-pope.com/
03-Oct-2020,RTGS,00.00,"2,142,251.17",00.00,f9Be6F3d2BAcc1E,7504,Melvin,Gibson,Whitaker-Brewer,North Yesenia,Madagascar,775.701.5643x92755,130-285-7393x332,harrellisaiah@chen-donaldson.com,2020-02-01,http://www.coffey.com/
03-Oct-2020,Commission,"11,484.00",00.00,"11,484.00",40A7bd9D814bF64,8739,Henry,Webb,"Crane, Faulkner and Zavala",Frazierbury,Italy,(180)872-2244x5941,528-208-8871x021,marciabush@murillo.com,2020-03-13,https://www.kelly.info/
03-Oct-2020,Commission,"217,350.00",00.00,"228,834.00",94fBaEc207eDdfa,3276,Christian,Garza,Palmer PLC,New Chase,Djibouti,+1-245-918-3186x8039,001-637-415-5706,sproctor@le.biz,2022-04-03,https://www.scott-vance.com/
03-Oct-2020,Bill,00.00,"25,426.00","203,408.00",Ae4d3ad361d40FC,7986,Levi,Coleman,"Cordova, Rollins and Henderson",South Samuelport,Macao,054.312.3945,(769)427-8490x86414,claire48@campos.com,2020-08-28,http://mata.com/
03-Oct-2020,Bill,00.00,"29,058.29","174,349.71",A8dFDe0bA4BbaB4,9739,Ryan,Bautista,Buckley-Spencer,South Shelley,United States Virgin Islands,552-192-5521x179,086-595-3058,reeseanthony@hickman.com,2020-11-13,https://long-grimes.com/
03-Oct-2020,Commission,"29,240.50",00.00,"203,590.21",cfDB96C0EaD9550,5956,Erica,Andrews,Blackwell-Dennis,Balltown,Palau,001-379-361-8902x7493,+1-840-218-7459x8742,wanda09@yang.net,2021-06-29,http://www.trujillo.com/
04-Oct-2020,Commission,03.20,00.00,"203,593.41",bF9B570B3bDdcE6,8992,Glenn,Russell,Frazier-Petty,South Corey,Sri Lanka,928-289-8831,+1-577-960-6299x4120,rdunlap@jenkins.com,2021-03-07,https://oconnell.com/
04-Oct-2020,RTGS,51.70,00.00,"203,645.11",B9DCaC19254369b,4975,Dominique,Tapia,Meadows-Cooley,Lake Garyborough,French Polynesia,857-570-8724x2249,2200454553,sherryellison@garza.com,2020-09-19,http://mcintyre.info/
04-Oct-2020,Cash,"3,285.00",00.00,"206,930.11",5EEe2cC2A1Cbe0A,9590,Andre,Mcmahon,Singleton-Estes,Hannahberg,Lithuania,584.718.3893,875-571-4454,beth13@baird.com,2020-01-24,https://goodwin.com/
04-Oct-2020,Miscellaneous,08.29,00.00,"206,938.40",31BA9c58e4FfCbc,3847,Alfred,Leach,Gaines LLC,Lesterbury,Guernsey,3510481774,784-014-9507,normanjohns@guerra-owens.com,2021-12-13,http://www.lane.biz/
04-Oct-2020,Commission,"177,106.50",00.00,"384,044.90",9ad6dAD4BEbBe83,8477,Alexandria,Rush,Pena-Werner,Booneberg,Somalia,087.119.7767x504,280-321-6548x65361,barberdakota@proctor-morton.info,2020-05-10,http://glover.org/
04-Oct-2020,Cheque,00.00,"192,022.45","192,022.45",CCD016f5e064faF,1739,Gwendolyn,Foley,Heath and Sons,Emmaland,Turkmenistan,320.107.8978x2778,001-156-511-5085x73976,kara18@short.com,2020-03-10,http://donaldson-roach.info/
04-Oct-2020,Cash,00.00,"192,022.45",00.00,edb08eE9E9C0A45,4448,Priscilla,Molina,Ramirez-Medina,North Shari,Botswana,8352859646,(353)067-9819x76907,ekennedy@conway.com,2020-12-21,http://www.braun.com/
04-Oct-2020,Miscellaneous,01.30,00.00,01.30,EDb0DCAaf614c22,801,Daryl,Reid,Winters-Sandoval,Bullockborough,Taiwan,3105048938,(039)191-1383,markcamacho@hooper.com,2020-02-26,https://www.carr-mendez.biz/
04-Oct-2020,RTGS,24.50,00.00,25.80,d5879ba7DfE7cE2,4365,Anne,Quinn,"Silva, Watts and Pitts",West Lynn,Finland,001-701-644-2601x20012,799.253.9286x2490,orichardson@mayer.biz,2021-12-15,http://barnes-hendricks.com/
04-Oct-2020,Cheque,00.00,25.80,00.00,977DEacE80FEbb4,8263,Derrick,Hurst,Ho PLC,Rodneychester,Bermuda,7531749308,863.688.5049,sherriroth@padilla-wilkins.com,2021-06-15,https://www.cook-fischer.com/
04-Oct-2020,Bill,06.00,00.00,06.00,e475Ab6813C6E1B,858,Audrey,Frederick,Moody Inc,Edwardborough,Portugal,845-687-0055x8211,0104078496,ebarajas@flores.com,2021-06-16,http://cruz.com/
04-Oct-2020,Reversal,00.00,02.00,04.00,A0DEe53a96fEe4D,3874,Alex,Collier,Rodgers-May,Annstad,British Virgin Islands,576.434.4376,3548919730,stuart65@briggs.net,2021-11-15,https://logan-berger.com/
04-Oct-2020,Interest,00.00,00.44,03.56,5FaD6BfE5ebE92D,4280,Philip,Lutz,Sweeney LLC,Sosaberg,Pitcairn Islands,716-188-3432x44057,144.469.8333x113,carol28@ross-jensen.com,2021-03-04,http://www.vega-salazar.biz/
04-Oct-2020,Purchase,00.00,03.56,00.00,0d34D3F3780CB62,4274,Michelle,Atkins,English-Cooley,East Adrian,China,467-071-2561,(547)067-3099x6859,pagemanuel@mercado-dudley.com,2020-05-06,https://www.ramirez.net/
04-Oct-2020,NEFT,"18,954.00",00.00,"18,954.00",6f5a4aae7d6A1Bf,2154,Ann,Byrd,Sosa-Montgomery,Mccannstad,Sudan,(664)624-3178,001-529-317-5450,derek70@richmond.com,2021-10-22,https://martinez.com/
04-Oct-2020,Interest,"1,285,838.00",00.00,"1,304,792.00",8E2BA74A98E2f32,7868,Dave,Peck,"Pearson, Garner and Good",West Patriciaton,Micronesia,001-382-859-5941,+1-545-115-9203x38194,dyersandy@baird-odonnell.com,2021-01-30,https://mcneil-webb.com/
04-Oct-2020,RTGS,00.00,"260,958.40","1,043,833.60",Fd09AA3c0E32cCf,456,Logan,Dickerson,Arnold Ltd,Lake Robin,Heard Island and McDonald Islands,(706)788-7595x22855,948.876.9672,rachael73@spencer.com,2021-08-13,http://www.hamilton.com/
04-Oct-2020,Reversal,05.99,00.00,"1,043,839.59",83d5b6bba5dC1FD,8691,Darlene,Blevins,"Castillo, Collier and Gibbs",Yufurt,Austria,340.117.4220x05591,237.409.0906,angie51@pacheco.biz,2022-04-27,https://glover-rosales.com/
04-Oct-2020,Debit Card,"2,078,410.80",00.00,"3,122,250.39",fE327893b742CdF,1272,Kathy,Hale,"Holloway, Weeks and Middleton",Port Tiffanyview,Tuvalu,4149519853,(607)643-4319,rhodesjon@cummings.biz,2022-01-13,http://www.mcdowell.com/
04-Oct-2020,Cheque,48.00,00.00,"3,122,298.39",DF9bcCfCe4FacE3,3418,Carrie,Russo,Francis LLC,East Courtneyview,Thailand,8155699107,+1-111-339-2315,carl60@kennedy.com,2020-12-06,https://richards.net/
04-Oct-2020,Tax,00.00,"1,040,766.13","2,081,532.26",9a0fD1AB15852ab,5408,Alyssa,Morales,Rogers Group,West Alexandriamouth,Israel,714.342.6502x130,145-923-3699x826,joyhess@hancock.com,2020-06-27,https://www.kirk-durham.com/
04-Oct-2020,Transfer,"2,245.03",00.00,"2,083,777.29",4EBfE088fbCe23C,3030,Shawna,Everett,Flynn PLC,Jamesside,Maldives,487-099-2999,1139256770,hesseric@burke-grant.info,2020-04-27,https://www.gutierrez-jones.com/
04-Oct-2020,Transfer,"1,761,181.75",00.00,"3,844,959.04",62Dc5d901e6C9EE,253,Priscilla,Cortez,"Dodson, Wagner and Roth",Dylanshire,Jordan,+1-704-228-1033x97217,400-638-3888x8832,jenny52@berry.com,2020-09-23,http://www.barber-jensen.com/
04-Oct-2020,Cash,"840,932.00",00.00,"4,685,891.04",Fa1bf4A5aDb3AE6,9042,Laurie,Blackburn,"Holt, Meyers and Sharp",Beckytown,Argentina,7275517486,230-110-7181x574,chenselena@cochran-fuller.info,2021-03-31,https://washington-brewer.com/
04-Oct-2020,IMPS,757.00,00.00,"4,686,648.04",B8FcDFcEedB34aA,5035,Danny,Shaw,"Mcneil, Martin and Deleon",Lake Debrahaven,Iran,462-104-8487,(555)631-3822,nathaniel57@haynes.org,2021-08-13,https://harding-dixon.com/
04-Oct-2020,Cash,"3,944.21",00.00,"4,690,592.25",d69cf4cC4ABb4e6,965,Bradley,Torres,Duncan-Navarro,North Meagan,United Arab Emirates,001-639-335-9537x3108,264-339-0859x80819,qperry@carey-figueroa.com,2020-05-31,https://hamilton.com/
04-Oct-2020,Cash,"1,640,720.80",00.00,"6,331,313.05",D2d355a67bF2AB8,7995,Scott,Pugh,Craig Inc,Katieville,Myanmar,112-112-4640,+1-513-043-4018x331,jli@boyer.com,2020-06-20,https://www.wiggins.com/
04-Oct-2020,Bill,"1,557.50",00.00,"6,332,870.55",A9A1d18Ba443F0E,1677,Jerome,Ortega,Solomon Group,Bernardfort,Saint Pierre and Miquelon,+1-737-995-5737x03400,(664)856-8452x6313,dwarner@huffman.com,2022-03-25,http://holloway.com/
04-Oct-2020,Interest,"252,952.80",00.00,"6,585,823.35",CFc2E3fBb2cc695,8042,Katherine,Weaver,Barnett-Blackburn,Kathleenville,Saint Pierre and Miquelon,024.864.8424x80179,+1-112-847-0042x73388,poolekerri@johnston.com,2022-03-18,http://www.gilbert.com/
04-Oct-2020,Commission,00.00,"731,758.15","5,854,065.20",eeFaFbEf151cAcC,1547,Karina,Blackburn,"Gentry, Weiss and Velez",Lake Olivia,Montserrat,001-900-197-5763x98762,372-792-8329x60243,timfreeman@taylor-velez.com,2020-06-08,http://mcconnell.org/
04-Oct-2020,Tax,00.00,"650,451.69","5,203,613.51",fE18b60F48DB50c,1824,Drew,Benson,Pittman PLC,Port Hectormouth,Lithuania,(104)809-3951,+1-211-855-5357x6865,ferrellmarc@mata-lindsey.info,2021-06-15,http://www.moran.org/
04-Oct-2020,Purchase,00.00,"1,300,903.38","3,902,710.13",F32c88af72E729D,8051,Karl,Braun,Benson-Everett,Gravesbury,Eritrea,552.080.6560,001-722-132-5633x52949,zchurch@schmidt.net,2021-03-07,https://www.burch-bender.com/
04-Oct-2020,Reversal,00.00,"1,300,903.38","2,601,806.75",E00A87b6bDE631b,6452,Seth,Kennedy,"Guzman, English and Saunders",Neilchester,Myanmar,195-029-4497,+1-942-436-3695,alishali@larsen.net,2022-01-03,http://www.chan.net/
04-Oct-2020,Purchase,00.00,"260,180.68","2,341,626.08",FD6Fe62ed5A02f1,6827,Ann,George,Brock Ltd,Lake Cynthia,Tajikistan,001-469-809-0412x62925,9841811306,warejeff@salas.com,2020-12-05,https://barry.com/
04-Oct-2020,Transfer,"23,607.36",00.00,"2,365,233.44",5cBEdEe2A12AccE,5934,Christopher,Giles,Brown PLC,Alexandriabury,Heard Island and McDonald Islands,684.171.1119x692,523.175.2979x58552,ohoward@roth.com,2021-05-11,http://lawrence-guzman.com/
04-Oct-2020,Purchase,00.00,"295,654.18","2,069,579.26",b913E1515bFEDC3,124,Duane,Brock,Beltran LLC,East Rebeccashire,French Guiana,503.800.5804x8397,001-296-131-0612x3322,sarahpotts@bradford.com,2020-05-07,https://alvarado.com/
04-Oct-2020,IMPS,00.00,"413,915.85","1,655,663.41",Df12bAEF5EE5baf,3966,Autumn,Galloway,Keller-Quinn,Port Lori,Maldives,001-908-885-5126,714-532-9173x425,gordonabbott@carson-robles.com,2020-09-06,http://perkins.com/
04-Oct-2020,NEFT,00.00,"551,887.80","1,103,775.61",E88Fc5CC602361F,8945,Rhonda,Brennan,"Diaz, Edwards and Lowery",Doughertyfort,San Marino,179.651.4321,+1-861-047-0183x23697,maxlloyd@fry.com,2021-12-13,http://little.com/
04-Oct-2020,RTGS,00.00,"157,682.23","946,093.38",70DcEfb4bB551b7,1521,Cameron,Potter,Ross-Parrish,Codymouth,Armenia,040.852.3384,(772)055-1613x98307,kreid@nelson.com,2022-04-09,http://www.nelson-green.biz/
04-Oct-2020,Miscellaneous,47.00,00.00,"946,140.38",44CeeBEfb6d09A8,1316,Jaime,Hardin,Bryan-Velazquez,Charlenehaven,Chad,+1-724-812-5924x2800,707.430.1855,clairehanson@jimenez.biz,2021-01-22,http://www.madden.org/
04-Oct-2020,NEFT,00.00,"118,267.55","827,872.83",6cDfAaf87cd992F,104,Terri,Hurst,"Shannon, Patterson and Martinez",Lake Omarbury,Luxembourg,+1-012-633-1812x604,(454)485-5374x59454,vernonrush@harvey.com,2020-06-30,http://www.hurst-johnston.info/
04-Oct-2020,IMPS,00.00,"206,968.21","620,904.62",aebEcf786E55Fff,4848,Raven,Morales,Martin PLC,West Tashamouth,Northern Mariana Islands,272-714-0293x40949,+1-217-995-2774x99468,terrence18@west.net,2021-12-24,http://anderson-jenkins.com/
04-Oct-2020,Commission,00.00,"88,700.66","532,203.96",16e0CbCdFcaB8D2,6442,Melvin,Patton,Porter Ltd,East Heatherton,Angola,900.754.1904,001-603-127-1683,fbender@steele.com,2021-04-07,http://www.oneill.net/
04-Oct-2020,IMPS,"1,377,162.50",00.00,"1,909,366.46",76bDf48CC7dD5Bd,4826,Yvonne,Mckinney,"Bolton, Owen and Pham",Judithport,Djibouti,(158)202-2736x758,096-792-3669x54559,cnunez@johns.com,2022-04-09,http://moss-brennan.com/
04-Oct-2020,NEFT,00.00,"636,455.49","1,272,910.97",FbCd0bF57B266Bb,6056,Deanna,Waller,"Norton, Velasquez and Ponce",West Jaclyn,Netherlands,133.387.8310,001-335-832-5021x8398,lesterjacqueline@leonard-deleon.net,2021-09-17,http://www.irwin-zimmerman.com/
04-Oct-2020,NEFT,00.00,"254,582.19","1,018,328.78",Eb3c12fc46a7966,2000,Oscar,Church,Frost Ltd,Smallstad,Korea,(460)036-9281,(746)482-3059x962,lonnie66@blake.biz,2022-01-25,http://potter.org/
04-Oct-2020,Reversal,"29,206.70",00.00,"1,047,535.48",06CEd2F28a10F43,5852,Dave,Everett,"Hogan, Griffith and Jefferson",New Jeff,Isle of Man,001-413-693-7164x4942,543-511-0335,crojas@wolf-pittman.com,2021-02-11,http://stone.com/
04-Oct-2020,Bill,00.00,"104,753.55","942,781.93",EF78b8Cb47a0D7f,9746,Francis,Phelps,Morse-Dorsey,Mccormickmouth,Latvia,067.174.1997x6490,(271)526-1827,hesterkim@sanders.com,2021-03-10,https://rangel-schmidt.com/
04-Oct-2020,Interest,"1,967,989.20",00.00,"2,910,771.13",2Ae4d9df594d9Ed,1530,Tamara,Terrell,Mckay Ltd,Braunbury,Tokelau,620-559-6905x9594,020.850.2233,millersergio@bray.net,2020-03-19,http://church.com/
04-Oct-2020,NEFT,"1,781,135.00",00.00,"4,691,906.13",FCfbDF05Bc7a7c6,539,Andres,Kennedy,Conner Group,Port Kirsten,Falkland Islands (Malvinas),(482)286-3803,001-313-359-6200,kristen16@mcdonald.com,2022-02-16,https://aguirre.com/
04-Oct-2020,Cheque,00.00,"781,984.36","3,909,921.78",FebD11a0a4f3BE1,340,Anita,Daniel,"Chapman, Rojas and Morgan",Richardfort,Angola,(258)690-1199x499,+1-033-650-2789,valentinecaitlyn@henry.com,2020-06-30,https://www.mcpherson.com/
04-Oct-2020,Interest,"3,796.19",00.00,"3,913,717.97",7fFbBA72BEBcFac,3734,Tracy,Church,Cardenas-Hayes,East Tina,Guinea-Bissau,721-485-3683x9708,256.184.4751,charleneyoung@holland-hunt.info,2020-02-09,https://www.kennedy.com/
04-Oct-2020,Cash,"98,351.03",00.00,"4,012,069.00",B6C8723eBc92D35,3417,Daryl,Guerra,Gallegos Inc,Paulaview,Rwanda,516.356.0800,224.197.5640x6148,sharon91@walker.biz,2021-11-25,http://costa.org/
04-Oct-2020,Interest,00.00,"4,012,069.00",00.00,86FC4E3087C3eD7,6246,Alan,Callahan,"Francis, Paul and Avery",Anahaven,Ecuador,(321)655-5671x37772,898-657-8110x81307,haileycherry@allen-cobb.com,2020-02-23,https://www.house-banks.com/
04-Oct-2020,Interest,01.30,00.00,01.30,Eac59eEa3FC3DB9,6123,Andres,Harrison,Rojas-Ortega,Antoniofort,Peru,565.594.9099,+1-065-356-3045x18591,tracey81@liu-lindsey.com,2020-07-14,http://www.ellis.com/
04-Oct-2020,Reversal,55.20,00.00,56.50,41FB63B1bcA71F6,2230,Makayla,Shelton,"Lopez, Oneal and Giles",Marcoberg,Cambodia,001-037-345-2027x37133,036-696-4965,meredith21@mills.org,2021-06-24,http://maynard.info/
04-Oct-2020,Reversal,"1,091.00",00.00,"1,147.50",Ede2b4aF6f79b3d,2069,Seth,Vance,Harrison-Delgado,East Davidtown,Turkey,(726)641-6058,395.423.6967,alvin02@ford-garrison.com,2021-06-30,https://www.howell.com/
04-Oct-2020,Commission,00.00,191.25,956.25,eCE3BBEB6Adc33d,5135,Dwayne,Bernard,Norton Inc,Bentonstad,Bosnia and Herzegovina,(996)951-1025,923.867.4392x72238,reginaldcooke@decker.com,2021-11-23,http://simon.org/
04-Oct-2020,Transfer,"3,717.58",00.00,"4,673.83",7a7de0A6AF47cc7,6027,Victoria,Reeves,Mccarty LLC,North Samuelshire,Singapore,+1-119-772-8316x07490,(821)252-9527x62170,steve98@henson.com,2022-04-04,https://mckay-cooke.com/
04-Oct-2020,Purchase,"1,883,062.00",00.00,"1,887,735.83",BCed6Bc778E0952,1122,Morgan,Flynn,"Vasquez, Bean and Ashley",Diazberg,South Georgia and the South Sandwich Islands,748.930.8683,667-775-9977x142,opittman@franklin.net,2021-10-06,https://pitts.com/
04-Oct-2020,Transfer,00.00,"209,748.43","1,677,987.40",6d3d9e8F86679fb,4031,Ana,Paul,Humphrey and Sons,East Amandashire,Vanuatu,660-177-1599,261.516.7150x59456,edwinkey@benson.com,2022-02-10,http://www.monroe.com/
04-Oct-2020,Reversal,"1,815.00",00.00,"1,679,802.40",8d8FF8D3527828b,6898,Diana,Gardner,Cortez-Solomon,Erikaside,Moldova,805-281-8333x839,609-279-2771x790,timothy92@mullins.com,2022-03-07,http://orozco-gaines.com/
04-Oct-2020,Transfer,221.00,00.00,"1,680,023.40",aBF98dFd3034AEE,6697,Catherine,Huerta,Henry-Trujillo,East Jasmineland,Bosnia and Herzegovina,(175)855-7201x53391,(305)395-2582x208,wburns@chase.com,2020-10-28,http://pena-case.com/
04-Oct-2020,ATM,00.00,"420,005.85","1,260,017.55",D85f43ccaF0fD9c,3015,Charles,Brady,"Snow, Espinoza and Branch",Haleyborough,Argentina,001-647-462-4590x33848,481-884-4148x72018,kpetty@green.com,2022-05-17,http://www.barton.com/
04-Oct-2020,RTGS,00.00,"210,002.93","1,050,014.62",FbdB4CF8A3D2396,6817,Leslie,Pitts,"Green, Brennan and Coleman",Mariohaven,Tunisia,+1-877-729-1574x52997,001-920-518-7888,kdavidson@baird-schwartz.com,2020-06-12,https://kelley-gill.com/
04-Oct-2020,Reversal,"2,856.74",00.00,"1,052,871.36",a3F6fb7F0cF2Fbe,1100,Stephen,Rasmussen,Williamson Inc,Lake Tracy,Switzerland,001-058-442-2449x85855,+1-056-759-4952,twarren@wolfe.com,2022-04-19,https://www.daugherty.com/
04-Oct-2020,Cash,716.97,00.00,"1,053,588.33",6D810B88eBBDEE4,1684,Natasha,Nicholson,"Olsen, Hernandez and Garza",Griffithburgh,Monaco,207-456-6983,001-147-048-0671,afrye@sandoval.biz,2020-12-24,http://www.stevens.com/
05-Oct-2020,Miscellaneous,00.00,"526,794.17","526,794.16",151A6a7Deb33bcA,183,Stacy,Hayden,Rush and Sons,Port Shawna,Spain,001-383-579-5745,+1-222-830-3139x0809,gravesalisha@harrell.info,2021-11-24,https://www.li.biz/
05-Oct-2020,RTGS,00.00,"263,397.08","263,397.08",C58eFabBFe3bB64,8822,Angela,Davila,Parks Group,Port Rodney,Egypt,(148)886-4742x321,567.737.6907x775,bakerana@leon.com,2020-02-25,http://www.cowan-lawson.com/
05-Oct-2020,Debit Card,46.00,00.00,"263,443.08",538d27B5B8DFafa,3294,Gabriella,Barrera,"Kemp, White and Sosa",Wardton,Saint Martin,001-575-398-3746,(219)700-4764x8248,leonardrhonda@michael.com,2020-04-03,http://barrett.net/
05-Oct-2020,Transfer,"3,697.10",00.00,"267,140.18",BAA76688A26bfa1,730,Javier,Levy,Underwood and Sons,New Elainefurt,Suriname,+1-023-939-7348x03518,740-577-7210x88523,luis75@lucas-price.com,2022-04-18,http://pham.com/
05-Oct-2020,Purchase,00.00,"38,162.88","228,977.30",e0510d8AfBE0e2C,6100,Charlene,Mullen,Calderon LLC,New Kimchester,Bosnia and Herzegovina,(890)744-2764,848.683.5632,aayers@warren-burch.info,2020-01-13,https://www.harvey.net/
05-Oct-2020,Interest,00.00,"28,622.16","200,355.14",24991d88D469BFC,6608,Carmen,Wiley,Barr-Sawyer,West Autumnberg,Tajikistan,001-656-756-6618,+1-745-363-0989,nicole66@graham-burnett.org,2021-08-27,http://hamilton.com/
05-Oct-2020,Bill,00.00,"22,261.68","178,093.46",9adB0599CaeCCDA,4598,Debra,Price,"Lester, Lucero and Alvarez",Lake Colin,Switzerland,001-942-146-6041,(575)263-2838,dominicsimon@villanueva.org,2021-03-10,http://www.rollins.com/
05-Oct-2020,Cheque,00.00,"59,364.49","118,728.97",1BF1798e57e461D,953,Marie,Leblanc,Huff and Sons,Ronaldbury,Jordan,001-210-355-5380x643,(780)346-0158,brandy33@larson-blair.com,2020-11-03,http://www.marquez.org/
05-Oct-2020,Cash,05.00,00.00,"118,733.97",D5eb0D2875dCD7A,1459,Brandi,Prince,"Maxwell, Rubio and Schwartz",Schmidtfurt,Costa Rica,523.913.2340x6908,(699)717-9753,dominic93@olsen.com,2022-05-20,http://roy.com/
05-Oct-2020,RTGS,00.00,"13,192.66","105,541.31",290D433DDc9FA44,7051,Sabrina,Stein,Oconnor-Wheeler,West Brady,Cuba,110.483.9449x445,140.584.2566x48428,guy24@mullins.com,2022-03-24,https://www.suarez.net/
05-Oct-2020,IMPS,07.00,00.00,"105,548.31",2C7CBa68e6c1595,3066,Tasha,Bentley,"Young, Hester and Campbell",Lake Roseborough,Dominican Republic,513.199.9301,806-436-5148,linda14@flynn.com,2021-11-28,http://www.salas.com/
05-Oct-2020,Debit Card,00.00,"105,548.31",00.00,bFf6FB8b3F0852B,2976,Wanda,Lowery,"Osborn, Wolfe and Knox",Ricardoview,Taiwan,027-885-3739x851,227-419-1561x953,smithfelicia@mora-yates.com,2021-01-21,http://www.alvarado-craig.com/
05-Oct-2020,Commission,"62,640.00",00.00,"62,640.00",1EEfc81f0a6d054,4735,Kari,Williamson,Richards PLC,Jenningsshire,Bolivia,(561)904-1315x347,549.684.8708,ymathews@singleton.com,2021-06-14,http://www.solomon-jackson.com/
05-Oct-2020,Commission,593.00,00.00,"63,233.00",7B63C90d01DB0F8,1722,Connor,Serrano,"Solis, Fields and Paul",North Jimmyfort,Mayotte,745-360-7320,5115516988,olivia37@phelps.com,2021-03-31,https://french.com/
05-Oct-2020,NEFT,55.62,00.00,"63,288.62",a26711e5794EAdb,5377,Michaela,Dillon,"Gutierrez, Cruz and Freeman",Lauraberg,Egypt,975-393-0290x83245,(304)406-9697x3947,kara47@mcclain.net,2021-05-10,http://www.mathews.biz/
05-Oct-2020,ATM,"23,007.00",00.00,"86,295.62",d560F2Ae3F04Ed8,578,Margaret,Christensen,Shields-Peterson,South Chris,Samoa,(234)325-0895,4827936216,anayoung@stephens-christensen.com,2021-10-01,http://www.massey.net/
05-Oct-2020,Purchase,"1,318.00",00.00,"87,613.62",D4b6bD4dd767b8b,8678,Jenny,Larson,"Mejia, Moss and Wright",Carlyhaven,Vietnam,(569)714-2863,(568)824-3292x9208,mariamccullough@dalton.com,2020-05-01,https://www.park.com/
05-Oct-2020,Cheque,"223,234.03",00.00,"310,847.65",a8a585BB5EEa3cf,2655,Ernest,Dunlap,Bowers Ltd,Wisetown,Tajikistan,235.414.3384x531,158-212-6889x046,tsavage@vasquez.com,2021-05-10,http://www.dickson.com/
05-Oct-2020,RTGS,05.70,00.00,"310,853.35",bcEaA988648d3E3,3251,Traci,May,Harris-Anthony,New Frankton,Kenya,986-340-0253,+1-061-966-9225x64166,alexandra21@kemp.biz,2020-05-24,https://www.dudley.com/
05-Oct-2020,IMPS,00.00,"62,170.67","248,682.68",D169531CeaC2D3E,113,Noah,Gallagher,Franklin LLC,Bryantfurt,Syrian Arab Republic,001-072-846-4420x3958,7795040584,hortonmiguel@mays-rivers.org,2021-02-06,https://morse.org/
05-Oct-2020,IMPS,00.00,"27,631.41","221,051.27",2Ea64a27cDd5eA7,2212,Janice,Vang,"Huang, Huynh and Medina",New Sheila,Nigeria,9592715253,+1-573-358-2957,timothymorton@fields.biz,2020-03-21,https://www.chen.com/
05-Oct-2020,Cash,00.00,"73,683.76","147,367.51",D9c4B9c32cDe980,8332,Sara,Yoder,Garrett Group,Philipside,British Virgin Islands,(063)711-7752x60359,470-883-0227,pinedaearl@mcgee.net,2021-06-28,http://bridges-huang.info/
05-Oct-2020,Bill,00.00,"18,420.94","128,946.57",d9aC4EefF0a36E4,6587,Matthew,Savage,"Freeman, Woods and Drake",Cannonland,Saint Vincent and the Grenadines,313.864.8069,(538)600-6306,darrenduarte@boyer-freeman.com,2021-04-30,http://petty.com/
05-Oct-2020,Debit Card,"34,472.00",00.00,"163,418.57",BBa1Fa9FfDC1D77,4657,Sonya,Cortez,"Richmond, Horton and Coffey",Rhondamouth,Congo,001-287-648-0358,383.958.3022,yschultz@gallagher.com,2022-03-14,https://www.neal.com/
05-Oct-2020,IMPS,00.00,"23,345.51","140,073.06",a4492c442DcCE5b,6517,Alyssa,Weaver,"Salinas, Rivera and Hebert",New Joy,Bahamas,433-825-3326x8001,(814)016-1201x964,amarshall@horn.com,2022-03-08,http://www.mccall-chang.org/
05-Oct-2020,Cash,00.00,"46,691.02","93,382.04",aB883abf8BFD23b,7421,Ross,Valentine,"Dunlap, Hicks and Rogers",Stewartville,Sri Lanka,001-074-691-9670x179,658-806-7782x0931,rhonda66@green.com,2020-05-07,http://www.franco.com/
05-Oct-2020,Tax,"2,115.50",00.00,"95,497.54",EdBBe0D36479Dd7,2433,Sandy,Church,Rodriguez and Sons,Juliashire,Palau,769-150-1401,001-244-071-4899x067,hinesmelinda@weber-joseph.com,2020-04-20,https://fletcher.com/
05-Oct-2020,Cash,"1,034.70",00.00,"96,532.24",54F7F47a2FF89a7,5758,Sonya,Rubio,Harding-Swanson,Bernardmouth,Wallis and Futuna,(643)924-4289x2825,+1-085-415-2657x1368,jillian31@jenkins-whitehead.com,2020-06-06,https://www.hickman-beck.com/
05-Oct-2020,Tax,35.19,00.00,"96,567.43",9B6d4BCbF8B43E2,6052,Terrance,Cline,Williams Inc,Nataliebury,Gambia,522.205.4731,+1-276-416-1838x655,eaustin@mullins.biz,2021-06-17,https://duncan.com/
05-Oct-2020,NEFT,00.00,"10,729.71","85,837.72",fcFAb4CcfEDCCb2,9327,Angie,Braun,Pope-Larsen,Harrisburgh,Ireland,+1-018-085-8514x3327,019-628-0414,zshelton@norman.com,2021-07-15,https://www.horn.com/
05-Oct-2020,NEFT,00.00,"10,729.72","75,108.00",a6aC18c20BB4b38,4320,Norma,Sparks,Randall PLC,Port Jasmine,Vanuatu,010.353.2649x5807,(975)838-4077x95596,paige89@bryan-andrade.org,2020-03-17,http://www.moore.com/
05-Oct-2020,RTGS,00.00,"7,510.80","67,597.20",d1Be4D41500884C,4914,Steven,Finley,Lamb Group,Stantontown,Bouvet Island (Bouvetoya),340-106-7755x365,(809)563-5088,zwoodward@petersen-mclaughlin.com,2021-07-06,https://www.archer.com/
05-Oct-2020,Miscellaneous,00.00,"22,532.40","45,064.80",DccfB536C1edb1a,8377,Cheryl,Fitzgerald,Hughes-Ingram,Lindaville,Belarus,+1-848-865-7480x4017,+1-565-443-9766x526,pritter@campos-dean.com,2022-01-24,http://www.riggs.com/
05-Oct-2020,Reversal,00.00,"7,510.80","37,554.00",2ef7898c342EBe6,9316,Patty,Morrow,Hale PLC,New Dontown,Djibouti,000.618.2439x599,026.568.7836x8860,nchaney@gill-galloway.com,2021-03-11,https://williamson.com/
05-Oct-2020,Cash,00.00,"9,388.50","28,165.50",aEBCaFDe3EeC708,9528,Cassandra,Valencia,Henry PLC,Freyshire,Somalia,469.418.4886x6321,132-863-3547x230,bobcasey@walker.biz,2022-05-24,https://mcdaniel.com/
05-Oct-2020,Commission,04.10,00.00,"28,169.60",412aa2AAb0fAAE1,8532,Tammy,Rojas,"Jacobs, Carlson and Franklin",East Kristinaland,United States Virgin Islands,6048920567,615-421-1657,lawrence33@steele.com,2021-11-16,http://bolton.com/
05-Oct-2020,Bill,04.00,00.00,"28,173.60",daEFd10fa657afb,9682,Wayne,Hawkins,Stokes Group,Marissastad,Grenada,024.878.7226,223-212-3399x43123,jsantana@downs.com,2021-01-20,http://www.tyler-vaughan.com/
05-Oct-2020,Purchase,00.00,"2,817.36","25,356.24",de60e1cbB2C53F9,2932,Billy,Serrano,"Berger, Key and Mcmahon",New Ann,Argentina,455.816.7474x36293,+1-382-362-9444x024,friedmanjacob@sherman-dyer.com,2022-02-26,https://may-key.com/
05-Oct-2020,Purchase,200.30,00.00,"25,556.54",59bDE56C1053b64,7016,Jeff,Henson,"Glenn, Macias and Shannon",Keithfurt,Bangladesh,001-833-902-2467x49521,5912823530,uhamilton@sawyer-cardenas.com,2021-08-10,http://sutton.com/
05-Oct-2020,ATM,"8,677.20",00.00,"34,233.74",638cd6ffAA83Afc,1473,Ronald,Barrett,"Richard, Galvan and Ballard",Ritaland,Sao Tome and Principe,001-450-180-3290x8634,580.773.7190,tannerweber@proctor-adams.biz,2020-05-15,http://robertson.com/
05-Oct-2020,Tax,00.00,"3,803.75","30,429.99",bAf9eFe0efA5c5d,5323,Yvonne,Harrison,"Hughes, Galloway and Ramsey",North Julianside,Aruba,+1-152-162-9997x024,9773274023,ymolina@hays-villarreal.net,2021-01-01,https://giles.biz/
05-Oct-2020,ATM,00.00,"7,607.50","22,822.49",320e1803f758aD3,4901,Emily,Hardy,"Lam, Espinoza and Drake",Blackburnfurt,Wallis and Futuna,(812)333-0931x2011,001-353-678-6265,hailey38@murillo.org,2021-02-01,https://fowler-contreras.info/
05-Oct-2020,Purchase,"694,868.00",00.00,"717,690.49",5fcECFab34da3f8,5959,Jonathan,Powell,Moss-Golden,Odonnelltown,Norfolk Island,700.745.5553x96349,059.534.8112,wperry@deleon-morris.com,2020-07-04,https://www.white-herman.com/
05-Oct-2020,Reversal,"188,539.97",00.00,"906,230.46",65Eaafef5E243CB,9374,Jeremiah,Porter,Stephenson-Aguilar,Kylieport,Israel,001-634-872-5059,001-452-936-9811x9029,jareddavis@hays-boyle.com,2022-03-10,http://www.costa-leblanc.com/
05-Oct-2020,Debit Card,00.00,"453,115.23","453,115.23",fe51ef5bEcb9B3a,9553,Breanna,Moran,"Maddox, Cabrera and Donaldson",Oscarburgh,Honduras,073.104.4157,367.206.8377x7278,jilliandoyle@bridges-walker.biz,2021-08-18,https://www.salinas.com/
05-Oct-2020,Purchase,"220,244.70",00.00,"673,359.93",deCee1d8035D612,862,Gregg,Golden,"Stark, Pace and Fernandez",Coltonville,Liechtenstein,+1-898-361-3070x329,001-432-199-7893x4363,eugene22@lamb-thomas.com,2021-10-04,https://www.velazquez.info/
05-Oct-2020,Interest,"18,277.00",00.00,"691,636.93",a9F3D3EBEb7abCD,8581,Meghan,Chang,"Galvan, Ramos and Cowan",Hartburgh,Tunisia,(290)168-2422x2169,741-244-1244x3007,doris96@warren-peters.com,2022-05-08,http://baird.com/
05-Oct-2020,Cash,00.00,"230,545.64","461,091.29",1fb049c689A075b,7787,Hayden,Serrano,"Ingram, Hale and Taylor",East Malikchester,Pakistan,594-037-6063,363-962-9247,gerald39@hoffman.com,2020-05-10,https://www.whitehead.net/
05-Oct-2020,IMPS,"1,431,824.50",00.00,"1,892,915.79",101B6bA9dA323C2,4761,Curtis,Irwin,Bryan-Steele,Meadowschester,Chile,693-290-7971x90157,354-085-4862x2737,estradabrett@pena.com,2021-03-26,https://sloan-miranda.biz/
05-Oct-2020,Cash,00.00,"378,583.16","1,514,332.63",8C6dD4cdEf857A6,9937,Warren,Acevedo,"Williams, Madden and Harrison",Paigefurt,Comoros,(101)737-2884x4231,(084)193-9213,rsmith@donovan-jackson.com,2020-09-07,http://www.lam.net/
05-Oct-2020,Miscellaneous,00.00,"151,433.26","1,362,899.37",6df1fB89Dc83DF0,5369,Norma,Morgan,Marshall-Kaufman,South Eduardo,Antarctica (the territory South of 60 deg S),(571)454-3788x68448,001-852-281-1858x693,lwang@ford-lang.info,2021-06-24,http://www.velasquez-diaz.com/
05-Oct-2020,RTGS,00.00,"227,149.90","1,135,749.48",BFD257E7a62F43f,622,Bill,Dunlap,"Hoffman, Mccarty and Mcmillan",Peggyfort,Saint Barthelemy,098.661.3555x48646,+1-137-479-0704,nicholsjared@odonnell-weaver.com,2020-08-06,https://moses.net/
05-Oct-2020,Bill,01.70,00.00,"1,135,751.18",A132D26bD47E3A5,8352,Mikayla,Lloyd,"Ferguson, Brewer and Zhang",South Bobville,Nauru,326-867-6723x32009,001-195-689-3638x7162,margaretdeleon@mccann.com,2020-07-21,http://curtis.com/
06-Oct-2020,Interest,61.00,00.00,"1,135,812.18",C174C7bCEE4d7A2,6144,Kristie,Norris,Petty-Bowers,Bradleyport,Christmas Island,(425)998-5788x138,530.599.3034,margaret53@ross.com,2021-03-23,https://lang.com/
06-Oct-2020,Cash,00.00,"378,604.06","757,208.12",Ba5d97ccb36E6B6,6902,Denise,Sawyer,Lyons LLC,North Warrenshire,Belarus,001-565-991-9313x05394,1194644018,kerri33@gates.com,2020-10-17,https://zamora.com/
06-Oct-2020,RTGS,00.00,"252,402.71","504,805.41",ee5Da0fCA1BdDcb,1149,Natalie,Monroe,Hutchinson and Sons,East Carolynport,Heard Island and McDonald Islands,486.012.5303x67031,+1-888-383-0624x29775,gbuckley@chavez.com,2020-11-05,https://moon.com/
06-Oct-2020,Commission,04.00,00.00,"504,809.41",4b39D4fc9c1E7dc,7808,Candice,Anderson,Rogers-Lloyd,South Thomasbury,Slovenia,347.349.6732,001-055-149-7892x8733,ebartlett@rosario-mercado.com,2021-01-10,http://www.conway.com/
06-Oct-2020,Tax,00.00,"50,480.94","454,328.47",f2eE78D1A6DEe5e,1021,Rachael,Benitez,Hester Ltd,Lawsontown,Mauritania,(694)376-3296x032,+1-774-787-5087x50986,mwalls@salinas-robinson.com,2022-04-29,https://horton-rubio.com/
06-Oct-2020,Reversal,00.00,"56,791.06","397,537.41",B7acDDB21FA2fe8,3549,Clayton,Hansen,Rocha LLC,East Anthonyshire,Jordan,(291)954-6055,7106233478,keith80@daniel.org,2020-01-22,http://turner-curry.net/
06-Oct-2020,Bill,"31,852.00",00.00,"429,389.41",d3D2D30f3D1afa3,237,Louis,Carpenter,"Camacho, Wilkinson and Holden",Gregoryhaven,Wallis and Futuna,+1-548-779-6484,+1-651-481-8871,jacobskurt@dalton-small.com,2020-12-18,http://www.mathews.com/
06-Oct-2020,Bill,00.00,"53,673.68","375,715.73",bF67FEDfF32A0DC,1460,Lee,Bowen,Hill Ltd,New Patrick,Madagascar,444-193-5315,(133)049-4309x18470,mliu@hurst.com,2021-04-04,https://bean-mercado.org/
06-Oct-2020,Cheque,54.20,00.00,"375,769.93",E3a886752F9Ced1,7706,Jenna,Ward,Knapp-Lucero,North Terri,Somalia,001-375-246-9830x9031,001-339-037-0128x922,kyle23@brooks.com,2022-02-13,https://www.bowers.com/
06-Oct-2020,RTGS,"24,981.00",00.00,"400,750.93",cAa8f8C30204Cf9,4426,Loretta,Dixon,Bishop-Eaton,Jasminside,Mozambique,+1-606-368-1789x195,(650)331-8716,gabriel77@dennis-archer.net,2021-05-15,https://jacobs.com/
06-Oct-2020,Transfer,00.00,"57,250.13","343,500.80",FcAd6B4f081eACD,3468,Alisha,Kent,Woodard-Rollins,Davidtown,Micronesia,(944)139-5443x13287,840.928.7399x764,latasha16@goodman.com,2022-03-16,https://www.mendoza.org/
06-Oct-2020,ATM,00.00,"57,250.13","286,250.67",dDafEe6ABcCCEFB,7905,Mariah,Hughes,"Booth, Hunter and Rubio",Lake Melody,Turks and Caicos Islands,291-023-3739x1083,(630)482-0425,sherriyang@marshall-yates.net,2020-01-01,http://davies.com/
06-Oct-2020,IMPS,00.00,"57,250.13","229,000.54",Bf8d80EAC5E490E,4504,Howard,Dudley,"Garner, Randolph and Koch",Crawfordfurt,Dominican Republic,199-975-6348,989.757.2558x2526,schwartzkathryn@maldonado.net,2020-07-27,http://blevins-silva.com/
06-Oct-2020,Commission,"27,424.80",00.00,"256,425.34",EC69De7E4DFfEa5,9480,Dawn,Calhoun,Moran Inc,West Sophiamouth,Christmas Island,+1-256-075-8878x1517,(781)853-7595x5553,bfoster@mendoza.org,2022-04-03,https://www.mills.org/
06-Oct-2020,Purchase,00.00,"85,475.11","170,950.23",a6f01EcEcFf79d1,1784,Frederick,Vargas,"Blackburn, French and Zimmerman",Traciemouth,Mauritius,821-143-1835x110,+1-728-960-4095x68882,suarezcaleb@hoffman-craig.com,2021-03-07,https://herring.org/
06-Oct-2020,Commission,63.00,00.00,"171,013.23",ad14BEAF84Edec4,2767,Brady,Macdonald,"Rivas, Arias and Baldwin",Madelineland,Greenland,001-875-029-3130,(174)138-1903x11712,ambernewton@guerra.info,2022-04-07,http://newton.net/
06-Oct-2020,Bill,00.00,"57,004.41","114,008.82",788Dfe7C2dDAD52,8253,Emma,Sellers,"Sheppard, Andersen and Rogers",West Joshua,Macedonia,455-908-0323x5681,(293)463-5414x342,gina40@woodward.com,2020-05-07,http://www.moran-carey.biz/
06-Oct-2020,Transfer,00.00,"16,286.97","97,721.85",E8fBb3e4F89AFf9,7891,Monica,Small,"Bailey, Roth and Mcneil",Morrisfort,Kiribati,135-079-5003x9160,(878)470-5543,knelson@cortez.com,2020-06-04,https://www.bauer.org/
06-Oct-2020,Miscellaneous,00.00,"16,286.98","81,434.88",cB5994100151F5F,8815,Nancy,Hays,Vega-Guerra,North Jeffery,Mauritius,001-541-709-5989x85241,+1-890-604-8059x216,lanesharon@allison.biz,2020-02-21,http://www.smith-doyle.com/
06-Oct-2020,Transfer,"3,818.00",00.00,"85,252.88",CAcaAD99EF3c2D4,488,Tricia,Waller,Bradford-Bush,Rhondaborough,Uruguay,001-401-481-6270x0994,828.889.7561x52807,gilesjamie@hall.com,2020-09-01,http://www.vazquez.com/
06-Oct-2020,ATM,"1,760.90",00.00,"87,013.78",3DF3d5d6c6E52FC,1067,Dana,Gay,Saunders LLC,Cassandraport,Djibouti,677.679.6978,001-831-993-2159x492,rebekahmays@holden.com,2021-08-23,http://www.king.org/
06-Oct-2020,RTGS,967.59,00.00,"87,981.37",4Ba9BDFDa4dF0E0,3035,Curtis,Grant,Ray LLC,Carlychester,Saint Helena,(980)851-8464x43610,365-601-9077x902,hkaiser@frey.biz,2020-10-21,http://www.whitehead.com/
06-Oct-2020,Interest,00.00,"10,997.67","76,983.70",BCd18DB7E2Feb39,4874,Leon,Carrillo,"Schultz, Bonilla and Carrillo",Port Cassandra,Bulgaria,306-387-1772x52190,+1-074-575-7903x440,pvalentine@paul.com,2021-04-11,https://mack.com/
06-Oct-2020,IMPS,22.60,00.00,"77,006.30",6f33e0E021C7C72,2322,Yvette,Mejia,Barrett-Benton,Glennchester,Guinea-Bissau,001-876-047-1095x734,2174079341,cherrytami@everett-alexander.net,2020-12-30,https://gross.info/
06-Oct-2020,Bill,"25,392.96",00.00,"102,399.26",71a380918707ea4,8961,Jeff,Braun,"Mercer, Horne and Sawyer",Austinfort,Northern Mariana Islands,001-472-630-4548x20568,(571)419-2839,carlsonphyllis@petty.com,2020-07-27,https://hickman-rhodes.com/
06-Oct-2020,IMPS,00.00,"14,628.47","87,770.79",ABCFefFaDAc5F2C,1297,Judith,Abbott,Potter-Haney,Lake Evanberg,San Marino,(803)522-0695,8758726874,alyssajuarez@villanueva.com,2020-04-14,https://gates.com/
06-Oct-2020,IMPS,00.00,"9,752.31","78,018.48",16cd5B13dCadae8,4563,Andrea,Briggs,"Schultz, Stephens and Brooks",East Aimee,Bahrain,(337)206-4916x175,856.294.7959,tcarroll@keller-whitaker.com,2022-02-03,https://clay-austin.com/
06-Oct-2020,Commission,49.00,00.00,"78,067.48",77ECeDc4ECFE3e7,6055,Donald,Frank,"Hays, Shaw and Perkins",South Theresachester,Niue,085-270-5158x82630,001-752-467-4977x15704,xbarr@shelton.com,2021-12-27,http://www.mayer-wu.com/
06-Oct-2020,NEFT,"26,325.00",00.00,"104,392.48",F5683A50E4fdbF4,5554,Marissa,Hamilton,"Wolfe, Pratt and Knapp",Brittanymouth,Saint Pierre and Miquelon,9641430198,+1-095-178-4420x467,alan94@hanson.com,2020-01-26,https://juarez.com/
06-Oct-2020,Reversal,00.00,"20,878.50","83,513.98",a21Ce6067cD633E,360,Drew,Patterson,"Ruiz, Leon and Salinas",Diazmouth,Congo,+1-629-893-3866x5762,484-379-5918x42421,mbanks@dorsey-sanchez.biz,2020-01-25,https://www.hunter.net/
06-Oct-2020,Cheque,00.00,"41,756.99","41,756.99",9dBF4524Fb95bcA,5397,Debbie,Mata,Villanueva Group,Claytonport,Bahrain,(277)213-7616x89807,001-906-465-5387,luismahoney@dennis.com,2020-06-05,http://www.beck.com/
07-Oct-2020,RTGS,00.00,"5,965.28","35,791.71",DA5BD64f6aaE4C6,9530,Leroy,Russo,"Boone, Daniel and Carter",Stuarthaven,Bosnia and Herzegovina,+1-198-501-9622x2102,047.259.5628,eduardoday@velez.biz,2020-07-30,https://www.fletcher.net/
07-Oct-2020,Tax,00.00,"35,791.71",00.00,4D1eECDBad8dbaC,3357,Tammie,Burgess,Gregory Ltd,Sandraside,Greenland,318-273-3032,001-419-621-1529x4012,helen01@rosales.com,2021-08-25,https://www.pope.info/
07-Oct-2020,Debit Card,"3,655.90",00.00,"3,655.90",4E83f21eAF07A57,8113,Karina,Russo,"Clayton, Silva and Knapp",Lake Sarahmouth,Greece,001-899-461-4139x668,481.151.0109,gregduke@mckinney.com,2022-05-25,http://holloway.org/
07-Oct-2020,Interest,07.00,00.00,"3,662.90",DDaEB0Ade6E0EDf,2769,Tommy,Adkins,Olson-Thornton,Loriville,Iceland,1435993231,362-378-9427,lindsay57@kramer-chaney.info,2021-08-13,http://www.roach-calderon.net/
07-Oct-2020,Bill,"227,799.81",00.00,"231,462.71",8D86a9B2dFb2ed9,3116,Jillian,Stone,"Orozco, Greene and Parrish",Markport,Vanuatu,347-161-6182x239,(690)767-6994x623,huynhcarl@ayers.net,2020-11-19,http://cobb.com/
07-Oct-2020,Purchase,"2,921.60",00.00,"234,384.31",3E3bfED8c4CB7FA,1773,Ernest,Chandler,Hawkins Ltd,Lake Glenfort,Jamaica,(207)969-9678,635-838-4189x71067,darlenepayne@villanueva-stevens.com,2020-01-13,http://randolph.info/
07-Oct-2020,ATM,00.00,"234,384.31",00.00,1d5eE82086E98A7,3160,Gabrielle,Bridges,Rosales LLC,North Yesenia,Azerbaijan,765-096-4468x4093,+1-816-464-0818,andres09@ryan-payne.com,2020-06-25,http://www.bishop-huang.com/
07-Oct-2020,Cash,"1,925.80",00.00,"1,925.80",EAb90cc4a23D5d1,5021,Troy,Melendez,Norman-Malone,East Daisy,India,898-747-4280x64816,001-224-413-0553x6502,jasminpatel@callahan.com,2022-05-26,https://mosley.com/
07-Oct-2020,Interest,00.00,240.73,"1,685.08",ffAFa8e95099910,2690,Gregory,Mclean,"Mahoney, Buckley and Blanchard",Lake Cody,Gambia,518-744-1264x00276,385.242.6627x36292,sabrina74@steele.com,2020-12-29,https://www.short.com/
07-Oct-2020,Bill,"3,856.00",00.00,"5,541.08",0afAA5D950e833c,2605,Caroline,Rivas,Randolph Ltd,Richmondborough,Malawi,7763494220,+1-653-804-6493,phillip19@robbins.biz,2022-01-09,http://christian.com/
07-Oct-2020,Debit Card,00.00,791.58,"4,749.50",B7b0b1600B58aAd,8682,Erik,Rivas,Hunter Group,South Terrence,Palestinian Territory,3224725327,(855)555-2179,mindy49@hull-prince.net,2021-07-01,http://kline.com/
07-Oct-2020,Bill,"8,376.90",00.00,"13,126.40",eD9BaB908ba2a3b,5485,Daryl,Jacobson,"Sullivan, Rhodes and Walls",Andersonmouth,Anguilla,074-906-2040x7211,554-652-2500x36897,vanessa53@spears.org,2021-11-05,https://www.gay.com/
07-Oct-2020,Bill,00.00,"13,126.40",00.00,f721e7cAFE8b44f,3385,Dustin,Frank,Guzman Group,Farrellborough,Mongolia,001-409-070-8416x01279,(939)495-1309,legina@roman.info,2020-09-10,http://pittman.com/
07-Oct-2020,Tax,"1,145,740.25",00.00,"1,145,740.25",b7697aC75a0bF5b,1610,Natasha,Henry,"Andersen, Stafford and Foster",Port Allison,French Polynesia,999.945.4299x8273,802.799.7924x71384,preston71@bowen-lucas.info,2022-03-26,https://www.vaughn-douglas.info/
07-Oct-2020,Transfer,00.00,"114,574.03","1,031,166.22",DCAd2BD0CeBFc1d,2915,Louis,Klein,Mcintyre Inc,Kennethshire,Finland,(377)132-6353,+1-189-712-1697x991,lindseydale@mercer.com,2020-05-09,https://www.garrison.com/
07-Oct-2020,Cheque,00.00,"114,574.02","916,592.20",61b84BAE6c645AA,6132,Spencer,Holland,Martinez-Beck,West Roy,Iceland,225-498-1955,001-507-471-9784x951,nsimon@mccullough.org,2022-03-23,http://arroyo.com/
08-Oct-2020,Miscellaneous,00.00,"91,659.22","824,932.98",DB37af7BBDcEAd1,9346,Sara,Leon,Robbins PLC,New Shawnaville,Belgium,+1-101-400-1318,917-959-8496,lunderwood@acosta-ali.net,2020-10-17,https://barajas-richard.com/
08-Oct-2020,Purchase,00.00,"206,233.25","618,699.74",AeC147A9f936A31,6035,Ian,Richard,Christensen-Combs,Rowlandport,Guatemala,361-003-6410x806,657.765.2395x0409,xmathis@hughes.com,2020-11-26,http://www.holland.com/
08-Oct-2020,Bill,00.00,"154,674.94","464,024.80",Cdcd04c2398FFfe,148,Rose,Hunter,"Acosta, Mendez and Rivas",Boydburgh,Costa Rica,264-488-7271,+1-039-325-0627x1822,hebertdarin@kidd.com,2020-03-22,http://www.small.com/
08-Oct-2020,Miscellaneous,06.40,00.00,"464,031.20",CB4dFE7eec24D7F,4285,Daniel,Mann,Cunningham and Sons,Tonyahaven,Egypt,(920)339-3917x833,1204543866,rosehodge@middleton-garrison.com,2021-07-18,https://www.weeks-hood.com/
08-Oct-2020,Cheque,"5,236.00",00.00,"469,267.20",a7cfa569c8B6efa,2645,Jose,Arias,"Pearson, Holloway and Carson",New Dillonfort,Holy See (Vatican City State),+1-650-748-1812x11414,8118876665,russokylie@clarke.com,2021-09-29,https://gutierrez-ruiz.com/
08-Oct-2020,NEFT,"1,969,778.00",00.00,"2,439,045.20",6DdADca2C7744fD,224,Max,Gates,Solis-Olson,West Rubenburgh,Micronesia,001-401-710-2797x2407,4420602669,xrollins@mcfarland.com,2020-02-11,https://www.hood-decker.com/
08-Oct-2020,Transfer,"977,924.00",00.00,"3,416,969.20",e9EDD08FE5Aa19E,9526,Loretta,Whitaker,Stokes and Sons,West Ariana,Uruguay,001-297-933-6429x601,096.407.2268x90676,melody68@key-burns.com,2020-11-16,https://www.dillon.info/
08-Oct-2020,Bill,00.00,"379,663.24","3,037,305.96",5EbFF009b32311a,6362,Jake,Rhodes,"Daniel, George and Vargas",North Francis,Zambia,071-595-7224x328,(506)360-0270x1306,kgeorge@guerra.org,2020-08-22,https://www.cherry-yang.com/
08-Oct-2020,Debit Card,00.00,"379,663.25","2,657,642.72",62591BdCf896dE5,5909,Larry,Herring,Gibbs Inc,Malikland,United Kingdom,629-233-4454x25483,+1-229-524-4867,bryanmeredith@sawyer.org,2020-01-19,http://pope-baxter.biz/
08-Oct-2020,Interest,"1,465,813.25",00.00,"4,123,455.97",0FE8eA68A3E2D0f,2128,Patrick,Ray,"Chambers, Mcguire and Obrien",Schultzton,Norway,425-835-8660,580.657.0349x57101,wyatt03@keller.com,2020-02-29,http://hays.com/
08-Oct-2020,Commission,"30,867.70",00.00,"4,154,323.67",FE5B1180E5C8E3e,6918,Kathy,Stanley,Carney Inc,New Brianafurt,Germany,(068)581-4018,001-209-124-1213x483,jocelyn52@velez.info,2020-10-02,https://www.hammond-richmond.info/
08-Oct-2020,Reversal,"18,557.00",00.00,"4,172,880.67",83b0F8CfDB1E906,6714,Lauren,Rasmussen,Barajas-Gonzalez,North Allisonside,Italy,(142)379-4118x875,+1-203-895-8769,ldavidson@glass.net,2020-06-28,https://beck.info/
08-Oct-2020,Commission,"1,237.00",00.00,"4,174,117.67",2e15e6Ea65AAcC3,367,Robert,Perry,"Hancock, Simpson and Faulkner",Danielsstad,Liberia,563-746-1695,964.893.5912x1370,romandeborah@carter.com,2022-04-09,http://villarreal.com/
08-Oct-2020,NEFT,00.00,"521,764.71","3,652,352.96",d144aeCa5F769CE,1163,Gabrielle,Callahan,Cochran-Fitzpatrick,Kristiville,Mali,410-006-6377,945.287.8079x65777,lambrobin@bowers-marks.com,2022-01-31,https://www.buckley.info/
08-Oct-2020,Cheque,57.40,00.00,"3,652,410.36",e586A2D67bcdB48,12,Sara,Shaffer,"Dudley, Coleman and Green",Orrland,Gambia,4229986278,001-028-824-7381x56737,gabrielaleach@rose.net,2021-04-07,https://www.hoffman-rubio.com/
08-Oct-2020,Tax,00.00,"365,241.04","3,287,169.32",Cbeae0A00b69EBC,568,Kaylee,Dalton,Cantrell-Boone,West Lukestad,United States Virgin Islands,001-270-489-2972x78033,896-700-4276x46555,phelpskeith@wallace.com,2022-02-23,http://www.cervantes.org/
08-Oct-2020,Bill,52.00,00.00,"3,287,221.32",320e7Adefec5ECc,7772,Bridget,Sawyer,"Hines, Roth and Valentine",Jeffersonstad,Zambia,926.421.6895,+1-503-239-4545x57171,zoe92@olsen.info,2021-06-08,https://hartman.com/
08-Oct-2020,Commission,00.00,"821,805.33","2,465,415.99",cc9CAFA72Bcb2d3,9705,Tanya,Aguilar,Sims-Schneider,South Paigeport,Spain,0302282287,227.521.0215x2773,ebass@foster.net,2021-08-02,http://stewart-boyd.com/
08-Oct-2020,Cash,00.00,"616,354.00","1,849,061.99",D858C7bfCa1cCb5,8795,Dave,Juarez,"Whitney, Russell and Massey",Lake Alejandro,Paraguay,+1-018-954-1808x1042,001-524-154-7180x8776,richardsonglen@brown.info,2021-02-03,http://gross-donaldson.com/
08-Oct-2020,Tax,"234,609.10",00.00,"2,083,671.09",6c5A6FDAA3DBD45,1052,Tony,Sanchez,Ruiz-Douglas,Tamarastad,Bermuda,+1-509-074-6257,347-343-6399,shannoncummings@cisneros.com,2022-04-14,http://gentry.com/
08-Oct-2020,Bill,"27,284.35",00.00,"2,110,955.44",67Fb72519B6FC5c,4556,Glen,Stout,"Glass, Ho and Wallace",East Jill,Nepal,796-076-8677x57816,(694)405-7922,lutzfrank@harrison-kaiser.org,2020-04-29,https://www.little.biz/
09-Oct-2020,Reversal,"6,606.97",00.00,"2,117,562.41",aAC0dEdc22BBa83,2166,Max,Osborn,"Cole, Gibson and Duffy",Meyerbury,Brazil,862-825-9146x0710,(003)701-7242,vhammond@carrillo.com,2021-10-04,http://www.archer-cross.com/
09-Oct-2020,Purchase,00.00,"211,756.24","1,905,806.17",f354263bF5CBC5C,6171,Marilyn,Horn,Estes-Massey,Bryanchester,Montserrat,+1-129-943-6368x8608,001-575-734-4868,evelyn50@lee.info,2020-01-27,http://www.raymond.com/
09-Oct-2020,RTGS,00.00,"476,451.54","1,429,354.63",3f781baEB265b65,7793,Harold,Saunders,"Hudson, Barnett and Tyler",Terrellland,Vietnam,(176)310-0645,414-391-7569x44341,lucaspace@morton-kirby.biz,2020-09-18,https://www.keith-friedman.com/
09-Oct-2020,Reversal,00.00,"714,677.32","714,677.32",6C3b6B6D0AfCeCf,7867,Elijah,Fleming,"Spence, Mccormick and Jacobs",Lake Gabriellamouth,Somalia,682-867-3865,494-172-7750x711,tristansherman@wang.com,2020-07-11,https://clements-paul.info/
09-Oct-2020,Bill,"37,044.16",00.00,"751,721.48",B8ed2bEc1e0b0F8,3983,Jacqueline,Yates,"Hawkins, Cisneros and Brock",West Gwendolyn,Tonga,846-788-6825x991,579.202.8495,nichole59@cooley.com,2022-04-01,http://hensley.info/
09-Oct-2020,Debit Card,00.00,"751,721.48",00.00,88c69a92A78beCb,4632,Yolanda,Bush,"Massey, Horton and Herring",Francisberg,Australia,+1-800-459-1169x84111,+1-260-937-2135x471,anneward@henry.com,2020-11-13,http://www.hill.com/
09-Oct-2020,Debit Card,181.64,00.00,181.64,E7B6DfeCce3EFf4,742,Catherine,Willis,Pruitt-Howe,Tannerside,Tajikistan,009-638-0514,487.963.0835x425,herringmelvin@little.org,2022-04-03,https://ingram.com/
09-Oct-2020,Commission,"1,463.50",00.00,"1,645.14",FE1CD67ba32Adde,8497,Darryl,Ewing,"Simon, Barton and Russell",Dorischester,Cyprus,(675)366-6873x092,+1-349-231-2527x87182,nathaniel57@byrd.com,2021-11-02,https://brady.com/
09-Oct-2020,Purchase,00.00,274.19,"1,370.95",B0aab46eEFfCDC8,8873,Mckenzie,Salinas,Aguilar-Johnson,Berrychester,Japan,001-556-715-2581,001-120-667-0953x062,alexander17@casey.com,2022-03-11,https://mcguire.com/
09-Oct-2020,Reversal,00.00,228.49,"1,142.46",EADd0FbFbdf62aC,7137,Joe,Ortega,"Madden, Howard and Moody",Myersville,Paraguay,+1-772-660-0095x4623,2858070500,humphreyalbert@harrell.com,2021-03-30,http://www.frank.com/
09-Oct-2020,Cheque,00.00,571.23,571.23,19972eAE7aC45f5,4047,Ashlee,Levine,Randall-Phillips,North Aimeeport,Cocos (Keeling) Islands,023-649-2941,(161)473-7528x847,brownglenn@delgado-gill.biz,2021-12-28,https://www.salazar-cochran.com/
09-Oct-2020,Interest,00.00,571.23,00.00,8eb7148232CE4FE,5419,Phillip,Arroyo,"Gibson, Cantu and Fuentes",Anitahaven,Turkey,(741)619-2706x8521,6501417831,acostabreanna@cooley.com,2020-05-07,https://www.dodson-lynn.info/
09-Oct-2020,Debit Card,225.00,00.00,225.00,32034fDa1b49F43,4542,Patricia,Sweeney,Stout-Townsend,Lake Daltonview,Benin,028.910.3308x8733,209.828.8296,miguel40@leon.com,2020-05-11,https://www.riley-church.biz/
09-Oct-2020,ATM,00.00,56.25,168.75,d2e4F8EEEFD262C,2211,Jocelyn,Underwood,Ray and Sons,Courtneyside,Turkmenistan,930.939.6176,128.444.2364,pbishop@grant.com,2020-03-12,http://browning-parsons.com/
09-Oct-2020,Cheque,00.00,21.09,147.66,8ea7D0beCDdA164,4034,Robin,Moran,Hart Inc,West Pamela,Somalia,001-136-309-9206,(216)696-8450x52224,ibarralaura@le.com,2020-02-02,https://www.wise.org/
09-Oct-2020,Tax,00.00,18.46,129.20,0Feb0fef25bAEe1,1466,Dave,Medina,Palmer-Vincent,Hannahland,Timor-Leste,(394)981-2686,(553)689-3266x8728,jhorn@quinn-sosa.biz,2021-02-22,https://www.conrad.biz/
09-Oct-2020,Transfer,"155,745.30",00.00,"155,874.50",65a6EE10A077aD7,6267,Heidi,Young,"Rush, Summers and Morgan",Strongmouth,Iran,866.669.1155,733-682-0440,herringjasmine@price-hansen.com,2020-05-18,https://ellis.com/
09-Oct-2020,Commission,06.17,00.00,"155,880.67",7F46F6E259fbDde,7148,Eduardo,Foster,"Cortez, Stewart and Weeks",Sheppardburgh,Iraq,(578)156-5322x9588,001-175-172-7390x99057,sonia05@barker.info,2021-04-02,http://shields.com/
09-Oct-2020,Cheque,00.00,"19,485.08","136,395.59",Bca2d5CeeF19eaa,6103,Jessica,Giles,Donaldson PLC,Katieton,Latvia,145.495.3899x313,001-055-930-1041x3084,buckleyjames@gallagher-scott.biz,2021-06-29,https://www.scott.net/
09-Oct-2020,NEFT,61.00,00.00,"136,456.59",4CDD436E36C97De,213,Darlene,Vasquez,Elliott Ltd,Patrickfurt,Malaysia,1462753989,+1-671-928-3389x83763,mosleyross@lawrence.com,2021-01-28,http://www.weiss.com/
09-Oct-2020,Interest,23.18,00.00,"136,479.77",CE68F0Ca42f3b5E,3516,Bill,Chandler,Scott and Sons,Frazierfort,Netherlands,(558)242-5619,758-244-1510x174,haydencole@james-fox.com,2022-03-02,https://www.salas.org/
09-Oct-2020,Transfer,"36,056.90",00.00,"172,536.67",78a2De50Dd9D12a,4611,Teresa,Melendez,"Rosales, Vance and Ortega",Port Francis,Suriname,462-479-9532x52477,327-236-1500,xvincent@finley.net,2021-07-02,https://www.boyle.com/
09-Oct-2020,Bill,"7,037.00",00.00,"179,573.67",CB5f4d9842996A2,8729,Jackie,Valenzuela,Chandler Group,Mejiamouth,Ukraine,+1-138-385-9596,049-917-8735,kristaterrell@gilmore.com,2020-11-07,https://mcdaniel-mckinney.info/
09-Oct-2020,Miscellaneous,30.90,00.00,"179,604.57",aF2Fb959e8da5D3,3766,Duane,Jimenez,Castro Ltd,Mackside,Nicaragua,537-667-7234,001-798-363-1777,hcastaneda@walton-houston.com,2020-04-13,http://www.jennings.com/
09-Oct-2020,ATM,00.00,"179,604.57",00.00,4Ff0c4681DD1fC9,5641,Nichole,Lutz,Joseph Inc,West Jonathonland,South Africa,994-324-9290x8047,821.952.2659x8728,vaughancollin@lester-lucas.com,2020-07-29,https://knight.net/
09-Oct-2020,NEFT,"39,498.20",00.00,"39,498.20",9B7bCbA060807BF,2484,Dorothy,Weiss,Mcmillan-Newton,Claireberg,Belize,563.864.9939,(063)816-2424,malikoconnor@wiggins.com,2021-05-23,http://www.carlson-ayala.com/
09-Oct-2020,ATM,00.00,"4,388.69","35,109.51",f5E80Bd7e96b5D6,7696,Edwin,Wang,Mcknight LLC,Jodimouth,Gabon,379-077-6024x411,852-408-8261,dsheppard@mcintyre.info,2020-02-29,http://www.whitney.com/
09-Oct-2020,Interest,04.50,00.00,"35,114.01",Aac9EdEC3bA0861,4612,Dennis,Kent,Bonilla-Horn,New Christian,Czech Republic,+1-534-411-1244x814,080-116-4260x06671,summerwiggins@fuller.net,2020-09-27,https://hopkins.com/
09-Oct-2020,Transfer,00.00,"5,852.34","29,261.68",9Df04dcEec38175,368,Gerald,Morales,Mora Ltd,Robertoberg,Congo,666-844-5078x9437,171-663-3726,mckenzieroberta@leach.org,2020-02-26,https://stevenson.info/
09-Oct-2020,Transfer,00.00,"5,852.34","23,409.34",7aa0bBb2c8afBfc,1273,Robin,Bernard,Hayes-Conrad,New Bob,Macao,+1-179-164-4027,(566)245-3647,pbentley@jensen-marshall.org,2020-07-30,http://www.manning.com/
09-Oct-2020,Debit Card,00.11,00.00,"23,409.45",708B9DEE2aceebA,2045,Douglas,Mckinney,Landry Group,North Devinbury,South Africa,+1-454-409-5611,294-468-6594x01252,marilyn20@mack.com,2020-07-27,http://www.ortega.com/
09-Oct-2020,RTGS,"22,926.00",00.00,"46,335.45",57B6d3584aabffa,7457,Neil,Delgado,"Mathis, Bruce and Braun",Kaitlinfort,Martinique,512-630-2244x29031,(628)846-6260x7115,stacyduncan@boyer.com,2021-08-08,https://www.eaton-serrano.biz/
09-Oct-2020,NEFT,108.00,00.00,"46,443.45",aCe18Ff6E22E530,656,Eric,Hale,"Benjamin, Huang and Dillon",Kimmouth,Uruguay,395-186-0530,1334010143,kristigardner@knight.net,2021-08-01,https://hendrix.com/
09-Oct-2020,Purchase,00.00,"11,610.86","34,832.59",7f371E09D0d2df7,395,Vickie,Finley,Spears LLC,West Nancy,Guinea,001-721-934-4214x040,+1-951-944-0860,eavila@allen-gillespie.com,2021-10-06,http://www.luna-santana.biz/
09-Oct-2020,Purchase,"119,862.50",00.00,"154,695.09",dFCce1be917852C,4081,Cynthia,Phelps,Gamble-Eaton,South Kristin,Togo,206.621.4114x2887,015.960.9695x16853,alejandrabaldwin@boyle.com,2021-10-21,http://yoder.com/
09-Oct-2020,Interest,00.00,"17,188.34","137,506.75",3DB5b574A1794FC,4071,Lauren,Bullock,Rice-Cummings,Beasleyland,Isle of Man,+1-242-328-0312,2133406336,carlaobrien@serrano.com,2022-03-22,http://www.barnett.info/
10-Oct-2020,Commission,03.60,00.00,"137,510.35",0F6E13dc86e8e7A,9602,Curtis,Johnston,Mitchell-Montes,North Staciemouth,Brazil,+1-471-189-1356,701.172.2585x1906,knappmindy@johnston.org,2021-09-10,https://www.murray-roth.biz/
10-Oct-2020,Debit Card,44.00,00.00,"137,554.35",bDE2bCbf0c37c5a,9489,Tricia,Knapp,Miranda Ltd,Bradleyshire,Uzbekistan,579-705-5839x58286,(040)375-9814,xalvarez@carr.com,2021-06-07,http://www.beck-molina.biz/
10-Oct-2020,IMPS,"24,249.60",00.00,"161,803.95",43a2dBEBB0Fb8D4,8524,Mercedes,Murray,Todd and Sons,Lake Leonton,Canada,820-174-7865x2484,001-122-789-0058x2153,lidouglas@zuniga.info,2020-05-06,http://gibbs.com/
10-Oct-2020,Purchase,00.00,"53,934.65","107,869.30",bD044a72175bE0a,7919,Angie,Compton,"Trujillo, Rodgers and Cherry",West Isabellaville,Rwanda,652-020-8449x7850,474.605.7291,petercortez@kent-lynn.com,2021-11-22,http://www.barron-blanchard.com/
10-Oct-2020,Interest,00.00,"26,967.33","80,901.98",2Db0AaFa22F73Ff,5790,Connor,Hill,Vance-Schaefer,Lake Andrew,Monaco,001-558-197-3607,008.347.3877x20921,aimee09@davies-edwards.net,2020-05-21,https://pierce.org/
10-Oct-2020,Debit Card,89.00,00.00,"80,990.98",4cA2AFff4CB33eF,2354,Abigail,Allison,"Stark, Schmidt and Lucero",Alfredchester,Lithuania,430-523-3977x7451,001-390-111-7660,pedroknox@kent.com,2020-11-19,http://berg.com/
10-Oct-2020,NEFT,"24,703.00",00.00,"105,693.98",b07c2Dc76d5b32C,389,Clarence,Church,"Rasmussen, Wu and Hawkins",Abigailstad,Hong Kong,1946419219,(559)009-3592x74098,daniellebooth@underwood.info,2021-08-13,http://www.tucker-kelley.info/
10-Oct-2020,Transfer,00.00,"52,846.99","52,846.99",2c8F7FF1ECe7267,8816,Anthony,Morris,"Gutierrez, Gilmore and Bowen",Riversland,Korea,388.333.0006,(581)370-9157x113,ustokes@duncan-navarro.net,2020-02-24,https://reed-valencia.com/
10-Oct-2020,Debit Card,"30,943.20",00.00,"83,790.19",A64C2186EbBa7aD,2549,Kathy,Bolton,Russo PLC,Sherryburgh,Chad,9748700636,001-605-490-2745x6021,earl05@boyd.org,2020-07-13,https://www.stevens.com/
10-Oct-2020,Purchase,"68,237.12",00.00,"152,027.31",dce6Fc71a59aB3e,8686,Felicia,Cherry,Compton-Zavala,Lukeport,Papua New Guinea,064.440.8280x65879,847.716.4193x0590,christian86@pratt.net,2021-01-02,https://farmer-ryan.com/
10-Oct-2020,Transfer,00.00,"50,675.77","101,351.54",AE7d02ec579ace4,6572,Tara,Mueller,Byrd-Irwin,South Cassandrafort,Moldova,+1-964-192-9926x78222,(804)283-4680x89321,hurstsean@wade-preston.com,2020-02-28,http://www.murphy-sweeney.com/
10-Oct-2020,RTGS,00.00,"16,891.92","84,459.62",3BF8bFfAe2Ae5Bb,163,Ebony,Noble,Mccann-Barker,Makaylaberg,Christmas Island,(425)631-1876,+1-553-699-1216x151,lydiameyers@frederick.com,2020-06-24,http://www.escobar.com/
10-Oct-2020,NEFT,09.20,00.00,"84,468.82",c0A4a01C81dFb18,1542,Donald,Church,Byrd Ltd,Scottmouth,Congo,264.211.1322x47101,(033)003-6981,dbanks@nichols.biz,2020-07-17,https://haas-summers.biz/
10-Oct-2020,Tax,"29,558.81",00.00,"114,027.63",b447DbC633E65a0,7992,Denise,Browning,"Davies, Gould and Barker",North Cory,France,606.156.8226,563.816.2238x37092,rvalencia@jensen.info,2021-07-26,http://branch-hays.com/
10-Oct-2020,Transfer,"48,136.00",00.00,"162,163.63",Ff9ea1647acFb6B,4567,Jodi,Newton,Kaiser-Dorsey,Angelberg,United States Virgin Islands,832-114-1565x1026,001-951-329-3477,mackenziemcneil@stewart-manning.com,2020-01-23,https://randall.com/
10-Oct-2020,Purchase,"1,708,598.00",00.00,"1,870,761.63",061AB1b3530F3Fd,177,Brandon,Browning,Hayes Group,Meyerview,Libyan Arab Jamahiriya,001-366-571-1158x8709,001-830-240-2243,gabriellanorton@robertson.org,2021-04-17,http://www.pena.com/
11-Oct-2020,IMPS,00.00,"311,793.61","1,558,968.02",998370d4f5DdBfc,8902,Reginald,Pacheco,"Kent, Garrison and Briggs",Cruzville,Austria,3836063976,280.306.5592x4555,iwatts@rowland.com,2021-10-23,http://french.info/
11-Oct-2020,Purchase,00.00,"1,558,968.02",00.00,765165e477658Fe,4412,Summer,Kemp,Hensley Ltd,East Jillian,Romania,+1-674-987-7314x70770,908.734.4537x55259,rhondaholder@mccormick-carter.com,2021-08-02,https://bush.biz/
11-Oct-2020,IMPS,04.00,00.00,04.00,2ef7898c342EBe6,9316,Patty,Morrow,Hale PLC,New Dontown,Djibouti,000.618.2439x599,026.568.7836x8860,nchaney@gill-galloway.com,2021-03-11,https://williamson.com/
11-Oct-2020,Transfer,"25,705.76",00.00,"25,709.76",2B7daeDEDC7725D,2532,Tanya,Reid,Strickland-Farley,Phillipsburgh,Dominica,0939425032,(032)801-8834x0232,darryl51@smith.com,2020-04-19,http://www.contreras-jenkins.com/
11-Oct-2020,Commission,00.00,"5,141.95","20,567.81",Dd3e8A60Fd757Df,5146,Cesar,Gomez,"Pitts, Martinez and Barr",Cuevasville,Afghanistan,335-832-7844x91725,0606321132,gbenton@goodwin.com,2021-04-23,https://kelley.com/
11-Oct-2020,NEFT,07.34,00.00,"20,575.15",Fdf7CD9Cad5FEda,6897,Crystal,Alvarez,"Proctor, Kline and Villanueva",Wolfemouth,Western Sahara,685-554-9714x22821,656.738.2007x98533,latoya67@horne.org,2021-03-29,http://www.juarez-snyder.com/
11-Oct-2020,IMPS,00.00,"4,115.03","16,460.12",D9e3c6dCE0D1d4c,2744,Jeanne,Farrell,"Martin, Mcclure and Conley",East Ellen,Korea,622-847-6153x2911,345-137-0848x42951,kristine34@rivas-suarez.net,2020-07-15,https://boyer.com/
11-Oct-2020,Interest,"2,607.00",00.00,"19,067.12",7ca1dbE1BFCd7f7,7358,Amy,Arellano,Cervantes and Sons,West Shelly,Ireland,6299810481,001-729-285-7425,ralph21@braun.org,2021-08-20,https://anderson-anthony.org/
11-Oct-2020,Transfer,"122,485.40",00.00,"141,552.52",fbFCe3bEf074Ac1,5420,Robyn,Noble,Shields-Ball,Juliefurt,Oman,161-501-0848x12007,096-587-3193x699,brandon00@soto.com,2022-01-10,http://www.rice.org/
11-Oct-2020,Interest,00.00,"14,155.25","127,397.27",EDF84b2D3f452d7,1848,Lisa,Norton,"Beck, Sharp and Waller",Bentleyland,Maldives,681.119.3503x195,064.571.4165,jherring@gates.com,2021-04-13,https://www.butler.com/
11-Oct-2020,Commission,00.00,"12,739.73","114,657.54",86c1C754fE6F849,4558,Richard,Mccall,"Mckinney, Lee and George",West Hannahhaven,Paraguay,265.336.0050,(299)923-8467,villanuevajeanne@rivas.com,2021-07-01,https://bailey-lane.com/
11-Oct-2020,Transfer,00.00,"38,219.18","76,438.36",6D23D4aBD7a9d5C,4322,Leah,Flynn,Blankenship-Fox,Barbaraville,Monaco,908.086.0859,007.651.8932,nathanielhansen@massey.com,2020-01-05,https://huber.com/
11-Oct-2020,Bill,31.40,00.00,"76,469.76",7C88B7c5d1a4dEB,4856,Patty,Levine,Sims PLC,Nicholasburgh,Iraq,(981)728-9756x549,021.624.2276x9137,kendrarodgers@waller-farrell.com,2021-04-09,https://mills-nelson.biz/
11-Oct-2020,Transfer,00.00,"8,496.64","67,973.12",ebed34126980Cb7,7339,Frank,Bruce,Nolan-Gallegos,East Kiarahaven,Chile,622.949.5024,713-104-0496x891,johnathan64@bradshaw-nelson.com,2020-02-03,http://quinn-may.info/
11-Oct-2020,RTGS,31.00,00.00,"68,004.12",CAbF5AF5DDe559c,571,Karina,Benjamin,Rowland Group,North Loganport,Saint Kitts and Nevis,(362)802-4463x17611,264-909-9938x99397,marcussandoval@watts.info,2022-02-03,https://www.henson.com/
11-Oct-2020,Cheque,00.00,"11,334.02","56,670.10",ceEabAe50A0f63b,8401,Steven,Barrett,"Robles, Gentry and Barker",West Grant,Singapore,962-837-9447x102,001-310-449-6675x619,jenniferbanks@floyd-frank.com,2021-10-27,http://mclean.com/
11-Oct-2020,Transfer,05.07,00.00,"56,675.17",ac16Caa8cACCa6E,3392,Joanna,Alexander,Barker-Sweeney,Dillonfort,Monaco,803-793-7220x30772,843.972.8886,melissa67@bernard-whitney.org,2021-04-30,http://koch-goodwin.com/
12-Oct-2020,Miscellaneous,00.00,"11,335.03","45,340.14",c927E6840FF4A0c,310,Angie,Navarro,Howell Group,Dianeborough,Namibia,1861519660,725-519-2910x288,kirstennicholson@terrell.com,2021-10-15,http://www.gentry-barnett.net/
12-Oct-2020,Reversal,10.30,00.00,"45,350.44",b52146EeE2ffdf7,2431,Brittany,Nelson,Choi and Sons,Michaelton,Denmark,773.512.0983x90656,+1-490-384-9488x7362,rhawkins@griffin-hancock.net,2022-01-02,https://www.murphy.com/
12-Oct-2020,Tax,00.00,"9,070.09","36,280.35",c7a44B5D4c44A33,273,Audrey,Levine,Franco-Berg,West Gregory,Mozambique,001-939-299-4393,122.214.6853x762,kristinemunoz@neal-kline.com,2022-05-29,http://oliver.net/
12-Oct-2020,Transfer,04.52,00.00,"36,284.87",6E77AF6DEEd344F,4262,Franklin,Sharp,"Yang, Butler and Stevenson",North Tashaberg,Israel,001-041-648-1389x081,9140786850,lblake@vargas-bailey.com,2020-01-20,https://bailey.com/
12-Oct-2020,RTGS,47.00,00.00,"36,331.87",9A8e359AFb697CD,9900,Kristie,Crosby,Glover Group,Greenhaven,Myanmar,+1-971-169-6006x576,780.365.0598x607,calvinfrench@webb.com,2022-01-29,http://obrien.com/
12-Oct-2020,Purchase,00.00,"6,055.31","30,276.56",DfB1240Ee8Feb3E,5516,Douglas,Guerrero,Nguyen-Archer,Townsendmouth,Jersey,+1-996-645-6021x01612,001-183-946-5528x972,kyliejames@oneill-cooper.com,2022-03-07,https://valdez-brewer.org/
12-Oct-2020,IMPS,57.00,00.00,"30,333.56",C6CFa8FFA0E1aEf,4822,Lydia,Mathews,Young-Walton,Kerriland,Finland,378.642.4420x851,227-370-1671,claire32@rollins.org,2020-01-20,https://burgess.info/
12-Oct-2020,NEFT,00.00,"30,333.56",00.00,F1cef5EC17f48f8,3141,Sheryl,Melendez,Cannon-Carroll,Lake Suzanne,Nicaragua,074.508.5923x2435,896.482.8017x1093,burnettbrandon@church.biz,2021-02-10,https://mccann.com/
12-Oct-2020,IMPS,07.00,00.00,07.00,F7839cc423b91C1,5677,Ebony,Sharp,Flynn PLC,Lake Stevenfurt,China,279.595.3393x83136,545.129.1003x54924,vasquezsylvia@doyle-herman.com,2020-03-21,https://weaver.org/
12-Oct-2020,Purchase,"233,720.59",00.00,"233,727.59",93603f57EaC25A5,4024,Kerry,Buck,Wise-Sanchez,West Jennaland,Macedonia,(131)363-4286,(696)656-2149,theresa07@roth.biz,2022-02-10,http://brennan.com/
12-Oct-2020,IMPS,"15,055.80",00.00,"248,783.39",FC13a2d339DCCaa,1022,Sarah,Munoz,Manning Ltd,New Pattychester,Cyprus,376.573.7996,(036)469-3509x76326,wilsondeanna@fuller-murray.info,2020-04-19,http://mcgrath.com/
12-Oct-2020,Commission,"11,152.91",00.00,"259,936.30",Fb3Ec6A33af50D9,3384,Sue,Kidd,"Warren, Ward and Olsen",Johnsport,Tajikistan,287-075-5536,400.544.5039,robinewing@holt.biz,2020-09-06,http://hobbs.org/
12-Oct-2020,Cash,00.00,"37,133.76","222,802.54",eAadd1EaCFbDF2c,973,Shelly,Rice,Pearson Group,North Angiefurt,Malawi,293-102-1402x6775,000-124-3050x9928,carolynsilva@ford.org,2021-01-14,https://charles-moreno.info/
12-Oct-2020,Cheque,"31,725.37",00.00,"254,527.91",Ade79715d026bb6,6290,Autumn,Parrish,Little Inc,North Gloriatown,Indonesia,709.771.2453,001-373-917-8230x09810,larsonbrett@rose-gibbs.com,2020-02-12,https://mcconnell.com/
12-Oct-2020,Tax,00.00,"254,527.91",00.00,Ff76BFAEeBCE31f,7222,Jade,Esparza,Herring-Mahoney,North Gabriela,Mayotte,001-909-367-3286x1469,001-263-358-1751x730,castillobrianna@gallagher.com,2021-01-16,https://irwin.biz/
12-Oct-2020,NEFT,07.00,00.00,07.00,CF15AC9d290FB2c,6552,Lindsay,Bennett,Mills-Casey,Leviport,Namibia,001-331-082-6797,701-251-6391x7403,priscilla54@mclaughlin.com,2020-08-29,http://rollins.com/
12-Oct-2020,ATM,00.00,02.33,04.67,acfa6d36133e5de,9954,Miguel,Costa,Roy-Dennis,North Kristen,Nauru,684-421-6710,097-294-3891x715,malikdougherty@blankenship.com,2020-12-05,https://www.ritter-blevins.info/
13-Oct-2020,Miscellaneous,"8,030.00",00.00,"8,034.67",88af0Ff9CD0Cf6B,3402,Bethany,Becker,Aguilar-Boyle,West Sydneyton,New Zealand,(191)752-3373x104,454-454-1411,jalvarez@riddle.com,2020-08-20,http://www.morse-henry.net/
13-Oct-2020,Commission,00.00,"2,678.22","5,356.45",3dFcB1a64c96bfA,135,Shaun,Marsh,"Lester, Murphy and Garner",East Maureen,Svalbard & Jan Mayen Islands,+1-859-923-2981x21277,001-991-038-5566x12302,damonhowe@larsen.org,2021-07-15,https://newman.com/
13-Oct-2020,Reversal,05.62,00.00,"5,362.07",03E38E0CC224EeF,6114,Allen,Castaneda,Clarke and Sons,North Josephchester,Puerto Rico,001-380-562-1235x79891,(902)871-2810,shari32@bryant-noble.com,2020-12-06,http://ryan-rich.com/
13-Oct-2020,Tax,00.00,536.21,"4,825.86",8797a5b218Cc1E2,612,Eddie,Lester,"Barton, Ferrell and Cain",West Alisontown,Mongolia,270.539.8417x009,4122005137,kenneth15@simon.info,2020-07-11,https://www.singleton-hooper.com/
13-Oct-2020,Reversal,00.00,804.31,"4,021.55",390de3b1476207E,7001,Valerie,Blair,"Reeves, Hernandez and Goodwin",East Debra,Isle of Man,2387750009,395-955-1702,hinesanita@gonzalez-gill.com,2021-10-09,http://dudley-cunningham.com/
13-Oct-2020,ATM,391.98,00.00,"4,413.53",02898865ef261D8,2581,Gary,Watson,"Cameron, Peck and Hale",North Grantbury,Greece,334-059-0518x2057,749.882.3352,mariecochran@maddox-mcdowell.com,2021-08-21,https://www.crosby-hicks.com/
13-Oct-2020,Purchase,"25,757.10",00.00,"30,170.63",1332679d9CBD83D,1310,Glen,Stevenson,"Hodge, Long and Maddox",North Terriberg,Iraq,869.960.0800,758.792.0275,martha18@holland-robles.org,2020-11-28,http://www.owen.com/
13-Oct-2020,NEFT,00.00,"5,028.44","25,142.19",E9Bc41A88ED6D6b,5029,Terri,Fowler,"Bradley, Buckley and Frye",New Connie,Djibouti,(266)274-4481x818,050-135-3611,xholmes@davidson.biz,2021-10-11,http://www.jimenez-singleton.com/
13-Oct-2020,Cash,"2,237.00",00.00,"27,379.19",AD9d94CEDa9dec0,848,Larry,Arnold,"Monroe, Nichols and Johnston",Alicetown,Thailand,+1-592-927-2270,182.414.7176,gailmcclure@rich.biz,2020-09-11,https://www.mccall.biz/
13-Oct-2020,Reversal,00.00,"13,689.60","13,689.60",69ba3C77Ae9aEb7,7796,Yesenia,Stark,"Maxwell, Finley and Wiley",South Cesarbury,United States Minor Outlying Islands,001-359-261-3440x194,001-451-211-8398,chelsealyons@edwards.com,2022-04-19,https://www.hanson-burnett.com/
13-Oct-2020,Purchase,00.00,"1,711.20","11,978.40",64Afc702a6c5Fad,1046,Kara,Bennett,Swanson-Mahoney,East Mathew,Estonia,(379)747-9902x4324,+1-578-411-2031x91611,kaitlinpeters@pacheco.net,2022-01-30,https://www.carson.com/
13-Oct-2020,Tax,00.00,"2,395.68","9,582.72",a76bB5ee6d78ED2,1533,Paige,Adkins,Stone-Edwards,East Jodi,Turkey,149-338-5712x9712,908-026-3799x07923,lambkristie@bradshaw.biz,2020-04-13,https://www.dominguez-owen.com/
13-Oct-2020,Miscellaneous,00.00,"3,194.24","6,388.48",e43e19BF53DBeCa,5867,Kelli,Vang,Fitzpatrick-Nelson,Murraystad,Wallis and Futuna,088.986.3323x112,306-082-9814x424,oroach@watson-blackwell.com,2020-11-21,https://wilkins-kemp.com/
13-Oct-2020,Tax,00.00,"6,388.48",00.00,5109Ae18Baf4b9B,4896,Mitchell,Franklin,Calderon-Wilkinson,Santanatown,Lithuania,(962)336-0612,(702)285-9235x9147,smathews@hogan-moran.org,2022-05-20,http://leach.com/
13-Oct-2020,Reversal,"1,747.21",00.00,"1,747.21",9EA1d1bdfc2c9b1,4811,Rodney,Thomas,Patrick Ltd,Lake Carlyberg,Syrian Arab Republic,604-248-0184,150.766.6875x394,jaclyn07@pope-yates.com,2020-06-26,http://www.cantu-arroyo.biz/
13-Oct-2020,NEFT,08.00,00.00,"1,755.21",fCe7Ef600b7ab06,4189,Arthur,Hartman,Long PLC,Jacksonfurt,Lebanon,(896)579-6572x13914,684-604-1497x35637,dunnjohnny@pearson.com,2021-01-30,http://fitzgerald.info/
13-Oct-2020,Bill,"773,782.75",00.00,"775,537.96",DAF78aB8aCcb1B0,1626,Kari,Wilkinson,"Ingram, Allen and Foster",East Brandon,Ethiopia,005-623-9685x175,001-297-985-8261x661,farmerspencer@beltran.org,2022-05-25,http://gallagher-scott.com/
13-Oct-2020,Commission,"1,724,404.00",00.00,"2,499,941.96",DFEeE37Cebae15B,5278,Sylvia,Mcmillan,Duran LLC,Branchbury,Hungary,001-681-982-1756,666.364.4189,stewarteugene@gentry-horne.com,2020-05-20,https://www.quinn-frost.com/
13-Oct-2020,Cheque,"258,749.53",00.00,"2,758,691.49",72B914acAFeaa00,6542,Oscar,Bernard,"Vang, Schaefer and Wolf",Petersonstad,Nauru,851-016-1308x558,042-389-9530,xleon@ewing.com,2020-09-03,http://www.pineda-garrison.info/
13-Oct-2020,Interest,"30,106.00",00.00,"2,788,797.49",caAdAedAdd0eC1A,913,Kristina,Bass,Zavala-Leon,Yangside,French Guiana,001-885-323-1323,+1-996-003-4479x94926,kpotts@williams.com,2022-04-19,http://frazier-decker.biz/
13-Oct-2020,RTGS,00.00,"1,394,398.75","1,394,398.74",ff8af69AecCdFCB,4021,Kelli,Wilcox,"Taylor, Hanna and Valdez",Lynnstad,Guyana,615-445-5255,+1-692-624-2700x3041,edward96@greene.org,2022-01-02,http://friedman.com/
13-Oct-2020,Tax,"22,762.00",00.00,"1,417,160.74",E4EF78b094b64C9,4404,Kaitlyn,Pearson,Griffith LLC,Downsville,Cuba,001-603-694-1946x184,488.725.8484x22714,alexanderduran@woods.info,2020-02-02,http://www.arnold.com/
13-Oct-2020,IMPS,"27,520.20",00.00,"1,444,680.94",bF67FEDfF32A0DC,1460,Lee,Bowen,Hill Ltd,New Patrick,Madagascar,444-193-5315,(133)049-4309x18470,mliu@hurst.com,2021-04-04,https://bean-mercado.org/
13-Oct-2020,IMPS,00.00,"1,444,680.94",00.00,f97fBDfE34Dd016,5094,Zachary,Thompson,Dorsey LLC,Duartestad,Svalbard & Jan Mayen Islands,001-174-384-6004x2990,671-189-5673x94327,christie05@morton.com,2021-06-09,http://www.hancock.info/
13-Oct-2020,Cash,04.00,00.00,04.00,EA6c4e3adcEdca3,3216,Stephanie,Dennis,Reid and Sons,Port Ebonyfurt,Uruguay,012.352.7660x380,+1-131-800-4624x630,abigail55@meyers.com,2020-01-25,https://norman.com/
13-Oct-2020,Transfer,00.00,02.00,02.00,23a1CeD8A626af7,1578,Traci,Cooper,Mcneil-Rose,Karinahaven,Norway,587-562-4038,+1-131-774-0910x143,gloverjeffery@hart.com,2020-12-31,http://www.jordan.com/
13-Oct-2020,IMPS,"1,954,002.00",00.00,"1,954,004.00",Bd7EdABBb34a06B,9668,Mackenzie,Key,"Evans, Kent and Zamora",Haaston,Montenegro,(070)416-5168x8081,(407)030-6065,catherine40@wolf.com,2021-08-12,https://mckenzie.com/
13-Oct-2020,Bill,00.00,"279,143.43","1,674,860.57",EA19cD8a6A1Efd8,4801,Tami,Clements,Fisher-Vance,West Dianetown,Isle of Man,782-226-0374x7383,195.980.1494,carolynbutler@vega-campos.com,2020-03-24,https://www.hardin-patrick.com/
13-Oct-2020,Cheque,00.00,"186,095.62","1,488,764.95",00C0F5A8e720666,4468,Daniel,Gillespie,Fleming Ltd,Lake Bryce,Liberia,772.847.0160,1952542105,ericaguirre@buck-kelly.info,2020-06-01,https://mcdowell-moreno.com/
13-Oct-2020,Cash,00.00,"372,191.24","1,116,573.71",Bb5459D7cEfcB51,8586,Ashlee,Krause,"Brandt, Graves and Thomas",West Erik,Uzbekistan,670.600.6098,671-634-4885,schultzjade@joseph.com,2021-06-29,http://patton-lloyd.org/
13-Oct-2020,IMPS,18.40,00.00,"1,116,592.11",B8e3201eADEA40d,4356,Tanner,Vang,Patterson Group,Thomastown,Bulgaria,001-431-103-3813,+1-500-826-4721x625,alishadickson@shaw.com,2022-02-10,https://www.meadows-santos.com/
13-Oct-2020,Reversal,06.00,00.00,"1,116,598.11",4B0aAad6e0fCfB6,6232,Nancy,Dunlap,Burnett PLC,Lake Virginiafort,Bahrain,001-052-330-1635x856,+1-329-284-9401x9550,sueschwartz@french-beasley.com,2022-04-06,http://www.coleman-weeks.net/
13-Oct-2020,Transfer,00.00,"558,299.06","558,299.06",FbBDaFb4B4E71Ac,2315,Connor,Ford,Whitehead Group,West Katelynview,Faroe Islands,+1-849-973-3305,+1-351-397-5170x576,jackson51@edwards-hale.com,2020-05-23,http://mendez.com/
13-Oct-2020,Transfer,01.04,00.00,"558,300.10",0c1cbAC211DA8CA,9121,Nancy,Cline,Joyce-Sheppard,Ashleyton,United States Minor Outlying Islands,791-865-2383x90000,001-613-701-4329,paulacortez@case.com,2021-08-25,http://andersen.com/
14-Oct-2020,Debit Card,04.00,00.00,"558,304.10",BeB4EE902dcE991,1107,Neil,Farrell,Chavez-Jacobson,Odonnellburgh,Chile,820-139-0112x72258,(914)172-7778x23316,dicksonderek@bowen.com,2022-02-17,https://www.holden-wallace.net/
14-Oct-2020,Cash,00.00,"55,830.41","502,473.69",d70a2EC8dF04bD1,6244,Brittany,Avila,"Mitchell, Ho and Johnson",Lake Gabrielfurt,Turks and Caicos Islands,952.931.9767,(991)908-1467,hbaxter@montes.com,2021-07-19,http://warner-good.com/
14-Oct-2020,RTGS,00.00,"50,247.37","452,226.32",AADB6e12E29F6FA,6502,Mark,Watkins,Moses Group,Brittanyton,Cocos (Keeling) Islands,408.654.9599x351,001-631-105-9299x931,annettedonaldson@rojas.com,2020-03-03,https://mann.com/
14-Oct-2020,Cheque,00.00,"56,528.29","395,698.03",4DaAFFadFeEe2cd,829,Jacqueline,Beltran,Morales-Kidd,Port Anneborough,Burundi,825.269.7428x56605,+1-828-852-6150x451,ustafford@rush-barr.com,2020-11-23,http://www.page.com/
14-Oct-2020,IMPS,"73,819.00",00.00,"469,517.03",1e43bbC6DBdC4Bc,9172,Mindy,Horn,Cross Ltd,Gibsonhaven,Belgium,298-313-0078x414,9042265912,cchase@rangel-donaldson.info,2022-04-15,https://www.wade-ortiz.biz/
14-Oct-2020,Cash,00.00,"46,951.70","422,565.33",c8f62fFE2A0baFE,8067,Alexandria,Hunter,"Norris, Gardner and Schultz",Lake Sandy,Guam,+1-407-227-3453x4521,(000)724-0925x169,michaela49@higgins-sampson.info,2020-08-10,http://www.joyce-gibson.com/
14-Oct-2020,Tax,00.00,"84,513.07","338,052.26",EefFa0D5AC7BBfb,6083,Janice,Whitaker,"Watkins, Williams and Faulkner",Dylanfort,Tajikistan,(380)959-5283x56382,531.241.6421x259,karl16@cain.net,2022-03-26,https://www.lowery.biz/
14-Oct-2020,Miscellaneous,01.76,00.00,"338,054.02",b1773104b5F3Cd7,4406,Tony,Thompson,"Johns, Willis and Fischer",New Cheryl,Portugal,417.497.6699,197-295-2931x1876,wayne87@owens.com,2022-05-02,http://higgins.com/
14-Oct-2020,Commission,00.00,"37,561.56","300,492.46",b9abafDDe117A5a,8683,Suzanne,Charles,"Tucker, Shea and Maynard",Riggsside,Botswana,+1-658-487-7096,525-607-2447,shericarey@cox.com,2021-11-13,https://www.cordova.info/
14-Oct-2020,ATM,41.00,00.00,"300,533.46",5aFc7BFbe176B2e,4336,David,Benson,Brock-Yates,Littletown,Sierra Leone,229-353-1835,+1-651-408-4328x18499,nicole73@dickerson-krause.com,2021-08-22,https://henderson.org/
14-Oct-2020,Tax,00.00,"75,133.37","225,400.10",FdBDDDF1f430Ff9,479,Kristina,Daniel,Osborn-Meadows,Terrymouth,Hungary,(991)260-9905,899-781-3477x9722,larajody@donovan.net,2021-01-19,http://www.reynolds.com/
14-Oct-2020,ATM,"257,266.00",00.00,"482,666.10",eC4B194dEbfA1cF,1763,Wyatt,Jennings,Stone-Wallace,Sheashire,Malaysia,4835747678,8557569201,tammynewman@vazquez-diaz.com,2020-11-14,http://www.whitney.com/
14-Oct-2020,NEFT,00.00,"80,444.35","402,221.75",4cdE1c880EF03Cd,6962,Angela,Thompson,Levine PLC,Lake Peter,Equatorial Guinea,(979)524-6033x295,729.847.7763x452,zoe67@arellano-stokes.com,2021-04-24,http://webb.info/
14-Oct-2020,Reversal,"3,079.00",00.00,"405,300.75",f2e43aD5BdDE7eB,5248,Arthur,Randolph,Love-Mosley,East Franciscofurt,Belgium,9424762176,556-114-6183,carolyn38@jimenez.com,2020-03-16,http://www.chen.com/
14-Oct-2020,ATM,58.00,00.00,"405,358.75",C9dBA2f2e264d80,6741,Angie,Huber,"Boyer, Bennett and Kirby",Autumnshire,Bosnia and Herzegovina,960-570-1312x12031,5399319942,gspears@frederick.com,2021-01-04,http://franco.org/
14-Oct-2020,Commission,07.94,00.00,"405,366.69",b6e2F443afC49Ab,4524,Colin,Waller,Knox-Combs,Andradeberg,Japan,(055)895-3881x8661,752.882.4710x352,hensleyabigail@pruitt-callahan.biz,2020-06-20,http://www.petersen.com/
14-Oct-2020,Interest,00.00,"101,341.67","304,025.02",C05fd16Bf9Ca3E3,2386,Candice,Kirby,Lambert-Stewart,East Michael,United States Virgin Islands,001-154-850-1653x858,(247)367-3578x8819,turnerlucas@yang-cameron.net,2021-12-09,http://www.rojas.com/
14-Oct-2020,Purchase,00.00,"60,805.00","243,220.02",4d2962A9fc85294,4372,Ryan,Murillo,Gay LLC,Port Tim,Paraguay,(975)873-8240,001-747-715-0276,spencejoshua@short-kelley.info,2022-02-16,https://spence.info/
14-Oct-2020,Miscellaneous,00.00,"48,644.00","194,576.02",BCCcB54d5d55d5A,6154,Catherine,Peterson,Mclean Inc,Morganton,French Southern Territories,(003)725-4694x90894,2762736317,lucaslonnie@kim.com,2022-05-17,http://www.fischer.com/
14-Oct-2020,Tax,00.00,"38,915.20","155,660.82",B6bF2E1D05CADE7,268,Rebekah,Weiss,Gallagher PLC,Lyonsshire,Oman,925.881.7050,(040)995-5358x7014,stoutwilliam@forbes.com,2020-03-12,http://lutz.org/
14-Oct-2020,Debit Card,00.00,"51,886.94","103,773.88",ECaf5CD6fAe10c9,8475,Anita,Flowers,Pollard-Charles,West Jamie,Egypt,999-815-5834x6421,+1-938-285-0457x792,alan18@scott-villanueva.com,2020-08-21,https://monroe.com/
14-Oct-2020,NEFT,00.00,"20,754.78","83,019.10",b080f9aa3ABdBFE,5340,Alexandra,Vazquez,Stephenson and Sons,North Kelli,Hungary,2451623774,(114)099-9944,katrinalamb@mendoza.info,2021-02-28,http://sims.net/
14-Oct-2020,IMPS,07.00,00.00,"83,026.10",56aef1a60a6dABc,2196,Chase,Martin,Conley Group,Joyland,Libyan Arab Jamahiriya,001-584-206-9175x38198,601-439-0740x02690,aimee25@franklin-bentley.biz,2021-08-18,https://mahoney-lyons.biz/
14-Oct-2020,Debit Card,00.00,"20,756.53","62,269.58",aF8D41f3c6D63B9,3482,Kristopher,Butler,Cervantes Group,Soniaside,Georgia,869.376.3007,009.925.7153,imorrison@krause.com,2021-02-26,http://hendrix.com/
15-Oct-2020,Bill,00.00,"8,895.65","53,373.93",a1A9C12Cf0e91f7,9395,Justin,Beltran,Vaughan-Gallegos,Hollyburgh,Solomon Islands,+1-031-244-7953x7409,(521)701-0794x3650,dale43@jacobs.net,2020-03-19,https://www.sandoval.net/
15-Oct-2020,ATM,00.00,"6,671.74","46,702.19",580a5AA0D534e6e,1611,Justin,Mcpherson,"Donaldson, Dougherty and Holloway",West Mathew,Afghanistan,+1-982-274-5504x12756,001-173-087-7818x48484,doriswilkins@ramirez.org,2022-04-19,http://leon-flores.com/
15-Oct-2020,Commission,31.32,00.00,"46,733.51",31F497BFEdea708,2550,Caroline,Marshall,Pruitt Group,Nathanborough,Afghanistan,272-843-8202,9161091588,tuckerjohn@haley.com,2021-10-18,http://www.conley-hawkins.info/
15-Oct-2020,RTGS,"20,480.96",00.00,"67,214.47",01f7Cb51B4aa8bE,7331,Shawna,Winters,Matthews Group,Barkershire,Australia,001-870-372-3317,645.438.8705x8457,fskinner@boyer.info,2021-12-17,https://www.kidd.com/
15-Oct-2020,ATM,00.00,"13,442.89","53,771.58",8e49493Ebfc4C39,9181,Guy,Warner,"Cantu, Webster and Berger",Erinborough,Philippines,334.323.0900x9139,601-830-4315x054,fvalencia@nixon.biz,2020-09-27,http://www.reynolds.com/
15-Oct-2020,Debit Card,00.00,"26,885.79","26,885.79",2E1CdA2BBF80Adb,9782,Lance,Mccullough,"Gross, Burns and Turner",Port Elizabethport,United Kingdom,510.621.0207,001-584-683-8509x7796,savagejoann@gay-costa.com,2020-11-02,https://www.mayo.com/
15-Oct-2020,IMPS,00.00,"2,688.58","24,197.21",9D72eEDa3a7dAe8,2899,Connor,Brock,Day-Fletcher,Clementsburgh,Cote d'Ivoire,5455227769,374.061.3565x85395,sergio51@rosario.biz,2020-05-28,http://www.sherman.com/
15-Oct-2020,RTGS,00.00,"8,065.74","16,131.47",ee6A9dd49c6B7B9,5382,George,Gonzalez,Stark-Spencer,Whitakerstad,Tunisia,+1-960-964-2072x602,(432)462-1189,judypollard@nielsen.com,2020-12-08,https://www.carrillo.org/
15-Oct-2020,Cash,00.00,"2,304.50","13,826.97",aB61e30bBB4Ae9c,4675,Christian,Sutton,Savage-Waters,Campbellfort,Somalia,+1-657-786-9541x4533,+1-582-545-1632x1070,bridgetkline@galvan-crawford.com,2020-03-20,https://gomez.com/
15-Oct-2020,Cheque,"207,798.00",00.00,"221,624.97",d0C6c7A3081aa4d,7012,Rebecca,Mayer,Oconnor LLC,Chelseyland,Bosnia and Herzegovina,001-508-405-2380x611,702-432-8792x17217,vangronald@chang.org,2021-11-24,http://www.moss.com/
15-Oct-2020,Transfer,00.00,"73,874.99","147,749.98",9F02A428C922af8,3027,Roberto,Gregory,Mcconnell-Wang,New Toddland,Zambia,+1-845-707-3456x5968,894.653.5052,cheryl07@aguirre.com,2021-02-12,https://www.powers.biz/
15-Oct-2020,Reversal,"53,066.44",00.00,"200,816.42",e3CA7aED67FBB0E,4970,Kathy,Rhodes,Spears-Rivas,Port Amanda,Jersey,724.509.7219x5759,001-518-408-1780x4999,caleb96@proctor.com,2020-09-28,http://www.stevens.com/
15-Oct-2020,ATM,00.00,"25,102.05","175,714.37",73A70Eecf3dF991,6874,Kaitlin,Parsons,Beck-Watkins,Caitlynland,Guadeloupe,781.606.8803,+1-685-373-4001x53293,doughertysally@randall.org,2021-08-13,https://reed.biz/
15-Oct-2020,Reversal,00.00,"17,571.44","158,142.93",a099Ffe1bc2ADda,6789,Tracy,Brock,Rubio-Beck,Lake Noah,South Georgia and the South Sandwich Islands,(036)692-3356x75342,001-835-451-8694x975,rebeccasutton@olsen.com,2020-02-24,http://montoya-gillespie.biz/
15-Oct-2020,RTGS,00.00,"31,628.59","126,514.34",8797a5b218Cc1E2,612,Eddie,Lester,"Barton, Ferrell and Cain",West Alisontown,Mongolia,270.539.8417x009,4122005137,kenneth15@simon.info,2020-07-11,https://www.singleton-hooper.com/
15-Oct-2020,Reversal,822.00,00.00,"127,336.34",aF1201cC7223a97,9162,Victoria,Sosa,Marsh-Case,Gomezton,Liberia,+1-541-366-9210x740,001-525-679-3084x56830,gregoryharmon@christensen.biz,2020-02-11,http://www.charles.info/
15-Oct-2020,NEFT,00.00,"25,467.27","101,869.07",3FBeABF4e0DF6B3,1228,Anita,Dickerson,"Hensley, Tanner and Mcneil",Carlsonchester,Russian Federation,+1-632-068-2455x9686,001-297-426-0190x0529,glennwarren@stone.com,2020-02-01,https://www.rasmussen.com/
15-Oct-2020,RTGS,00.00,"25,467.27","76,401.80",7Fd0edb39Ac22a3,9503,Julia,Leach,Singleton-Moses,Raymondstad,Equatorial Guinea,579.978.7691,(089)805-2886x09461,spencergeorge@pham-lynn.com,2020-09-03,http://patrick.com/
15-Oct-2020,RTGS,"193,986.47",00.00,"270,388.27",7AaD01F2EF77C4a,9210,Bryce,Arnold,Michael Group,Thomaston,Iraq,(432)977-9198x0731,(564)071-6631x21671,perezangela@reynolds-wells.com,2021-06-10,https://www.fischer-summers.com/
15-Oct-2020,RTGS,00.00,"135,194.14","135,194.14",Ca83aa93393309B,3470,Brandy,Weeks,Chen-Atkins,New Darylville,Oman,+1-398-016-8211,156.667.7689x9032,brookechapman@roberson.com,2021-09-11,http://grimes-frederick.com/
15-Oct-2020,Reversal,00.00,"15,021.57","120,172.57",34BBCFD8A10AC3f,5526,Vanessa,Tran,Pitts and Sons,Aimeechester,Mauritius,179-469-2275x4570,664-616-4980x549,astein@mckinney.com,2020-06-28,https://ingram-morrison.com/
15-Oct-2020,RTGS,"97,986.40",00.00,"218,158.97",E6E45eBf1c0CdE3,5749,Jenna,Garrett,Guerrero-Combs,Estradaside,Niger,877.392.9112,+1-105-248-0807,rodgerspeter@arias-graham.com,2020-02-14,http://www.french.com/
15-Oct-2020,Cash,00.00,"109,079.49","109,079.48",1Ba4e2F45c2AeE9,9245,Trevor,Anderson,Luna LLC,New Eduardotown,Thailand,790.986.0064,151-233-4390x5188,wyatt09@bender.com,2021-08-11,https://www.benton.com/
15-Oct-2020,Cash,00.00,"13,634.94","95,444.54",7fddda3cf7AeDFC,5560,Kristina,Fernandez,Mcpherson Group,East Rossmouth,Pitcairn Islands,257.714.7910x724,390.740.9042,maynardroberta@wagner-conley.org,2020-09-20,http://lee.com/
15-Oct-2020,Tax,"119,396.00",00.00,"214,840.54",37428BCFFCFbaB4,5181,Mario,Mccullough,Sheppard Inc,Hodgesshire,Montenegro,(264)042-9403x492,(099)889-9887x0620,reneewiggins@holt.info,2021-04-15,http://friedman-santiago.com/
15-Oct-2020,Commission,00.00,"71,613.51","143,227.03",4f3Dff09a16e3Bd,5709,Joan,Donovan,Wu-Ayala,Lake Jaredchester,Denmark,049.776.1594x838,001-696-811-3950x83728,schwartzlisa@grimes-lamb.net,2021-05-25,http://bennett-hurley.com/
15-Oct-2020,Tax,00.00,"143,227.03",00.00,Fdf7CD9Cad5FEda,6897,Crystal,Alvarez,"Proctor, Kline and Villanueva",Wolfemouth,Western Sahara,685-554-9714x22821,656.738.2007x98533,latoya67@horne.org,2021-03-29,http://www.juarez-snyder.com/
15-Oct-2020,Cheque,"3,157.00",00.00,"3,157.00",7AbE9bAa874ee5B,5873,Devon,Marshall,Bauer LLC,North Sabrinaborough,Saint Pierre and Miquelon,5060584609,592-233-0432x58332,ubowman@mullins.com,2022-01-27,http://mendez-hart.com/
15-Oct-2020,NEFT,"228,584.00",00.00,"231,741.00",7dAE66D8A754Ab7,6398,Mitchell,Stout,Martinez and Sons,Phelpsshire,Falkland Islands (Malvinas),(321)544-1130x529,001-492-879-6613x3719,wcannon@cameron.com,2022-04-25,https://www.larson.org/
15-Oct-2020,Transfer,00.00,"25,749.00","205,992.00",21966cA0E820bdb,5957,Devin,Newton,"Hess, Robertson and Brown",North Franciscoberg,Holy See (Vatican City State),355-328-2884,(813)083-8518,jill90@murphy.com,2021-03-11,https://coffey.com/
15-Oct-2020,Debit Card,00.00,"25,749.00","180,243.00",3C8DfAE7c9EDAfd,8558,Hannah,Ayers,Joseph-Sloan,Georgefort,Cape Verde,1421530585,+1-654-685-1631x32409,estrickland@foster.com,2020-12-29,http://www.howell.com/
15-Oct-2020,RTGS,00.00,"22,530.38","157,712.62",F5Ffd5A23f12d68,1280,Jose,Mahoney,Logan PLC,Alvaradostad,Ukraine,(955)614-8163x64020,001-779-602-9437x100,gmcgrath@melendez.info,2020-06-13,https://stout-cantu.com/
15-Oct-2020,Cash,02.41,00.00,"157,715.03",1ffA5730246Ed10,9807,Daryl,Greer,Roy-Mccormick,Monicamouth,Marshall Islands,+1-671-445-2728,063-949-5302x9400,mcdanielgrant@sandoval.com,2020-06-23,http://conrad.info/
15-Oct-2020,Commission,"2,768.50",00.00,"160,483.53",9a385DA6544f1ee,2937,Vernon,Shelton,Myers Inc,Raymondchester,Solomon Islands,263.171.5867,709.357.4386x141,wsteele@kaufman.net,2022-02-03,http://www.cross.com/
15-Oct-2020,Miscellaneous,371.80,00.00,"160,855.33",03E38E0CC224EeF,6114,Allen,Castaneda,Clarke and Sons,North Josephchester,Puerto Rico,001-380-562-1235x79891,(902)871-2810,shari32@bryant-noble.com,2020-12-06,http://ryan-rich.com/
15-Oct-2020,Tax,00.00,"32,171.07","128,684.26",C59D0C66209d40d,2082,Marilyn,Carrillo,Henry Inc,West Aaron,Jamaica,+1-752-470-5610x1241,(508)753-1617,wallsmargaret@day-woodard.com,2020-07-30,http://www.jordan.com/
15-Oct-2020,Interest,09.00,00.00,"128,693.26",53D27CbE3b3CAf7,41,Darren,Santana,Guerra LLC,Meyerbury,French Southern Territories,+1-145-916-2809x14415,440.474.1607,biancahenry@hernandez.org,2021-06-11,http://www.gates.net/
15-Oct-2020,Commission,612.00,00.00,"129,305.26",5f4f221a9055EAC,5070,Luis,Pitts,Rasmussen PLC,Lake Charlotte,Jamaica,+1-911-026-4019x617,390.191.7852,susanpotts@bridges-howell.com,2021-12-02,https://ochoa.com/
15-Oct-2020,Tax,00.00,"32,326.32","96,978.94",dB3Ae0E82ceedC9,3154,Shaun,Stafford,"Wilkinson, Miller and Bernard",New John,Mayotte,226.182.9605x516,875-381-9167x88166,estradabreanna@french.com,2021-06-22,http://church.com/
15-Oct-2020,Reversal,"711,632.50",00.00,"808,611.44",89adEe03fBdCe2b,5039,Kelly,Romero,Vega-Hayes,North Shannonside,Zimbabwe,+1-872-424-0701,001-491-901-1829x0683,snyderblake@jackson.biz,2021-10-16,https://farmer-lowe.com/
15-Oct-2020,NEFT,00.00,"89,845.72","718,765.72",1da22c6e8C496C2,3783,Doris,Gallegos,Dawson-Stark,Hartmanview,Lebanon,795.909.0725,960-969-3254x25272,zromero@myers.net,2021-04-05,http://jacobson.com/
15-Oct-2020,Purchase,00.00,"359,382.86","359,382.86",e5169aAa0A2cE5e,2470,Vernon,Wong,"Kane, Sawyer and Frye",New Lynn,Holy See (Vatican City State),7021188400,+1-932-776-6495x590,antonio35@joseph-hansen.com,2021-10-26,https://daniels-mccarthy.info/
15-Oct-2020,Cheque,03.00,00.00,"359,385.86",CBdD876cE0A1Feb,3851,Clinton,Castro,Atkinson-Bright,Hardingmouth,Andorra,782-177-0876,010-453-1373x9116,zbush@henson-blake.info,2021-04-22,https://davies-holder.com/
15-Oct-2020,Purchase,00.00,"359,385.86",00.00,dAccaA95A27293c,6443,Terrence,Grimes,"Potter, Potter and Meza",South Kylie,Seychelles,998.274.4472x1843,001-722-866-7241,lromero@drake.com,2020-06-05,http://www.flores-cummings.com/
15-Oct-2020,Reversal,"210,497.00",00.00,"210,497.00",98f69acbfD2cfeE,828,Jill,Price,"Farmer, Mccormick and Stokes",Port Brookeview,Egypt,(437)042-6205x5517,001-549-418-6190,mollyfaulkner@nielsen.biz,2021-06-08,https://marsh-pollard.com/
15-Oct-2020,RTGS,00.00,"52,624.25","157,872.75",5bCd496f2e35BC4,3056,Kristen,Walls,Ayers-Stout,Tinaview,Tajikistan,+1-868-825-2580x499,001-912-304-1816x7109,brandonshepherd@fry.com,2021-06-05,https://www.pollard-andrews.biz/
15-Oct-2020,Cash,00.00,"39,468.19","118,404.56",08800F76A7bb4c0,1936,Cathy,Stanley,Kline Group,Lake Hayden,Nepal,556-116-4958x14315,024-650-8735x25924,kirsten54@hansen.info,2020-12-09,http://mack.info/
15-Oct-2020,Cash,00.00,"13,156.06","105,248.50",9C0B5dAEDDA1C7d,1732,Mason,Mccann,Contreras-Avila,East Coltonhaven,Mauritania,001-922-755-5590x059,782.089.6909,garciajerry@francis-barry.com,2020-01-15,http://www.leblanc.info/
15-Oct-2020,Bill,00.00,"26,312.13","78,936.38",9BEcDe3EA3d5631,5770,Danny,Black,Key-Haas,Nicholsbury,Taiwan,654-036-5042x00021,875-647-1684x826,montgomerycolin@cox.com,2020-09-14,https://watson.net/
15-Oct-2020,Debit Card,00.00,"39,468.19","39,468.19",E81AADA7AFFD3a0,5354,Kristopher,Savage,"Webster, Ross and Cherry",Noblestad,Zimbabwe,744-219-9442,583-288-0000,tamiunderwood@rios.com,2021-07-09,http://www.wiley.com/
15-Oct-2020,Debit Card,00.33,00.00,"39,468.52",5235360eEC7aCc4,5646,Jamie,Caldwell,Gilbert-Moran,West Troyland,Netherlands,001-931-719-5752,290-253-8027x68150,ostephens@cohen.com,2020-03-25,https://www.leblanc.com/
15-Oct-2020,NEFT,"95,432.20",00.00,"134,900.72",bCbc0F706fAfF1e,3946,Tami,Burton,Holden-Bonilla,East Kristen,Benin,(368)650-5644x8701,+1-660-347-8804x2959,dhahn@gilbert-murray.com,2021-02-20,http://bentley.biz/
15-Oct-2020,Cash,00.00,"13,490.07","121,410.65",6bbd8ebF4A96Ad4,5188,Brett,Bender,Bishop-Hickman,South Judithside,Somalia,+1-281-150-8213x99443,(399)480-4960x192,bernard69@barnes.com,2021-11-12,https://armstrong.com/
15-Oct-2020,Reversal,00.00,"15,176.33","106,234.32",dDbaaAe0b9FaFfd,3023,David,Blackburn,"Blankenship, Weeks and Khan",East Rodney,Finland,(802)476-5007,141-122-3744,zschroeder@weber.info,2021-08-30,https://www.pruitt-davila.com/
15-Oct-2020,Cheque,00.00,"35,411.44","70,822.88",eEaA6F9Fd9D1cd6,1914,Darin,Frederick,Wilkerson and Sons,East Grant,Niger,(753)711-9659,685-940-4112x795,tannerseth@hughes-hawkins.com,2020-02-08,http://www.valdez-carr.org/
15-Oct-2020,NEFT,00.00,"7,869.21","62,953.67",BA4D409ADFCE7CC,8559,Pam,Harris,Tucker and Sons,West William,Grenada,719-597-0410x208,(612)353-0213x0757,parsonsrebekah@boone.biz,2022-01-31,https://lindsey.org/
15-Oct-2020,Interest,54.80,00.00,"63,008.47",1fDA21A6f3c75b4,392,Norman,Lang,"Holden, Gould and Chan",Villarrealview,Guadeloupe,919-062-2686x56805,264-147-8992x048,jenna30@dickerson-vaughn.biz,2021-05-02,http://mejia-blevins.com/
16-Oct-2020,Debit Card,00.00,"7,000.94","56,007.53",4AEcC2Dcdf9Aba0,8266,Jasmin,Ortega,Munoz-Richards,North Tracy,Maldives,759.158.6370x875,+1-774-120-3804x724,parrishalexa@vaughn.org,2021-10-31,https://www.henry-lin.info/
16-Oct-2020,IMPS,00.00,"6,223.06","49,784.47",E17d7e2d2950901,8365,Scott,Keller,"Wallace, Mccarthy and Mills",Hollyville,Guinea,439.116.4201x12871,6780902475,pennyjoyce@mendez.com,2020-02-28,http://www.wilkerson.com/
16-Oct-2020,Bill,48.90,00.00,"49,833.37",621100beB49754f,2996,Connor,Gill,May PLC,Cliffordburgh,United States Virgin Islands,956-014-7813x802,269.100.5762x495,schung@walls.com,2020-04-05,http://www.mayo-hamilton.com/
16-Oct-2020,Purchase,05.00,00.00,"49,838.37",53cD8B96bCBB4F3,3710,Kerry,Cox,Keith-Mcclain,South Edwin,Qatar,640-837-2819,001-749-643-1264x173,kristirusso@gonzales.com,2020-03-21,http://www.nielsen.com/
16-Oct-2020,Debit Card,475.73,00.00,"50,314.10",BBC2fdC2ecd7cdF,9069,Krista,Frey,"Hardin, Hickman and Bailey",New Frankborough,Chile,722-826-8409x5907,421-893-6299x52666,ray89@pitts.com,2021-12-31,https://www.sanford-molina.biz/
16-Oct-2020,RTGS,419.00,00.00,"50,733.10",74ff44FDA78e9FE,2379,Rickey,Bradshaw,Turner-Bell,North Jaclyn,Vietnam,001-616-754-8104x119,122.066.2993x46914,philip59@watson-rocha.com,2020-05-28,https://leblanc.com/
16-Oct-2020,Miscellaneous,00.00,"16,911.03","33,822.07",8D72B3c4472A3Bd,5253,Robin,Carson,"Orr, Massey and Barrett",Palmerport,Ukraine,825.314.5321,(105)258-6887x04775,villanuevaalec@whitaker.biz,2022-04-25,https://www.mcbride-dunlap.net/
16-Oct-2020,Cash,"2,371.30",00.00,"36,193.37",16Dd5C5b16Bc373,5091,Claudia,Simpson,"Daugherty, Oneill and Stone",Foxbury,Wallis and Futuna,324.119.8170x0114,001-321-462-1074x02124,margaret02@huff-barrett.net,2021-07-12,http://www.griffith.com/
16-Oct-2020,NEFT,00.00,"18,096.69","18,096.69",38baedECE07dA6A,272,Jesus,Haynes,Swanson-Glenn,Warrenhaven,Namibia,(592)022-9626,808.651.7562,zramsey@gallagher-briggs.biz,2021-11-13,https://watkins.com/
16-Oct-2020,ATM,00.00,"6,032.23","12,064.46",bA829972bFc6fc9,2345,Lisa,Hines,"Gonzales, Woods and Allen",Lynnshire,Botswana,(602)498-0740,+1-998-036-6127,marshmonica@madden-charles.info,2021-07-19,https://petersen.info/
16-Oct-2020,Tax,05.54,00.00,"12,070.00",1CA8C4717a69edD,761,Jean,Melton,Ortiz-Hansen,Brandonmouth,Philippines,001-248-294-1601x96152,(710)472-9518,chambersaimee@carpenter-villegas.net,2021-04-16,https://ellis.com/
16-Oct-2020,Bill,00.00,"1,341.11","10,728.89",aC3E4d6Ceedca2b,5581,Brenda,Ford,Madden-Livingston,West Raymondmouth,Chad,004-455-0074x784,(930)341-7583,villareginald@taylor.com,2020-02-14,https://boyle.com/
16-Oct-2020,Bill,00.00,"1,532.70","9,196.19",A92054Cd8b9D34e,6879,Samuel,Mccormick,"Reed, Phelps and Gray",Claytonland,Thailand,+1-794-566-3044x91163,749-385-2991x87686,bonnie24@perkins.com,2020-05-24,http://www.caldwell.org/
16-Oct-2020,Commission,00.00,"3,065.40","6,130.79",F9fD297E42BC6E6,324,Crystal,Baxter,Whitaker PLC,Port Gregville,Cook Islands,312-423-8877x6854,2512772210,clintonsuarez@duke-garner.com,2022-04-17,http://buchanan-campbell.com/
16-Oct-2020,Miscellaneous,01.00,00.00,"6,131.79",b9072cb30eCd8F4,4565,Ryan,Carter,"Marsh, Phelps and Landry",Hudsontown,Georgia,406-002-1444,904-259-6390x5643,tonifrey@moses-price.com,2020-08-23,http://williams.net/
16-Oct-2020,Bill,00.00,613.18,"5,518.61",abf0e9d1e30dBAD,9820,Isaac,Gonzalez,"Banks, Houston and Charles",Roychester,Ecuador,2570815450,5604370308,michealmatthews@rose.com,2022-01-28,http://galvan.biz/
16-Oct-2020,RTGS,"22,606.00",00.00,"28,124.61",FAfccbf3d274BD0,9549,Cristian,Mercer,"Rollins, Garner and Owen",North Shelia,Benin,+1-634-250-0807,613-605-6066,jean83@anthony.biz,2021-11-26,http://andrade.com/
16-Oct-2020,Purchase,00.00,"28,124.61",00.00,1ffA5730246Ed10,9807,Daryl,Greer,Roy-Mccormick,Monicamouth,Marshall Islands,+1-671-445-2728,063-949-5302x9400,mcdanielgrant@sandoval.com,2020-06-23,http://conrad.info/
17-Oct-2020,Interest,"3,595.00",00.00,"3,595.00",d9bBf5e7aCC6bbE,4676,Kathy,Skinner,"Dudley, Lewis and Shaffer",East Gabrielland,Bahrain,789.192.4363x213,(414)857-5628x4549,edaugherty@phillips.com,2022-05-27,http://campos.com/
17-Oct-2020,Transfer,168.00,00.00,"3,763.00",bca8c61e80D02A4,2186,Isaac,Walls,Dominguez-Ward,Watersfurt,Ireland,001-883-762-3211,120.038.9796x50456,chrisrich@obrien-hawkins.info,2020-11-15,http://www.small-robertson.biz/
17-Oct-2020,Reversal,00.00,418.11,"3,344.89",Cfc27ef7029D320,1612,Selena,Cohen,"Chang, Bright and Goodwin",Nicolemouth,Thailand,(109)801-8979x01529,001-153-831-0935x56181,erica97@bird.com,2021-11-25,https://www.miller.net/
17-Oct-2020,IMPS,"1,667,632.75",00.00,"1,670,977.64",e5C79CEa7Ba7bC9,4887,Leon,Valentine,"Maynard, Sosa and Shah",Cesarberg,Saint Kitts and Nevis,+1-504-718-6882,+1-239-413-1983x2448,carmen86@barrett-ramsey.com,2021-04-14,https://www.hill-hobbs.biz/
17-Oct-2020,IMPS,00.00,"185,664.18","1,485,313.46",44efF0B1C42Ea7A,909,Betty,Crane,"Stone, Peters and Petersen",Mikaylaside,Yemen,452-010-6155x74965,425-030-1153,linda70@shepherd.net,2021-07-13,http://graves.com/
17-Oct-2020,Purchase,00.00,"742,656.73","742,656.73",bD5E2D0D8889B50,3933,Debbie,May,Ashley LLC,South Feliciaburgh,Maldives,(894)179-4342,001-436-132-2945x501,asalazar@cortez-cowan.com,2020-08-17,http://www.hurst.net/
17-Oct-2020,Transfer,00.70,00.00,"742,657.43",3EFf74fCE09e7de,4196,Virginia,Ball,"Copeland, Montgomery and Ware",North Jacksonland,Malta,031.395.5571x4612,001-444-607-1228x82713,zlara@koch-fields.net,2021-04-17,http://www.pham.com/
17-Oct-2020,NEFT,18.00,00.00,"742,675.43",eaA8c70373fF05F,8725,Nicole,Everett,Garner PLC,New Chad,Congo,6608642817,001-939-534-9607x2940,chrishunt@trevino.com,2021-12-06,http://davis-santana.com/
17-Oct-2020,NEFT,02.00,00.00,"742,677.43",C5d3A983dE8B7Af,1151,Autumn,Morrow,Cain-Key,Gavinmouth,Puerto Rico,(364)863-0943,001-598-633-2610x1437,obright@shah.org,2021-11-23,https://www.guzman-foley.net/
17-Oct-2020,Interest,"1,551,561.20",00.00,"2,294,238.63",02FB4f17aCd93E0,9916,Desiree,Beltran,"Wilson, Shepard and Mcbride",Warrenland,Iceland,084-805-4742,+1-620-196-1365x88367,welchlisa@cooke-roberts.com,2021-02-25,http://www.beltran-farmer.com/
17-Oct-2020,Commission,00.00,"229,423.86","2,064,814.77",F6A181c16bA9db4,9243,Juan,Carey,Proctor Ltd,Montgomeryland,Comoros,(992)650-9776,509-260-9405x69528,carly92@rasmussen.com,2020-05-20,http://www.caldwell.info/
17-Oct-2020,Reversal,00.00,"2,064,814.77",00.00,c59aBbC0EbEe2eF,1037,Selena,Chavez,Rosales-Madden,North Norman,American Samoa,955-978-9927x252,001-221-848-4050x6507,gbrowning@herrera.net,2020-02-26,http://www.hatfield-campbell.com/
17-Oct-2020,NEFT,"1,541.32",00.00,"1,541.32",C68542ae05DAC48,85,Dillon,Gallegos,Lindsey LLC,Port Jon,Macao,836.527.9927x34601,056-265-8970x614,escobarisabella@harrell-santiago.info,2020-10-13,https://kirk-skinner.com/
17-Oct-2020,Bill,"3,096.00",00.00,"4,637.32",924ba7a4BFE7Deb,1685,Vincent,Mccoy,Clayton-Jenkins,Rossstad,Japan,+1-343-284-5091x853,838-559-7376,andrewdonovan@graves-watts.com,2020-07-29,https://cortez-stewart.com/
18-Oct-2020,IMPS,00.00,"4,637.32",00.00,caCCF49FD7bBaAA,8617,Shelby,Pacheco,"Meyers, Gonzalez and Hernandez",East Sharonstad,Uruguay,860-273-2972x94264,3291568396,jaclynthompson@frye.com,2021-07-01,http://rivera-green.info/
18-Oct-2020,Interest,261.90,00.00,261.90,66ACE6eDC8Cea9d,5031,Gina,Beard,Bradley Ltd,East Phyllisberg,Dominican Republic,092.223.8542,448-655-8591x857,tsteele@kelley.com,2020-01-12,http://www.torres.org/
18-Oct-2020,Debit Card,00.00,130.95,130.95,5ABea84Dc8AF5E7,3048,Diane,Gates,Day-Newman,East Dominique,Spain,307.836.2178x8415,+1-301-071-8845x56399,vhartman@kelly-coffey.org,2021-09-08,http://www.hogan.org/
18-Oct-2020,Commission,00.00,65.48,65.47,AAc719dC2D147B2,215,Christine,Walker,"Hartman, Martinez and Lambert",Katieshire,France,+1-908-911-5594,001-290-363-6730x094,luceromaxwell@wong.biz,2021-01-15,http://hodge-ramirez.com/
18-Oct-2020,RTGS,04.00,00.00,69.47,45bccddAffDcebB,4837,Russell,Jennings,Bridges-Baldwin,Cohenborough,Netherlands,+1-758-624-0105x40917,7787925297,zjarvis@payne-maddox.com,2020-04-03,http://www.liu.com/
18-Oct-2020,ATM,00.00,07.72,61.75,FEfC56aEeFD575d,5898,Charlotte,Escobar,Mullen PLC,Lake Marissamouth,Switzerland,534.998.5416,4754829550,frobles@rhodes-gamble.com,2020-01-23,http://hanson.com/
18-Oct-2020,Cheque,00.00,10.29,51.46,9FE1fBadf36D6c3,8954,Edward,Norris,Nielsen-Schneider,West George,Benin,4037606499,001-494-596-6957x46209,pcervantes@preston.com,2020-11-01,http://www.ellis.com/
18-Oct-2020,RTGS,00.00,17.15,34.31,BEb090eEcd50deD,7060,Misty,Strickland,Lin Inc,New Brandon,British Indian Ocean Territory (Chagos Archipelago),254.934.8712x60950,641.001.4447x3970,blackburnkristopher@blackburn.biz,2020-05-02,http://massey.com/
18-Oct-2020,NEFT,"3,672.00",00.00,"3,706.31",b3AA50bdDDFBCF2,5014,Kirk,Sanford,Donovan-Hodges,Alfredbury,New Zealand,9913466962,378-706-5866,ericmorton@leonard-conley.com,2021-04-14,https://gillespie.org/
18-Oct-2020,RTGS,"1,891,023.80",00.00,"1,894,730.11",7a2cD31f7A2c545,1072,Norma,Medina,Marquez-Faulkner,Gallowaymouth,Solomon Islands,001-298-685-5257x47766,(724)785-0802,caitlinhubbard@proctor-mullins.com,2020-11-28,https://www.chandler-henderson.com/
18-Oct-2020,IMPS,17.00,00.00,"1,894,747.11",0E4C2Dc37fAFBf0,8016,Johnny,Cohen,"Cantu, Conley and Henry",Frenchburgh,Ethiopia,001-183-282-1974x4523,099-397-5526,marisablankenship@logan.biz,2020-10-31,https://carroll.com/
18-Oct-2020,Purchase,"1,477,269.20",00.00,"3,372,016.31",EB9Bf46a74aBacE,5136,Louis,Deleon,Jacobs LLC,East Alanton,Martinique,(131)857-4732,(595)141-5230x054,uchung@burnett-collier.biz,2020-02-26,https://moyer-skinner.net/
18-Oct-2020,IMPS,00.00,"1,124,005.44","2,248,010.87",Df2F2eC0E7B8F4F,7544,Marc,Weaver,Fernandez-Bernard,Alvinburgh,France,845.148.1904x718,(815)563-3937,aritter@stuart.com,2020-09-20,http://wiley-wheeler.com/
18-Oct-2020,Cash,00.00,"749,336.96","1,498,673.91",BB9b641e4238BA8,2074,Kristine,Alvarez,Valdez-Barton,West Gregg,Israel,(331)827-8985,290.238.0254,collin01@cameron-moran.biz,2021-12-08,http://cortez.com/
18-Oct-2020,RTGS,03.29,00.00,"1,498,677.20",Ca4F85ff53E442E,9413,Traci,Rice,Rojas Ltd,Odonnellberg,Tonga,+1-380-628-3223x10755,249.089.3769x36236,cervantescraig@jones.com,2020-01-23,https://mills.com/
18-Oct-2020,Debit Card,00.00,"249,779.53","1,248,897.67",19EE920b5514dD6,6685,Latasha,Peterson,Wyatt-Mendoza,West Dalton,France,+1-540-861-2915,327-464-8511x77153,claire01@stevens.com,2021-04-03,http://www.conrad.com/
18-Oct-2020,Tax,"74,055.25",00.00,"1,322,952.92",AAe7ab9dc73Ea1c,3360,Mia,Compton,"Patterson, Frazier and Wilkinson",Cindytown,Kenya,9998282143,993.394.6951,hoodvalerie@everett.com,2021-11-12,https://www.knox.com/
18-Oct-2020,Debit Card,"3,708.92",00.00,"1,326,661.84",cfea97B3aB9E037,9615,Gwendolyn,Hartman,Leach Ltd,Christianfort,Mali,(294)869-6584,+1-961-090-7505x480,louisvega@lawson.com,2021-04-25,https://www.villanueva.info/
18-Oct-2020,ATM,35.50,00.00,"1,326,697.34",dFDFc9B902B4BFb,6023,Breanna,Barajas,Solis Ltd,Staceyton,Guernsey,976.284.2284x91952,(682)033-1107x1745,sloanryan@decker.com,2021-11-21,http://www.walsh-schwartz.com/
18-Oct-2020,RTGS,00.00,"1,326,697.34",00.00,70f65f3fAb06177,1424,Cindy,Christensen,Wong-Santana,Claytonhaven,Slovakia (Slovak Republic),907.142.0938x5120,001-030-375-6458x77875,nlam@brown.net,2021-10-11,https://www.hendricks.com/
18-Oct-2020,Reversal,"55,373.00",00.00,"55,373.00",dbaD3607b79a93c,399,Sheila,Cardenas,Copeland Inc,Juliestad,Romania,326.362.3213x2697,+1-774-246-8617x95136,ibenitez@maxwell-martin.org,2020-03-31,http://gilmore.com/
18-Oct-2020,Transfer,00.00,"7,910.43","47,462.57",1EdA3EDBf4f35bE,5672,Brooke,Delgado,Chen-Yates,Lake Mark,El Salvador,001-595-399-8161x27132,+1-837-785-6998x540,kflores@powell-whitaker.com,2020-10-14,https://www.garrett.biz/
18-Oct-2020,RTGS,"128,982.00",00.00,"176,444.57",e4d7aD9D753a35b,3736,Julia,Bates,Gill Inc,Lambfort,Russian Federation,2864821224,694-037-3123x6369,molly59@alvarado.info,2020-10-11,https://www.harrington-reyes.biz/
18-Oct-2020,Reversal,00.00,"19,604.95","156,839.62",A01fAD8d8FBFdFC,7317,Carly,Garner,Hancock-Mcdaniel,Petersfurt,Vietnam,(589)959-4035x15581,641-464-2986x5872,carrieyang@glover.net,2020-07-12,http://norton.com/
18-Oct-2020,Commission,00.00,"26,139.94","130,699.68",24991d88D469BFC,6608,Carmen,Wiley,Barr-Sawyer,West Autumnberg,Tajikistan,001-656-756-6618,+1-745-363-0989,nicole66@graham-burnett.org,2021-08-27,http://hamilton.com/
18-Oct-2020,Interest,00.00,"26,139.94","104,559.74",D69E92Fb5EB72A1,8126,Nicholas,Parrish,Silva-Valencia,West Jordanville,Qatar,892.819.0830,4954759403,prich@woods-french.com,2021-05-03,http://www.villegas.com/
18-Oct-2020,NEFT,00.00,"13,069.97","91,489.77",D6F0E4D1DcBc9e0,9677,Katelyn,Phillips,Gould-Cooley,Gabrielland,Bermuda,+1-036-960-9352,(846)430-5209,scisneros@french-stanley.com,2020-03-17,https://www.ross.biz/
18-Oct-2020,Purchase,00.00,"10,165.53","81,324.24",6f6a82EED2B9933,5138,Sydney,Higgins,Barr-Gibbs,Youngview,Kuwait,(946)166-8356x840,+1-923-463-1299x90527,grantmelanie@friedman.com,2021-01-18,https://www.velez-johnston.info/
18-Oct-2020,Transfer,00.00,"10,165.53","71,158.71",539C67dE0EAF5f3,1679,Eduardo,Singleton,Fox-Guerrero,West Bryanfurt,Chile,(922)548-4683x6622,040-627-0820,caitlyn50@house.com,2021-08-18,http://www.giles.com/
18-Oct-2020,Purchase,"1,838.00",00.00,"72,996.71",73Ad6f9Cbe021D3,6340,Kelsey,Sawyer,"Callahan, Blake and Fuentes",Jeanland,Guatemala,001-444-313-6363x50164,001-938-075-9287,ehampton@huerta.org,2022-01-05,https://mitchell.biz/
18-Oct-2020,Cheque,00.00,"72,996.71",00.00,aB1B1A82DC0EbAe,9130,Dominic,Kirby,Morgan Inc,Kristyview,Saint Helena,323-782-6070x859,(489)650-7901x867,owenmikayla@wheeler-watkins.com,2020-10-29,https://www.hurley-raymond.com/
18-Oct-2020,Transfer,"981,732.00",00.00,"981,732.00",B14E7ED4dC4CBBf,280,Deborah,Atkins,Wagner-Ayala,North Mindyview,Cook Islands,(698)435-4856,106.482.9107x4369,brettmorrison@bernard-knapp.com,2020-06-21,https://www.weiss-foley.net/
18-Oct-2020,ATM,"181,652.75",00.00,"1,163,384.75",3a46B8Fd3b6aAfC,7657,Stephen,Lara,"Rosales, Summers and Diaz",East Theresamouth,Palau,+1-500-291-7522x264,(417)506-3142x9540,welchdale@henry-kim.com,2021-04-08,http://www.leach-blackburn.biz/
18-Oct-2020,Tax,00.00,"129,264.97","1,034,119.78",f10fAFa2EA7Ad5c,214,Tyrone,Oconnell,Chavez and Sons,Davestad,Malaysia,001-591-723-3809x36173,001-323-574-2316x07928,malik63@frazier-nichols.biz,2022-03-03,http://www.gray.org/
18-Oct-2020,NEFT,00.00,"114,902.20","919,217.58",f8EC3ABe3D2D49d,4820,Tammy,Curry,Moyer-Kerr,Lake Caitlyn,Kazakhstan,625-677-7485,269-111-1970x672,kfry@krause.com,2022-01-29,https://prince-moyer.com/
18-Oct-2020,Tax,93.88,00.00,"919,311.46",2dc0146c8da25fd,269,Kayla,Ferguson,"Shaffer, Chang and Mcmahon",Port Graceport,Slovakia (Slovak Republic),743.898.2631,974-320-4973,shopkins@murphy-fleming.com,2020-10-13,https://www.kennedy-li.com/
18-Oct-2020,Commission,"10,381.00",00.00,"929,692.46",aF2F7d88788cc7E,8605,Daniel,Neal,"Merritt, Little and Potts",Leefort,Albania,2395655515,+1-893-727-8174x7692,derek31@parrish.biz,2021-03-14,http://gilmore.net/
18-Oct-2020,Miscellaneous,"163,466.60",00.00,"1,093,159.06",47Ea2Ce23A5fcA7,5391,Ana,Stanley,Tran Ltd,Port Paul,United States Virgin Islands,(816)928-5793x555,(700)596-7080x558,wigginskristie@tyler.org,2020-07-01,http://wyatt-davenport.com/
18-Oct-2020,Interest,00.00,"273,289.77","819,869.30",c2169620C14FaC3,9948,Warren,Jefferson,"Lowe, Sherman and Martin",North Ebony,Guam,001-539-455-1269x769,(300)721-1331,huynhisabel@cantrell-patel.com,2020-12-13,https://www.robinson-snow.biz/
18-Oct-2020,NEFT,"2,335.20",00.00,"822,204.50",b74C5f67dE8bA4a,3202,Stephanie,Zhang,"Odom, Brock and Levine",Lynchmouth,Philippines,(592)554-3947x5170,(151)587-0695,rowen@swanson.com,2021-08-23,https://cardenas.com/
18-Oct-2020,Purchase,07.00,00.00,"822,211.50",9E0375Ff1c3Cf4f,2864,Chad,Wilson,"Rojas, Greer and Davenport",New Anitashire,Tuvalu,+1-377-470-5985x56363,001-071-786-7214x717,joannevillarreal@mata.org,2022-01-04,http://gilmore-chung.com/
18-Oct-2020,IMPS,00.00,"205,552.88","616,658.62",deEfc43CaB3bB49,6043,Crystal,Cortez,Hays Group,Whitakerland,Grenada,(599)960-0048x42784,493-174-4405,jasminebrennan@cochran.info,2020-03-23,http://www.white-sharp.net/
18-Oct-2020,IMPS,01.98,00.00,"616,660.60",3Ab5BAb01cCEdee,6895,Randy,Mckinney,Miller-Arroyo,Port Helen,Congo,+1-934-183-8889x03523,474.782.5912x637,oarcher@conway.com,2021-06-24,https://jones.com/
18-Oct-2020,IMPS,"590,893.00",00.00,"1,207,553.60",f7FDde683A4e5c9,3618,Alan,Paul,"Floyd, Zuniga and Krause",Olsenville,Western Sahara,750-164-4973,(875)326-1324x37314,sara48@stone-barber.org,2021-07-05,http://roth-campos.com/
18-Oct-2020,Tax,00.00,"150,944.20","1,056,609.40",F1998c81Dc72754,4888,Caleb,Arias,"Becker, Bray and Brown",Moniqueside,Poland,+1-136-997-7718,(225)807-9395,conniearellano@cannon-burnett.com,2022-02-23,http://francis.com/
18-Oct-2020,IMPS,00.00,"352,203.13","704,406.27",DA15FDa18f1Fb5e,7815,Rita,Hampton,Harvey Inc,Walshstad,Puerto Rico,057.544.9290,932-028-2086x7841,valenzuelacassidy@combs.com,2021-01-21,http://www.durham.com/
18-Oct-2020,NEFT,00.00,"78,267.36","626,138.91",1C4B0BfBDe9f77c,2290,Lori,Lam,Meadows-Fitzpatrick,Jaredstad,Cyprus,790-809-6196x3115,001-635-155-8772x7234,haleygabriella@roth-nixon.net,2021-04-08,https://montgomery.info/
18-Oct-2020,Tax,34.74,00.00,"626,173.65",dfdE53340FB82aa,6048,Jackie,Fox,Randall LLC,Monicamouth,Malta,323-088-5226x588,414.796.9219x068,hilljoshua@winters.com,2022-05-06,http://sparks.com/
18-Oct-2020,Commission,00.00,"89,453.38","536,720.27",DABb9bD3CE75FF3,8388,Peggy,Holt,Fitzpatrick Ltd,Mortonside,France,434.173.9632x9161,(660)264-1581x0816,rfuller@torres.com,2020-04-09,https://www.marks.info/
18-Oct-2020,Purchase,00.00,"67,090.03","469,630.24",d7f0a3eFF7C7f5e,4396,Lisa,Ortega,Werner-Diaz,Burnettmouth,United States of America,147.840.2780x9080,301.844.8300,sonyadodson@bentley.org,2020-12-01,http://castillo.com/
18-Oct-2020,Interest,00.00,"58,703.78","410,926.46",bC9488Da1bBDd21,1415,Troy,Arias,Mcdowell PLC,Perryfort,Bolivia,044-179-0609x429,001-053-315-5770x96701,ladkins@parrish.com,2021-03-20,http://eaton.info/
18-Oct-2020,Transfer,"173,210.00",00.00,"584,136.46",ecbAa91517b5fAB,1832,Lynn,Kelly,"Snow, Oneill and Rangel",Port Aprilville,Gambia,(046)102-1070,205-901-0925,fmay@pope-baker.com,2020-04-29,https://www.tyler.com/
18-Oct-2020,ATM,00.00,"292,068.23","292,068.23",E14B3b8a2f83F60,7195,Kristine,Mason,"Beltran, Stark and Wolfe",Wolfestad,Pitcairn Islands,+1-865-153-8376x6969,001-084-335-1305x11196,zacosta@mccall.com,2020-03-17,https://delacruz.com/
18-Oct-2020,Debit Card,00.00,"48,678.04","243,390.19",Fd04d0a7E2BB85D,7118,Helen,Mcintyre,"Love, Gardner and Price",Port Adrienneburgh,Mayotte,(397)062-2064x9327,256-874-5810,alec34@andersen.com,2022-04-22,https://chaney-wade.com/
18-Oct-2020,Cash,00.00,"121,695.10","121,695.10",1b48De1F0bBB4bf,9968,Rachel,Kramer,Park LLC,Lake Isabel,Central African Republic,952-653-5624x436,702.138.3889,montesjean@vincent.com,2020-07-10,https://neal.com/
18-Oct-2020,IMPS,00.00,"121,695.10",00.00,85ea3F493C25AB6,2650,Sheryl,Sandoval,Gallegos PLC,Nashstad,El Salvador,0562509766,286-760-1322,franciscoblackburn@ware.org,2020-12-05,https://www.horn-stephenson.com/
18-Oct-2020,NEFT,04.09,00.00,04.09,DF42EfcdACF9952,6808,Carly,Wheeler,Stokes Group,New Colebury,Montenegro,920-235-9919,001-777-288-4224,bernardhowe@schultz.com,2020-12-23,https://www.fuller.org/
18-Oct-2020,NEFT,413.20,00.00,417.29,cE26d5BBEc5aeeE,1834,Austin,Knight,Walter-Espinoza,Sheriville,Kazakhstan,+1-994-436-6664x6190,+1-716-520-9719x1785,herbert33@keller-morrow.org,2021-09-29,http://saunders.com/
18-Oct-2020,Miscellaneous,"109,065.00",00.00,"109,482.29",Ea4d54a76DF734e,3579,Isaac,Villarreal,Brooks-Nicholson,Salinasland,Burundi,426.649.6501x1887,001-400-715-3609x67437,bridgethardin@morales.net,2020-08-20,http://www.clarke-hayden.info/
18-Oct-2020,Purchase,00.00,"109,482.29",00.00,E9c20c939ACBF5a,7319,Ana,Sloan,Sanford Group,Wagnerton,Isle of Man,001-488-066-9530x6511,266-465-5926,fconway@costa.com,2021-03-15,http://stephens-bartlett.biz/
18-Oct-2020,ATM,"1,596,787.00",00.00,"1,596,787.00",85C7f5D9bbB72fA,2734,Mercedes,Martinez,"Cunningham, Kirby and Abbott",Avilafort,Namibia,042-988-9798x6756,114.658.0066x707,tvang@wells-davila.com,2021-11-11,http://grant.biz/
18-Oct-2020,Reversal,00.00,"798,393.50","798,393.50",E1CE0D4070F76F3,2463,Douglas,Chang,Levy LLC,Normanview,Trinidad and Tobago,+1-793-021-4940x874,(218)991-1008,tammierobertson@johnston-marshall.biz,2021-03-09,https://www.arellano.info/
18-Oct-2020,Cash,00.00,"99,799.19","698,594.31",BC45DEf0A2a05fD,9062,Edward,Yates,"Graham, Mendoza and Hale",West Lindsey,Italy,858-408-7425,(633)900-8832x4199,sawyervickie@french.org,2022-05-20,http://maynard.com/
18-Oct-2020,Interest,"1,863,036.25",00.00,"2,561,630.56",31C64Dc03Bb4FEf,7221,Fred,Benjamin,"Bauer, Cowan and Beltran",Jimmyview,Korea,(074)120-2792x3249,001-477-927-8647x44886,hectoryoder@liu.com,2021-08-29,http://michael-avila.com/
18-Oct-2020,Cash,"15,102.00",00.00,"2,576,732.56",D1AFe6DE311cb1D,5202,Kerri,Schaefer,Atkins-Carrillo,Jacobhaven,Palau,622.584.4865,001-489-173-2433x5616,andrewcuevas@hawkins.com,2020-07-25,http://www.good.com/
18-Oct-2020,Commission,00.00,"515,346.51","2,061,386.05",B7549f2aCAbc52E,3203,Felicia,Khan,Mendez-Reese,Allisonport,Macedonia,001-435-825-1238x7552,+1-082-410-5680x17216,marcus23@gates.biz,2020-03-15,https://www.norton-conley.net/
18-Oct-2020,Reversal,00.00,"515,346.51","1,546,039.54",D6FdCC7fCC9E0ca,4112,Candace,Cordova,"Elliott, Nelson and Stephenson",Lutzmouth,Tokelau,+1-023-036-1316x719,983.275.9331x9866,umcclain@lee-suarez.com,2020-12-06,https://www.mcknight.com/
18-Oct-2020,Transfer,04.50,00.00,"1,546,044.04",5193CdE8DDEBE31,992,Darius,Collier,Mullen and Sons,Sotomouth,Gabon,001-114-652-1153,121.092.6078,bblack@hancock-haley.com,2021-11-21,http://www.walters.com/
18-Oct-2020,Reversal,00.00,"773,022.02","773,022.02",bf039cF05b0D698,8951,Meredith,Combs,Blevins-Baird,Harringtonland,Venezuela,502.405.6504,(777)454-6162x86656,bonnierich@lang.com,2020-06-22,https://www.sutton.net/
18-Oct-2020,Purchase,"225,870.00",00.00,"998,892.02",fcECDE5fE92Dcc0,7364,Sean,Salas,May-Dodson,Lake Anita,Portugal,445.231.7411x93693,(048)560-4030x171,wharmon@mckay.info,2021-08-19,http://browning.com/
18-Oct-2020,Interest,25.60,00.00,"998,917.62",Bc9Cda3AAEED2DA,434,Kristi,Dixon,Kim Inc,South Rodneystad,Palau,(523)214-3540,001-614-536-6394,lindsaymiranda@atkinson.info,2021-12-04,https://wiggins.com/
18-Oct-2020,Bill,00.00,"124,864.70","874,052.92",fd2cEEB0A2DAca5,5372,Cody,Brock,Vaughan-Luna,South Terry,Jamaica,+1-244-071-9879x65702,017-512-9102,padillaalec@dean-rose.com,2021-01-17,https://www.vaughan-heath.com/
18-Oct-2020,Reversal,00.00,"124,864.70","749,188.22",23F85a722111F2e,4630,Brian,Schmitt,Johns-Jenkins,Port Jaredtown,Belarus,0875482198,921-220-4819x98659,jorge89@calhoun.com,2022-02-07,http://www.chambers.net/
18-Oct-2020,Tax,"1,420.00",00.00,"750,608.22",f6dEdeeDa2Bf8e5,6115,Evelyn,Kirk,"Graham, Chen and Moreno",West Neil,United States of America,(277)866-3064,(603)003-5119x327,christian01@aguilar.info,2020-01-10,http://www.gibson-riley.com/
18-Oct-2020,RTGS,00.00,"750,608.22",00.00,D6Fc0C032d897bf,9942,Cassidy,Larson,Kelly-Fritz,Wallfurt,Venezuela,716-542-3748,187-847-2633,frankware@lin.com,2020-07-30,https://tanner-dodson.org/
18-Oct-2020,Tax,"91,320.70",00.00,"91,320.70",EbadC2c181FFB6d,9176,Brent,Tanner,"Acevedo, Richardson and Stokes",New Katherine,Venezuela,444-976-6696,(187)640-4324x13980,mcconnelldeanna@dalton.com,2022-02-26,https://sosa.biz/
18-Oct-2020,RTGS,00.00,"9,132.07","82,188.63",CF04ed55A5EFF3E,9418,Nichole,Jackson,"Frazier, Hernandez and Bentley",Port Adam,Nepal,022-424-1498,772-764-7053x2941,stacie72@salinas-tucker.com,2022-01-08,https://carlson.org/
18-Oct-2020,NEFT,"210,182.34",00.00,"292,370.97",35522CB3aa1a15e,5840,Eddie,Duffy,"Pineda, Rice and Cuevas",West Patrickport,Montserrat,971.743.5961x4812,192-966-2252x48357,brianbooker@mack.com,2021-06-05,http://allison.com/
18-Oct-2020,Miscellaneous,00.00,"73,092.74","219,278.23",e74E7f8Fd8D102d,3163,Kendra,Trujillo,Bray LLC,Grantmouth,Estonia,+1-998-609-4646x32859,(045)549-1356,lamjoanne@russo.com,2022-04-28,http://campos.com/
18-Oct-2020,Commission,"156,857.00",00.00,"376,135.23",29A8E562DC75ede,105,Bobby,Collier,"Horn, Stevenson and Yoder",New Cindy,Mauritius,001-778-840-9271x74639,+1-151-871-9736x708,samantha34@mccarthy.com,2020-04-11,https://hendrix-pittman.biz/
18-Oct-2020,Interest,00.00,"62,689.21","313,446.02",AfCeAc9d8b0fAde,8403,Jacqueline,Howe,May-Booth,South Annette,Iraq,001-422-440-1309x6447,001-555-632-0351x68364,farcher@horton-thompson.com,2020-09-11,http://www.cohen.info/
18-Oct-2020,Bill,"1,766.00",00.00,"315,212.02",2c5eBF3da13Ee49,1655,Bob,Oconnell,Mills LLC,North Jordantown,Namibia,(517)321-9679x21611,552.734.8814x704,yreid@salazar.org,2020-05-14,http://www.rollins-mayo.com/
18-Oct-2020,Transfer,00.00,"78,803.01","236,409.02",9F3EF2B86c3ea30,1815,Jackson,Huerta,"Villarreal, Fernandez and Winters",Ballchester,Moldova,199-288-2506,(070)063-9219x741,tara33@solis-rojas.com,2020-05-15,http://www.noble-raymond.org/
18-Oct-2020,NEFT,495.00,00.00,"236,904.02",dE03Ad0E6Ca4aB5,3975,Edward,Case,Glenn Group,Thorntonland,Antigua and Barbuda,(515)552-0218x6175,794-978-8373x2998,meltonangelica@everett-leonard.net,2022-05-25,http://www.barnett.info/
18-Oct-2020,Tax,00.00,"47,380.80","189,523.22",82a23D4eC7f3eDC,4083,Betty,Byrd,"Ali, Crawford and Wise",New Miguel,Japan,(064)884-0944x8729,3640943402,mariogentry@blanchard-lawrence.com,2021-09-13,http://allison.info/
18-Oct-2020,Cash,00.00,"63,174.41","126,348.81",E5B87FC32BdCe3C,791,Catherine,Schmitt,Cherry-Nunez,North Stephaniemouth,Togo,+1-793-441-4448x348,+1-444-799-6940,nhood@hendrix-petty.com,2020-09-04,https://www.duncan.biz/
18-Oct-2020,Transfer,00.00,"12,634.88","113,713.93",8d0a2aEAB2Bc1dd,6417,Mark,Fry,Ponce-Dickerson,Hollowayside,Haiti,001-652-863-0103x79324,(945)240-8288,xsteele@nunez.com,2020-06-27,http://www.raymond-bradford.com/
18-Oct-2020,Tax,00.00,"22,742.79","90,971.14",Bae5CC8CbdC1ccc,8313,Gary,Wilkinson,"Fritz, Landry and Landry",Lake Danielhaven,Zambia,642.341.7372x420,413-412-4021,tarabrooks@pennington-patterson.com,2021-05-26,http://middleton.com/
18-Oct-2020,ATM,00.00,"12,995.88","77,975.26",7E827eb3763be1c,6720,Paige,Armstrong,Wu-Hanson,Dorisside,Antigua and Barbuda,001-086-005-9457,753.911.3064,stefanie94@chung-sawyer.com,2021-09-02,https://prince.net/
18-Oct-2020,Bill,"22,022.00",00.00,"99,997.26",76EdEe5baEBEc5B,3709,Mario,Wise,"Norton, Harrington and Tate",Nguyenhaven,Syrian Arab Republic,144-270-5826x07621,(593)104-7360x8991,whansen@mckee.com,2020-05-25,http://thomas-dougherty.org/
18-Oct-2020,Debit Card,"24,692.20",00.00,"124,689.46",AFbE63b72452168,7268,Cody,Krueger,"Day, Galvan and Juarez",West Jodi,Norway,581.887.1294,+1-930-790-5832x185,kirkmoyer@deleon.info,2021-08-26,http://ellis-mann.com/
18-Oct-2020,RTGS,714.78,00.00,"125,404.24",4eBB0de7Bc452fB,6713,Yesenia,Alexander,Gomez-Calderon,Bakerside,Jordan,+1-996-003-1791,014.421.3062x745,parker07@baker.com,2020-12-02,http://hood.biz/
18-Oct-2020,NEFT,00.00,"13,933.80","111,470.44",1fAcCDdED5e6e63,3181,Marie,Fuller,"Anthony, Wilkerson and Frye",Curtishaven,Guyana,857.364.7313x2083,378-470-7792x74662,rangelcory@callahan-reilly.com,2021-12-06,https://www.parker.com/
18-Oct-2020,Bill,00.00,"12,385.60","99,084.84",D9FaEfd9f2E71b2,1986,Sierra,Case,Reeves PLC,Davenportberg,Slovenia,+1-257-768-8102x55218,(636)141-3663,charleswalls@phillips.com,2020-08-22,https://mora.com/
18-Oct-2020,Debit Card,00.00,"14,154.98","84,929.86",25b867D7ADcdbc8,9391,Denise,Berry,Mcintyre-Lawrence,Lake Meghan,Cyprus,300.729.6290x9467,(218)580-8525,eileen81@prince.net,2021-05-14,http://pineda.com/
18-Oct-2020,Purchase,06.00,00.00,"84,935.86",4D1eECDBad8dbaC,3357,Tammie,Burgess,Gregory Ltd,Sandraside,Greenland,318-273-3032,001-419-621-1529x4012,helen01@rosales.com,2021-08-25,https://www.pope.info/
18-Oct-2020,Interest,00.00,"42,467.93","42,467.93",2396CCC1D555fbe,9890,Meagan,Quinn,Preston and Sons,Howellton,Uganda,423-364-9804x6659,001-232-964-8142,chloe80@avila.com,2022-04-04,https://harrell.com/
18-Oct-2020,Miscellaneous,"70,450.22",00.00,"112,918.15",e7d9ac4De34fE5E,4420,Sara,Archer,"Calderon, Cross and Estrada",Mckayside,Romania,226-502-1980,001-866-868-2113,anthony47@mcclain.com,2020-04-02,http://fowler-sanford.info/
18-Oct-2020,Bill,37.00,00.00,"112,955.15",7f1f4aF82AbCdE8,785,Lonnie,Cisneros,Parrish LLC,Francischester,France,(648)763-8915,872-626-7295x19426,qpham@cabrera-foley.com,2020-03-22,https://www.kennedy.com/
18-Oct-2020,Cash,00.00,"11,295.52","101,659.64",f19dFaB5630ABF7,6755,Shelby,Rocha,Harmon-Roth,West Harrytown,Zimbabwe,910-257-6626,001-242-442-1560,edwin73@daniel-kane.net,2021-06-17,https://www.adkins.org/
18-Oct-2020,Cash,"2,581.50",00.00,"104,241.14",0dCdaB72E1f65Fc,1772,Louis,Tanner,Malone Ltd,West Jacob,Grenada,(442)211-3561,206-929-4696,norrismanuel@torres.net,2020-05-29,http://www.bishop.org/
18-Oct-2020,Interest,20.70,00.00,"104,261.84",AACa6B7562DA780,5642,Stacie,Gibbs,Mcfarland Inc,Buckville,Gibraltar,001-989-335-8076x824,(466)917-6492,meagan71@gutierrez.org,2021-07-22,https://joseph-gordon.com/
18-Oct-2020,Tax,00.00,"17,376.97","86,884.87",9159EdB73DCC05C,3963,Jimmy,Landry,Bentley-Camacho,Whitneyborough,Australia,001-727-460-7620x45344,550-243-3433x75677,cliffordhuff@ferrell-flores.com,2021-10-31,http://chaney.com/
18-Oct-2020,Debit Card,00.00,"43,442.44","43,442.44",4ee662b0fC4B856,7115,Dalton,Montgomery,Sellers-Rich,North Dan,Marshall Islands,+1-755-838-4960x21124,7590908630,noah45@petersen-herrera.info,2022-03-04,https://hensley-peterson.org/
18-Oct-2020,Cheque,00.00,"4,344.24","39,098.20",7fAa8D9Ef4765b7,4884,Mikayla,Myers,Prince Inc,Hollandfurt,Canada,757.100.3585x811,5894232573,genefarley@santos.com,2020-07-09,http://www.bonilla.com/
18-Oct-2020,ATM,42.90,00.00,"39,141.10",83f294Dbc9Fa409,4367,Latasha,Wilson,"Moody, Velasquez and Christian",Sherryfort,Swaziland,753-846-2380x15374,+1-221-921-1684x47634,tberry@stein.info,2021-11-25,http://www.shelton-arnold.com/
18-Oct-2020,Cash,00.00,"13,047.03","26,094.07",fA5FF5fbE098ea7,2261,Randy,Rivas,Hurst-Hatfield,North Duaneport,Norway,+1-297-625-1797x302,(559)493-2694x331,andrewyoder@powers.com,2020-01-18,http://www.christian-bruce.net/
18-Oct-2020,Cash,42.00,00.00,"26,136.07",3Dcfb28d95fC6cd,2936,Dawn,Hammond,Kaiser LLC,Stevefort,Cayman Islands,001-246-591-3131x7494,4750825431,lvillanueva@bowers.com,2022-01-25,https://www.summers.com/
18-Oct-2020,Cash,"20,804.90",00.00,"46,940.97",Be2eAcF77d15cDf,8791,Jeremy,Sloan,Harding-Roberts,Benjaminside,Brazil,092-788-9658,853-072-1732x9432,bray@chavez-rodriguez.com,2020-09-20,http://www.gay.info/
18-Oct-2020,Transfer,00.00,"5,215.66","41,725.31",E14a4c782E21d11,4694,Dillon,Hogan,Rivers LLC,West Sydneychester,Zimbabwe,529-516-8667,001-868-273-6214x29101,monica18@brennan.com,2022-02-21,https://www.andersen.org/
18-Oct-2020,IMPS,"134,705.10",00.00,"176,430.41",1AADC0EB7A17ff0,7104,Yvonne,Gentry,"Parrish, Greene and Valentine",Port Stacie,Guinea,+1-145-993-7712x3125,+1-860-105-9633x694,kerritrujillo@brewer.com,2020-04-20,https://gibbs.com/
18-Oct-2020,Cash,"1,994.00",00.00,"178,424.41",aC3CC586cfEbF6B,6802,Latoya,Avila,Cuevas-Boyer,Lake Erikfort,Pakistan,593.570.1320x32993,(229)029-5391,anthonyfischer@yoder.info,2021-11-01,https://www.herring.com/
18-Oct-2020,ATM,"20,859.00",00.00,"199,283.41",2cfCbDE516cE9E6,1398,Michelle,Callahan,"Gomez, Walls and Baldwin",Lake Wesley,Cook Islands,583-159-2177x2515,560.958.9567,stacie74@stein-wolf.com,2022-02-17,https://www.mcpherson-hinton.info/
18-Oct-2020,Transfer,00.00,"33,213.90","166,069.51",7805fEeb3BdCBE6,8444,Tracie,Cortez,Woodward Ltd,Bradleyburgh,Iran,820-962-3195x474,+1-040-250-4230x3286,joneskathleen@christian.com,2020-01-21,http://huerta.com/
18-Oct-2020,Reversal,"247,116.44",00.00,"413,185.95",b2e575b007336bD,728,Jaime,Wu,Eaton and Sons,East Mikayla,Moldova,+1-928-064-3005x39854,741.330.3523x555,luceroivan@mcdowell-macias.biz,2020-09-07,https://www.vazquez.com/
18-Oct-2020,Cheque,358.25,00.00,"413,544.20",cC82EB07AAE4b3B,2893,Heidi,Burton,Dunn-Lyons,Lake Robin,United States Virgin Islands,+1-106-474-3119x1865,001-102-271-2329,lunacolton@macdonald.com,2021-11-29,https://barker.net/
18-Oct-2020,Miscellaneous,00.00,"41,354.42","372,189.78",EBb3BABAAEdFCeD,4613,Randall,Butler,Contreras Group,Karaborough,Malta,+1-318-333-4453x444,(851)721-5087x050,kelleymatthew@rose.info,2021-01-30,https://www.johnston.biz/
18-Oct-2020,Tax,"20,394.00",00.00,"392,583.78",c5f6b6A9C3b7DDe,1088,Devon,Holt,"Espinoza, Wade and Hood",East Chris,Western Sahara,560-913-6288,+1-073-524-4698,mirandamcfarland@woodard-kline.com,2020-06-05,http://www.murillo-cohen.biz/
18-Oct-2020,Transfer,00.00,"392,583.78",00.00,a3AC64E3e9D9DfF,4948,Frederick,Marks,"Shields, Garcia and Browning",Pennyburgh,Trinidad and Tobago,(283)555-5229,9348738998,ubanks@black.com,2020-11-16,http://www.flowers-sutton.com/
18-Oct-2020,Bill,07.42,00.00,07.42,0C5E7Ef62F79ec6,6149,Edward,Mclean,Mcknight-Kim,West Daryl,Ireland,767-042-1281x101,(985)922-6247x088,bautistamatthew@moreno.com,2022-05-09,https://www.graves.info/
18-Oct-2020,IMPS,00.00,00.82,06.60,29299b7dcc5F2Df,5418,Wanda,Morrow,"Weaver, Church and Dorsey",New Priscillaton,Maldives,(114)405-3146x8121,+1-527-873-0897,fernando52@sampson.info,2020-01-10,https://edwards.net/
18-Oct-2020,RTGS,"1,962,147.75",00.00,"1,962,154.35",84c29c3B87e3D0d,169,Gabriella,Huerta,Swanson-Lloyd,New Mitchell,Monaco,734.084.6764,2053040352,daniel75@hansen.com,2020-09-17,http://mitchell.com/
19-Oct-2020,Bill,"2,127.49",00.00,"1,964,281.84",cD6B75f2cca273f,7170,Katelyn,Sutton,"Norton, Valdez and Burch",Port Traciemouth,Croatia,068-816-5008,(670)992-6366x14405,rebecca30@moran-george.com,2020-03-25,https://meyer-blankenship.com/
19-Oct-2020,Debit Card,00.00,"218,253.54","1,746,028.30",3B8E38A20dC2Ade,5072,Richard,Cameron,"Chan, Yoder and Herring",Lake Gilbert,Ecuador,001-330-638-3697x77874,(955)391-6577x024,ellenvargas@joyce-burgess.com,2021-07-30,https://www.webster.com/
20-Oct-2020,Commission,00.00,"218,253.54","1,527,774.76",faacFEEfFD78eaC,9304,Erin,Branch,"Cooke, Mccormick and Donaldson",Cannonbury,South Africa,001-124-944-1053,(154)347-2169,lameugene@freeman-mills.org,2021-05-17,https://koch.net/
20-Oct-2020,RTGS,00.00,"381,943.69","1,145,831.07",09DEC4ABd858aDb,2119,Andres,Daniels,Horton Group,Connieburgh,Saint Helena,+1-959-362-3886x60181,(798)910-0823x3076,franklinshelly@graves.com,2020-04-03,https://www.buchanan.info/
20-Oct-2020,Reversal,"190,038.56",00.00,"1,335,869.63",afDB6eda83bcb9d,3019,Tara,Bass,Melton-Dalton,Kristenside,Chad,057-557-4618,(544)284-1589x4103,savageregina@yates-nicholson.biz,2021-01-20,https://villa-church.com/
20-Oct-2020,Debit Card,00.00,"148,429.96","1,187,439.67",0Be6C2ef2e85abc,9457,Cindy,Gonzalez,"Colon, Pennington and Ryan",South Madeline,Zimbabwe,4961540469,(605)039-9222,kathrynvang@pollard.com,2021-12-10,http://spencer.org/
20-Oct-2020,Miscellaneous,26.00,00.00,"1,187,465.67",DC1f66eF7dFE39C,5400,Caitlin,Arnold,"Mccall, Cantu and Burke",Villarrealhaven,Niue,001-420-686-6508x61412,139.143.1581x48643,bob74@hart.net,2022-01-14,http://davenport.info/
20-Oct-2020,Reversal,00.00,"118,746.57","1,068,719.10",1b8bd557eeccBb4,2283,Monica,Watkins,Ewing Ltd,Port Sarah,Sao Tome and Principe,001-517-749-7294x896,860-109-9092x776,lowerygeoffrey@owen-robbins.net,2021-10-13,http://www.mann.net/
20-Oct-2020,NEFT,00.00,"356,239.70","712,479.40",Cfc27ef7029D320,1612,Selena,Cohen,"Chang, Bright and Goodwin",Nicolemouth,Thailand,(109)801-8979x01529,001-153-831-0935x56181,erica97@bird.com,2021-11-25,https://www.miller.net/
20-Oct-2020,Commission,00.00,"237,493.13","474,986.27",A89Ca3f124cFc06,7183,Sherri,Gallagher,"Ingram, Gordon and Bauer",East Steveberg,Nigeria,001-929-905-0784x8118,419-107-6962,paige93@atkinson-michael.com,2021-06-19,https://merritt.com/
20-Oct-2020,Debit Card,325.00,00.00,"475,311.27",C4BA7bcACe4A939,8452,Jane,Vasquez,Bass LLC,South Robinburgh,Armenia,475.542.9046,790.656.5425x52031,adrian90@williams.com,2022-04-25,http://www.hays-winters.net/
20-Oct-2020,NEFT,00.00,"59,413.91","415,897.36",A254EEcB67fc6c5,7583,Bridget,Wilkerson,"Rodriguez, Davis and Burns",Lynchborough,Saint Pierre and Miquelon,787-604-9083x9886,714-985-9248,nmoyer@allison-dean.com,2020-05-11,https://middleton.org/
20-Oct-2020,Cash,00.00,"103,974.34","311,923.02",FFb80F51e5B5bEb,9428,Paula,Chambers,Everett and Sons,Adrianaland,Isle of Man,+1-698-021-6241x9624,689-381-4247,zmullen@robbins.info,2020-10-16,https://www.todd-guzman.com/
20-Oct-2020,Tax,00.00,"31,192.30","280,730.72",f2e43aD5BdDE7eB,5248,Arthur,Randolph,Love-Mosley,East Franciscofurt,Belgium,9424762176,556-114-6183,carolyn38@jimenez.com,2020-03-16,http://www.chen.com/
20-Oct-2020,Commission,37.90,00.00,"280,768.62",1e36285cf46bC5f,5298,Maureen,Koch,Orozco-Miles,Natashaview,India,+1-983-996-0800x506,001-519-175-5166x55790,betty51@johns.com,2020-01-20,http://gilbert-vaughn.com/
20-Oct-2020,Bill,"128,815.75",00.00,"409,584.37",538Bdaef89F7672,96,Elaine,Hendrix,"Goodwin, Lambert and Lowery",South Veronicafurt,Fiji,3010334267,111-173-4785x11133,maureen18@barr.org,2020-12-24,http://mccarty-meza.info/
20-Oct-2020,Transfer,"162,933.00",00.00,"572,517.37",3E3bfED8c4CB7FA,1773,Ernest,Chandler,Hawkins Ltd,Lake Glenfort,Jamaica,(207)969-9678,635-838-4189x71067,darlenepayne@villanueva-stevens.com,2020-01-13,http://randolph.info/
20-Oct-2020,NEFT,00.00,"57,251.74","515,265.63",4956159AB4c07eb,4059,Jeffery,Joyce,Hernandez Group,Gregton,Liberia,001-024-797-3091x7265,397-726-0841x27878,ninavazquez@conway-durham.com,2020-09-13,http://www.kemp.com/
20-Oct-2020,ATM,28.10,00.00,"515,293.73",fc415E95Be291cA,6801,Joanne,Strong,York LLC,Lake Jacob,Iraq,+1-190-102-1796x910,386.641.3518,kentdarren@chen-fields.info,2021-04-14,http://www.roman-roth.com/
20-Oct-2020,ATM,63.00,00.00,"515,356.73",ca099Cc5c260314,9646,Craig,Delacruz,Rich Inc,Port Leroy,Jamaica,001-837-217-5540x91525,6545946641,cassidyfinley@buchanan.com,2020-02-12,https://webb-may.org/
20-Oct-2020,ATM,"4,791.51",00.00,"520,148.24",9A6D2cedCcbc530,8584,Cassie,Ellison,Acosta-Sims,Keithshire,Finland,+1-702-339-9728x09691,+1-697-870-1662,kristameza@eaton.com,2020-01-22,https://www.hull-benitez.com/
20-Oct-2020,NEFT,00.00,"52,014.82","468,133.42",8AFDf96d19dCd5d,6066,Mary,May,"Chaney, Mcfarland and Castillo",South Vanessa,Afghanistan,519-574-9729,721.359.0463x7028,shelly06@chavez-humphrey.info,2020-03-15,http://mann.com/
20-Oct-2020,Reversal,"3,195.00",00.00,"471,328.42",f58CA7f0603F4a2,5436,Colleen,Stevens,Norman Ltd,Port Alice,Northern Mariana Islands,282-566-2323x5362,(144)469-4475x06174,mark56@vincent.com,2021-05-17,http://avery-black.info/
20-Oct-2020,Purchase,00.00,"47,132.84","424,195.58",A3a32Ae2f11FEfb,5050,Carl,Krause,Wheeler-Duffy,Barrettville,Hungary,001-247-883-2850x3283,(336)115-4242x4409,ronniehernandez@mccall.org,2022-04-09,http://www.matthews-esparza.info/
21-Oct-2020,Cheque,23.00,00.00,"424,218.58",aB41dba4eFFe03A,2916,Aimee,Wall,Melendez-Tyler,Whitneytown,Angola,520-829-3466x8250,2652638031,cantukirsten@bond-goodman.biz,2020-11-01,https://www.zimmerman.biz/
21-Oct-2020,ATM,"19,966.00",00.00,"444,184.58",09abFdC02d4BB96,8640,Mario,Harper,"Hampton, Dunlap and Sheppard",North Jeanette,Uzbekistan,385.038.2447x8936,430-460-5894,traceycobb@hodge.com,2020-07-26,https://www.elliott.com/
21-Oct-2020,Commission,"369,093.00",00.00,"813,277.58",a3B38aD7ceF9c26,5511,Shawn,Bolton,"Michael, Mccann and Mayo",Hufffurt,India,657.467.6122x85402,304-095-4260,nrasmussen@cantrell.info,2021-12-31,http://davenport-vargas.org/
21-Oct-2020,Tax,00.00,"203,319.40","609,958.18",9ecc05ceAfcFDFB,7062,Marilyn,Pearson,"Sweeney, Miller and Booker",North Sallyview,Lebanon,705.503.6017x8827,+1-456-773-0873,sgarza@hughes-bowers.com,2022-03-20,https://bridges-wall.net/
21-Oct-2020,Debit Card,22.80,00.00,"609,980.98",5eDb72a05b2A31b,9071,Yvonne,Collins,"Paul, Shah and Pierce",New Dustin,Netherlands,001-077-852-5731x82409,548-977-5738x29621,allison03@herring.com,2021-06-16,https://www.sweeney.biz/
21-Oct-2020,Transfer,00.00,"304,990.49","304,990.49",65D17Ecf29913A4,5123,Kent,Santos,Tucker-Gould,Edwardtown,Guernsey,115.285.6685x0927,+1-903-659-4957x5322,nhardin@orozco.info,2020-09-21,http://cooper-gallegos.com/
21-Oct-2020,IMPS,00.00,"43,570.07","261,420.42",eEbD7deF89c5C24,6402,Charlotte,Thornton,Marks-Strickland,Port Derrick,Angola,6414397271,(622)911-7651,normariddle@case.com,2020-07-19,http://davila.net/
21-Oct-2020,Tax,00.00,"37,345.77","224,074.65",ca1DF1AD4ebDfe2,8589,Cristina,Harris,"Donovan, Walker and Mcclain",Joyceport,Guernsey,+1-948-590-8785x86895,001-282-713-9077x9768,fmcintosh@ellis.com,2021-07-29,http://bullock.net/
21-Oct-2020,Transfer,"115,786.00",00.00,"339,860.65",C41Cc6C9AD0fA46,3551,Cindy,Sampson,Hendricks-Mcpherson,Glendamouth,Burkina Faso,079-216-9306,001-810-380-0755,evansalexandra@tanner.biz,2020-12-15,http://li.info/
21-Oct-2020,IMPS,08.00,00.00,"339,868.65",ef2E35aaBbd01D2,2394,John,Hickman,"Hammond, Webster and Stewart",Faithchester,United States of America,+1-384-821-8201,(141)082-0694x4352,ngates@escobar-merritt.com,2021-10-28,https://www.may-owen.net/
21-Oct-2020,Bill,00.00,"169,934.33","169,934.32",F66039D6ED29dEa,6551,Tyler,Cunningham,"Wilkerson, Dunn and Carey",Chungtown,Guyana,082.855.3128x71163,001-207-404-4780x67685,bonnie77@anderson.org,2021-03-23,http://www.rice-brooks.org/
21-Oct-2020,NEFT,"95,086.00",00.00,"265,020.32",BdB0e3D5a0De8a7,4509,Kayla,Pineda,Mccarthy-Tran,Haroldville,Finland,148-988-3788x6603,001-798-980-9733x6788,maryblackburn@zamora-duffy.info,2021-12-27,http://www.scott-ruiz.com/
21-Oct-2020,RTGS,00.00,"37,860.05","227,160.27",f1AA1fdEb6eF9c4,8797,Vicki,Lloyd,Lynn-Marquez,Jordanbury,Aruba,791-822-6156,(511)594-7691,cristinaglenn@nash.org,2020-10-04,https://www.robertson.com/
21-Oct-2020,IMPS,"235,176.50",00.00,"462,336.77",aeC137FcAaeeB9e,3426,James,Chavez,Todd-Richmond,East Destiny,Pakistan,376.088.5916,(017)620-9288x8870,grodriguez@braun.com,2020-12-08,https://dorsey-hancock.com/
21-Oct-2020,Interest,372.00,00.00,"462,708.77",fB63ACeDA5635A5,6576,Alexandra,Strickland,Montes-Lutz,New Kerristad,Nicaragua,041.904.4071,(027)139-9377x9251,douglas08@cameron.info,2021-03-31,https://www.jacobson.com/
22-Oct-2020,ATM,00.00,"154,236.26","308,472.51",bc8AeF23C40faDc,7797,Anita,Campos,Shannon PLC,Benjaminland,Korea,001-623-754-5192x8471,(141)475-2910,kibarra@coleman-summers.com,2020-07-11,http://www.knapp.info/
22-Oct-2020,Bill,53.00,00.00,"308,525.51",2f782F314b00AaB,4685,Ian,Rubio,Marsh PLC,Theodoreshire,Andorra,198.618.1658x1161,740.331.7592x4093,jason52@mccarthy.info,2020-09-21,https://blackwell-delacruz.com/
22-Oct-2020,Commission,"2,075,751.00",00.00,"2,384,276.51",83Beee4A53fBa66,377,Willie,Flynn,Roberson Group,South Cole,Madagascar,248.782.4477x032,001-480-347-3005x428,marissa82@charles-moore.net,2020-01-24,http://www.contreras.com/
22-Oct-2020,Commission,07.00,00.00,"2,384,283.51",5D59AB3879BFBcE,5710,Shelia,Whitehead,Esparza and Sons,Frankport,Turkey,(105)432-8851,012.644.7889x2046,mia79@parks-ramos.info,2020-09-22,http://www.bolton.com/
22-Oct-2020,Reversal,00.00,"238,428.35","2,145,855.16",b1aF5479A44e168,5470,Ray,Meyer,Novak-Steele,South Zoebury,Hungary,001-175-218-2438x214,(127)874-8343,snowjim@murphy.net,2020-08-21,http://clayton.com/
22-Oct-2020,Bill,06.40,00.00,"2,145,861.56",27E7c4E3aa2f845,7466,Noah,Pitts,Mendez Inc,Donaldsonhaven,Chile,399.945.2464,(483)415-1340x479,lydia84@villanueva.com,2022-02-05,http://www.pitts.com/
22-Oct-2020,Transfer,410.60,00.00,"2,146,272.16",AACa6B7562DA780,5642,Stacie,Gibbs,Mcfarland Inc,Buckville,Gibraltar,001-989-335-8076x824,(466)917-6492,meagan71@gutierrez.org,2021-07-22,https://joseph-gordon.com/
23-Oct-2020,Commission,00.00,"536,568.04","1,609,704.12",8FC0AFb9B6fA8aF,8699,Kerry,Roth,Freeman-Oconnell,South Nicholetown,French Guiana,587.174.5267,496-569-2667,xpierce@brown.com,2020-01-12,http://www.keith-doyle.org/
23-Oct-2020,Interest,138.10,00.00,"1,609,842.22",BdB0e3D5a0De8a7,4509,Kayla,Pineda,Mccarthy-Tran,Haroldville,Finland,148-988-3788x6603,001-798-980-9733x6788,maryblackburn@zamora-duffy.info,2021-12-27,http://www.scott-ruiz.com/
23-Oct-2020,Miscellaneous,"3,373.50",00.00,"1,613,215.72",C4C61a3E70fC1DE,5005,Shannon,Cunningham,"Fitzpatrick, Acosta and Parks",South Rachael,Burkina Faso,644.754.0813,426-591-0174,whitney02@larson-medina.info,2022-02-07,https://www.vincent.com/
23-Oct-2020,Miscellaneous,"257,873.70",00.00,"1,871,089.42",6DCbc22AE36d679,762,Cory,Dean,"Murray, Gomez and Mann",Shepherdport,Gabon,+1-218-710-7009x26304,(131)736-3419x546,franceslindsey@booker.com,2021-09-20,http://www.rush.info/
24-Oct-2020,Interest,00.00,"935,544.71","935,544.71",9Dd78C7bb9E6C6a,1928,Dana,Ross,"Hayes, Holder and Russo",Lake Ellen,Hong Kong,+1-808-176-3957,329.153.2849,marie53@bell.com,2022-01-18,https://mcgrath.info/
24-Oct-2020,Interest,00.00,"935,544.71",00.00,CadF3E4Af2ea92e,2168,Joy,Lynn,"Brennan, Fox and Horn",Lake Lynn,Burundi,800-401-8785x595,700-573-1916,scarney@maynard.com,2021-06-01,https://barrett-lozano.org/
24-Oct-2020,ATM,07.96,00.00,07.96,45fAcb9b399d894,663,Andres,Nash,Baldwin PLC,Leviborough,Norway,1787227957,0920114892,jon73@glenn.info,2020-08-25,http://www.morrow.info/
24-Oct-2020,Transfer,"1,599,888.00",00.00,"1,599,895.96",E2fd8d6dFEAD1Ce,7027,Autumn,Johns,Perry and Sons,Ruizview,Ghana,961.444.4234x818,001-806-442-9010x3424,haroldruiz@baxter.com,2020-06-04,http://goodman-dalton.com/
24-Oct-2020,Purchase,00.00,"228,556.57","1,371,339.39",1bf18C935CFb182,3453,Aaron,Dyer,"Roberts, Austin and Hale",Franceston,Madagascar,+1-327-109-9246x5636,184-006-7292,dsummers@page.biz,2021-04-19,https://www.stokes.com/
24-Oct-2020,Miscellaneous,"12,493.00",00.00,"1,383,832.39",6cDfAaf87cd992F,104,Terri,Hurst,"Shannon, Patterson and Martinez",Lake Omarbury,Luxembourg,+1-012-633-1812x604,(454)485-5374x59454,vernonrush@harvey.com,2020-06-30,http://www.hurst-johnston.info/
24-Oct-2020,NEFT,00.00,"345,958.10","1,037,874.29",9AD2bbe6aB814AF,8111,Nicolas,Hicks,"Shaffer, Haynes and Farley",Carmenfort,Italy,640-906-7355,001-862-198-1984,ubaldwin@sosa.com,2021-03-08,http://pierce.net/
24-Oct-2020,IMPS,03.60,00.00,"1,037,877.89",cbfcF1c0BAB625f,7408,Tabitha,May,Mendoza-Norris,Travisburgh,Moldova,200-986-4808,+1-961-100-0904x0807,hgriffith@duran.org,2020-08-08,http://www.castro-nixon.biz/
24-Oct-2020,Transfer,04.00,00.00,"1,037,881.89",6CFAA9f71E9423B,855,Judy,Rogers,Meyers and Sons,Cliffordborough,Saint Helena,(181)997-7317,+1-610-634-3284x8288,vernon50@dennis.biz,2021-04-10,http://davenport-jefferson.com/
24-Oct-2020,Cheque,00.00,"518,940.95","518,940.94",aE1dDFBf75bAd9A,522,Tom,Hogan,Waller Inc,West Rickyton,Germany,(425)426-1714,+1-673-217-6692x8647,bbowen@bowman.com,2020-05-14,http://www.ruiz.net/
24-Oct-2020,ATM,00.00,"86,490.16","432,450.78",deCee1d8035D612,862,Gregg,Golden,"Stark, Pace and Fernandez",Coltonville,Liechtenstein,+1-898-361-3070x329,001-432-199-7893x4363,eugene22@lamb-thomas.com,2021-10-04,https://www.velazquez.info/
24-Oct-2020,RTGS,00.00,"43,245.08","389,205.70",5BA6F8fEF2F47dD,4720,Allison,Brewer,May-Daniels,Rogerchester,Central African Republic,+1-204-504-9989x37988,217-021-8098,tim00@lutz-park.com,2021-05-30,https://www.mayer-mora.com/
24-Oct-2020,Cheque,00.00,"38,920.57","350,285.13",8Acb14a4FBB1F42,7383,Tammie,Good,"Jordan, Bradshaw and Barber",South Jayhaven,Djibouti,001-626-577-9248x0032,382-920-2668x05668,chaselarsen@holland.info,2020-02-03,https://www.bright.com/
24-Oct-2020,Reversal,00.00,"58,380.86","291,904.28",8F3F650B2ddD53B,634,Nicole,Hart,"Mayo, Goodman and Allen",Rochaport,South Africa,218-046-1566,882.665.3819x034,zchapman@villarreal.com,2021-04-02,https://www.johns-kelley.com/
24-Oct-2020,Debit Card,312.85,00.00,"292,217.13",54759cFa42db987,1020,Jesse,Valencia,George LLC,East Calvin,Portugal,638.366.7668x78866,290-060-5896x152,gordonmonica@love.com,2020-10-11,http://www.huynh.biz/
24-Oct-2020,Interest,00.00,"146,108.57","146,108.56",DE18C7FBFBAB6eC,8688,Benjamin,Simpson,Thompson-Long,South Ashleehaven,Northern Mariana Islands,001-850-122-1419,400-862-0066x4705,bergkyle@calderon-bean.com,2020-07-11,http://mcdaniel-howell.com/
24-Oct-2020,RTGS,"1,787,091.00",00.00,"1,933,199.56",9Ebe23dfA713FCa,2398,Marissa,Curtis,Pierce Inc,Bartonchester,Denmark,(453)788-6932x887,(458)585-2398x4534,shelby81@blackburn.info,2021-11-09,https://bell-mcbride.com/
24-Oct-2020,Tax,348.97,00.00,"1,933,548.53",adFCdB9C13947B6,8765,Kellie,Pollard,Hess-Miranda,West Isaiahchester,Italy,795.873.1433x5028,001-500-670-9095x37932,weberkaylee@sosa.biz,2020-11-14,https://www.morales.com/
24-Oct-2020,Tax,07.00,00.00,"1,933,555.53",e921CB5e5ccB0fe,6394,Barry,Sellers,Byrd and Sons,Bartlettside,Vanuatu,(231)198-5870x6531,001-430-580-4999x516,cynthiablack@walter.com,2020-12-15,https://www.espinoza.com/
24-Oct-2020,Commission,"1,361,884.25",00.00,"3,295,439.78",e263060dCDD13c3,8204,Molly,Kaufman,Mullen-Esparza,Copelandfort,Isle of Man,001-382-631-9739x00067,+1-856-552-9193x660,mkrause@sutton.info,2020-05-01,https://www.middleton.info/
24-Oct-2020,Miscellaneous,00.00,"329,543.98","2,965,895.80",0C3Ca2E7dbF6ec8,5843,Misty,Bauer,Lowe-Mcguire,South Micheal,Sudan,157.655.7466x527,001-796-513-1771x1628,ray06@frey.com,2021-03-17,https://www.guerrero-thompson.biz/
24-Oct-2020,Commission,"3,870.00",00.00,"2,969,765.80",AF38f1cBA82bcef,9490,Jenny,Clements,"Byrd, Paul and Newton",North Makayla,Saint Vincent and the Grenadines,359.408.2206,689.476.2473x96771,robert21@turner.biz,2020-10-19,https://ponce.com/
24-Oct-2020,IMPS,00.00,"329,973.98","2,639,791.82",55aEDeD91Ed4Ed9,6329,Nathaniel,Bonilla,Eaton-Decker,East Theodore,Andorra,(374)713-2461x102,+1-149-842-5717x7207,crawforddanielle@garner.com,2020-04-18,https://www.robbins.com/
24-Oct-2020,NEFT,"18,559.90",00.00,"2,658,351.72",5dbb4Afcb541F5b,3268,Damon,Singh,"Lara, Dorsey and Horne",Marissaburgh,Papua New Guinea,525-210-9357,(118)695-2962,sydney74@douglas.com,2020-08-21,http://www.buchanan.com/
24-Oct-2020,ATM,00.00,"2,658,351.72",00.00,04Bd5F8854C0BB2,1858,Jack,Gordon,Estes-Norton,Lake Mallorymouth,Syrian Arab Republic,560.171.1559,001-717-520-9659x236,beverly55@curry.com,2021-01-31,http://www.price.info/
24-Oct-2020,IMPS,35.00,00.00,35.00,DFcFcA6a4C8f4Ef,7186,Andre,Benitez,Jenkins and Sons,Arthurton,Gambia,057.819.2015x6701,3829629415,matthewhowell@dodson-fitzpatrick.com,2022-04-30,http://haas.biz/
24-Oct-2020,Debit Card,"16,023.00",00.00,"16,058.00",DADE73d661aac56,396,Erin,Boyer,Krause-Maldonado,Gallagherstad,Heard Island and McDonald Islands,(031)356-5581x111,(645)854-3522x9465,leslie12@pitts-holland.com,2020-03-16,https://www.meyer.biz/
25-Oct-2020,Reversal,"19,611.00",00.00,"35,669.00",6c6cb3EA73bccDB,6323,Alex,Wise,Mora-Saunders,West Glennburgh,South Africa,616-005-4136,469-022-5157x21080,pamchoi@meyer.com,2021-03-05,http://www.oneill.net/
25-Oct-2020,Miscellaneous,00.00,"3,963.22","31,705.78",c08d8F81d57ccAC,7022,Kylie,Moran,House LLC,Karlamouth,Saint Vincent and the Grenadines,+1-414-174-2290x7628,(980)269-5927,ppollard@cox.info,2020-05-05,http://mayo.com/
25-Oct-2020,NEFT,23.00,00.00,"31,728.78",A5cc2AaDE3A92fb,5266,Kari,Levine,"Dickerson, Cook and Kelley",East Tom,Turkey,337.642.2902,+1-678-594-8521x06366,erinshannon@vance-kaiser.com,2022-01-29,https://www.burnett-cohen.info/
25-Oct-2020,Miscellaneous,00.00,"4,532.68","27,196.10",dcbf5a3F6FBaEc3,2112,Marcia,Contreras,Hurst-Ashley,South Caseyton,Lebanon,379-373-2422x206,001-821-471-6902x7292,rtodd@hull.com,2022-02-22,https://www.collier.biz/
25-Oct-2020,NEFT,"2,078.07",00.00,"29,274.17",7A43af637BBfe49,5073,Vernon,Coffey,Schmidt-Ruiz,West Grant,Saint Kitts and Nevis,340-709-7720x6927,(126)786-6618x706,gregggriffith@lin-friedman.com,2022-05-04,https://www.lowe-velasquez.net/
25-Oct-2020,Bill,283.00,00.00,"29,557.17",88c69a92A78beCb,4632,Yolanda,Bush,"Massey, Horton and Herring",Francisberg,Australia,+1-800-459-1169x84111,+1-260-937-2135x471,anneward@henry.com,2020-11-13,http://www.hill.com/
25-Oct-2020,ATM,414.00,00.00,"29,971.17",2E58f1A238abeDf,1403,Mandy,Gilbert,Payne-Jennings,Danielleport,Saint Martin,9234120394,(159)785-3873x12167,karlacobb@davenport-powell.net,2021-08-15,https://www.barron-blevins.info/
25-Oct-2020,ATM,"1,695,376.50",00.00,"1,725,347.67",01DAd2cf14AF90a,6928,Duane,Farley,Brennan-Johnson,East Madelinemouth,Guatemala,001-251-402-2117,(386)427-6158,dwatts@norman.info,2022-05-11,http://www.baxter.org/
25-Oct-2020,RTGS,00.00,"246,478.24","1,478,869.43",DeccBc9e79228a6,6846,Kerry,Mckinney,"Poole, Montes and Wu",Kellertown,Macedonia,(924)262-9279x99388,890-016-6592x00096,darrell55@bradley-simmons.com,2020-11-25,http://www.shah.info/
25-Oct-2020,Miscellaneous,00.00,"739,434.72","739,434.72",B2c9Fae7DfbE4cA,1520,Sandy,Carlson,"Berg, Miles and Gamble",South Melodyburgh,Marshall Islands,+1-266-483-6070,001-804-702-3280x77623,curtis04@gomez.biz,2021-04-20,http://www.sanders.biz/
25-Oct-2020,Miscellaneous,00.00,"123,239.12","616,195.60",41cCfC6fA3FdA2d,9189,Charlene,Alvarado,Burke-Gamble,Shepardburgh,India,380-688-1730x322,951.042.5696x446,jessica73@orozco.com,2021-10-05,https://www.wheeler.org/
25-Oct-2020,NEFT,00.00,"88,027.94","528,167.66",cbEb6A3Fd9DE268,9370,Sierra,Gray,"Norman, Vasquez and Mcclure",Port Beth,Cook Islands,299.341.2734x155,001-759-991-8409x17388,kentkrystal@hodge.com,2021-09-09,https://www.villa.biz/
25-Oct-2020,NEFT,00.00,"52,816.77","475,350.89",e9B2AdeaB0abcbd,8270,Sierra,Aguirre,"Sullivan, Bender and Welch",Singletontown,Saint Martin,(487)680-0755x234,001-872-264-9059,heather49@murillo.com,2021-06-25,https://reed.org/
25-Oct-2020,NEFT,00.00,"158,450.30","316,900.59",071FB5bDeddED3e,1089,Cassie,Esparza,Hurley Ltd,South Isaac,Hungary,(836)106-7704x0781,(047)009-4396x7867,ekirk@velazquez.com,2022-05-05,https://skinner.net/
25-Oct-2020,Interest,"3,188.00",00.00,"320,088.59",F47934cb9b80133,7564,Kyle,Mills,Elliott-Becker,Port Frances,Saudi Arabia,001-831-990-2887x7156,278.878.4154x6222,stephaniebarker@franklin-horne.com,2022-05-24,http://vance.org/
25-Oct-2020,Commission,00.00,"64,017.72","256,070.87",6FE085Fa4358e72,8438,Michael,Hodges,Fuentes PLC,Marissaland,Ireland,687-929-6903,284.586.3693x000,avilachris@blanchard-parrish.com,2021-02-12,https://www.mcclain.net/
25-Oct-2020,Commission,00.00,"25,607.09","230,463.78",55FDDDdfd6dECBb,1657,Diamond,Nunez,"Bartlett, Reynolds and Bryant",Port Kellieburgh,Iceland,+1-031-536-6371x7003,(464)948-6940,nashstephanie@gordon.com,2020-08-08,https://joyce.net/
25-Oct-2020,ATM,"103,080.00",00.00,"333,543.78",1188C7553bDB6cd,2717,Micheal,Knight,Barrett and Sons,East Rose,Croatia,294.648.9937x128,(274)483-1425,katherine15@elliott-warren.info,2021-07-22,http://hayes-crosby.com/
25-Oct-2020,Miscellaneous,00.00,"83,385.95","250,157.84",dabeFBadD80Eeec,2097,Erik,Hatfield,Frost-Marquez,East Dalton,Guatemala,326.359.9776,+1-731-976-9733,barbarasosa@cain.com,2020-09-24,http://hayes.com/
25-Oct-2020,Interest,00.00,"31,269.73","218,888.11",bBee657D390d6EE,3437,Carlos,Mcpherson,Stout-Pope,Port Cory,Gambia,001-692-913-9636,4331963297,zchristensen@crawford.info,2021-05-17,https://navarro.com/
25-Oct-2020,Cheque,95.70,00.00,"218,983.81",CF89d6ae45AAdFd,1406,Sheila,Riggs,Mathews-Morrow,Blakemouth,Botswana,283.826.5324,001-155-483-7686x2974,lhuffman@hancock.net,2022-05-09,https://www.bush.com/
26-Oct-2020,Cheque,00.00,"31,283.40","187,700.41",0AFbFCB4ce11B3d,2118,Frederick,Huynh,Phillips Ltd,Lake Spencerport,Trinidad and Tobago,556-206-5248x5864,001-323-973-3371x12697,garrett41@baxter-booker.com,2020-04-17,http://bender-daugherty.com/
26-Oct-2020,RTGS,19.00,00.00,"187,719.41",b166e7E8aBDFC1e,7789,Bruce,Phelps,Foster-Mccann,North Connie,Heard Island and McDonald Islands,841-510-9683x49631,(633)431-9751x778,craigrasmussen@kelly.info,2021-05-12,https://kelly.info/
26-Oct-2020,ATM,00.00,"18,771.94","168,947.47",f2D8A8c56DC14F3,6278,Erika,Schroeder,Hunt and Sons,Malikton,French Southern Territories,001-349-255-2457,522-179-4237x89945,sgoodman@kerr-knox.net,2020-02-10,https://www.dickson.net/
26-Oct-2020,Cash,00.00,"18,771.94","150,175.53",b080f9aa3ABdBFE,5340,Alexandra,Vazquez,Stephenson and Sons,North Kelli,Hungary,2451623774,(114)099-9944,katrinalamb@mendoza.info,2021-02-28,http://sims.net/
26-Oct-2020,NEFT,"20,182.84",00.00,"170,358.37",2F793FE9F443bDE,4146,Alexa,Espinoza,Lowe-Adams,Freemanhaven,Guernsey,001-219-060-0846x260,(713)737-3942x8748,aaron25@davis.com,2021-07-19,http://vang.com/
27-Oct-2020,Cash,06.11,00.00,"170,364.48",fd53b6BeE5f9f1c,9628,Donald,Meyer,Lara-Morrison,Tommyhaven,Nigeria,+1-833-617-4502x44612,679.760.3064x578,wwalter@dunlap-travis.com,2021-07-02,http://www.sanford-giles.com/
27-Oct-2020,NEFT,00.00,"42,591.12","127,773.36",75b2C2659e8DDbD,3286,Alicia,Tate,"Baird, Stevens and Escobar",West Dorothy,Austria,001-394-196-0158x0380,6395208379,paulgarcia@castro-vang.org,2021-05-02,http://www.schmitt-lutz.net/
27-Oct-2020,Reversal,13.00,00.00,"127,786.36",a148d10ADa3F44C,977,Chloe,Santana,Mullen and Sons,Perryton,Luxembourg,398-230-1204x985,717-011-4554x273,eduardo20@diaz.info,2020-08-19,http://lawrence.com/
27-Oct-2020,Cheque,18.00,00.00,"127,804.36",eb8a292F27CCF4b,2387,Larry,White,Gentry-Shelton,Tonichester,Myanmar,(716)645-1696,547.479.5803x390,lorrainekaufman@reid.com,2021-07-23,http://www.ray.com/
27-Oct-2020,IMPS,00.00,"25,560.87","102,243.49",Fe7f04F13c45dc0,7722,Gregory,Sosa,"Berry, Gonzales and Dougherty",East Mckenzie,Nicaragua,+1-372-110-5223,(937)681-0553x57595,heidikaiser@stark-shelton.net,2021-11-18,https://www.robles-phelps.com/
28-Oct-2020,Tax,"54,274.31",00.00,"156,517.80",Ad8aDAe2E93fC17,9847,Jeanette,Alvarez,Farrell-Mcpherson,Mannmouth,Bahrain,001-664-429-9452x1678,844.325.4530x9635,levi46@maxwell-morrison.biz,2020-03-04,http://www.mcdaniel.com/
28-Oct-2020,Miscellaneous,00.00,"156,517.80",00.00,B0fecEcD5b24d6A,623,Jill,Saunders,Haney-Lutz,Port Jasmin,Liberia,+1-791-579-4498x189,500.536.6575,riveraleah@caldwell.com,2020-10-06,https://www.rivas.org/
28-Oct-2020,Reversal,08.00,00.00,08.00,FCfbDF05Bc7a7c6,539,Andres,Kennedy,Conner Group,Port Kirsten,Falkland Islands (Malvinas),(482)286-3803,001-313-359-6200,kristen16@mcdonald.com,2022-02-16,https://aguirre.com/
28-Oct-2020,Transfer,568.00,00.00,576.00,6fFACdbF5d585c5,8222,Lindsay,Shields,Diaz-Wells,Grahamstad,Gabon,+1-414-211-3709x106,+1-051-084-3033,ecowan@mora.com,2020-11-23,http://donaldson.com/
28-Oct-2020,Reversal,"1,769,902.00",00.00,"1,770,478.00",d2818dAEDf74bA8,1342,Jermaine,Pope,Farrell-Reynolds,Oneillside,Somalia,(200)410-1107x339,400.727.3268x172,onewman@rocha-juarez.net,2020-12-28,http://ayers-zimmerman.com/
28-Oct-2020,Reversal,00.00,"590,159.33","1,180,318.67",ABCFefFaDAc5F2C,1297,Judith,Abbott,Potter-Haney,Lake Evanberg,San Marino,(803)522-0695,8758726874,alyssajuarez@villanueva.com,2020-04-14,https://gates.com/
28-Oct-2020,Tax,186.50,00.00,"1,180,505.17",C9dAB363AD3Fabe,6105,Mandy,Bailey,"Chaney, Hatfield and Rodgers",Lake Priscilla,Kiribati,001-120-616-7144x31841,001-458-872-0400x6180,trevor38@buckley.com,2021-04-27,https://www.holmes.com/
28-Oct-2020,Purchase,"2,017,450.75",00.00,"3,197,955.92",4cC5f64DA8dd420,1831,Tonya,Greene,Waters-Tanner,Caseland,Saint Vincent and the Grenadines,+1-849-482-4087x91427,(361)556-0172x0811,joseph42@woodard.org,2020-05-14,http://strong.info/
28-Oct-2020,Reversal,00.00,"799,488.98","2,398,466.94",A043Ae9f07Cb9F8,1434,Briana,Winters,"Buckley, Ware and Dixon",Vernonville,Niue,(879)494-5896,(096)169-3103,wwong@blackburn-holt.com,2022-03-10,http://johnston-orozco.com/
28-Oct-2020,IMPS,"1,519.00",00.00,"2,399,985.94",c25C9c8F6FeCBa4,378,Sydney,Edwards,Hines LLC,New Emma,Denmark,(944)427-1207,050.915.6610x8821,flemingvernon@bean-le.com,2020-04-03,https://www.gibson.com/
29-Oct-2020,Reversal,00.00,"299,998.24","2,099,987.70",ebC4De12FAde3Ad,6523,Harold,Kline,"Bentley, Mckee and Ford",Olivialand,Gabon,001-536-548-7402,(427)121-8236x93734,mark60@beasley.org,2020-03-24,http://barrett-downs.com/
29-Oct-2020,IMPS,843.00,00.00,"2,100,830.70",e4aeF985Db6e3Bb,2943,Dalton,Blanchard,Jackson LLC,West Melody,Timor-Leste,319.531.8769x7938,+1-065-194-3631x5369,logan88@krueger.com,2021-06-10,https://www.oneill-brady.com/
29-Oct-2020,Commission,07.70,00.00,"2,100,838.40",f7cD5c6a57e5ADF,6113,Joyce,Holt,Pierce and Sons,Ericborough,Madagascar,490-215-6670x0768,001-370-480-9473x242,tammy11@krueger.com,2021-11-09,http://www.richard-conway.org/
29-Oct-2020,Interest,00.00,"233,426.49","1,867,411.91",a8eC9494e9CCb46,9992,Christy,Wilkinson,"Gray, Ponce and Hayden",South Jillian,Austria,342-307-9452,001-070-026-2258x071,amandaharrell@ballard.biz,2021-10-22,http://petty-acosta.com/
29-Oct-2020,Cash,00.00,"266,773.13","1,600,638.78",00267CCcC317c9e,7598,Francisco,Morales,Barnett-Sharp,Lake Sharonfurt,Vanuatu,550.140.3873x31060,4011295824,lschultz@palmer.org,2020-12-05,http://www.little.net/
29-Oct-2020,IMPS,14.18,00.00,"1,600,652.96",eC64EbD80c47a4b,9940,Cassidy,Mcguire,Mills and Sons,Weissburgh,Denmark,2015999761,001-232-493-0973x12053,isabella74@costa.org,2020-10-23,http://www.mason.com/
29-Oct-2020,Reversal,"22,480.98",00.00,"1,623,133.94",dcD492fA78e8Dd0,4778,Adam,Rasmussen,Rojas and Sons,Gavinview,Slovakia (Slovak Republic),+1-186-788-3741x145,+1-009-016-9189x958,kmays@vincent.info,2021-08-07,https://mcdowell.info/
29-Oct-2020,Commission,00.00,"162,313.39","1,460,820.55",ecBa8Cb9B6b7A8D,3503,Olivia,Hampton,Mosley Ltd,Salasfort,Togo,001-192-245-8043x525,+1-699-695-8279x406,lucerogwendolyn@reid-sutton.com,2022-01-18,http://www.gregory.com/
29-Oct-2020,Bill,419.88,00.00,"1,461,240.43",0BD982882c05Fe1,9496,Kristen,Melton,Ruiz Group,South Susanside,Saint Barthelemy,427-552-2205x683,5205235651,villegasdustin@potter.com,2022-02-15,http://www.salas-lopez.org/
29-Oct-2020,Purchase,00.00,"146,124.04","1,315,116.39",39EaF5ac3a30efE,7007,Alex,Barrett,"Rivera, Holmes and Carey",Kathrynside,Oman,+1-292-874-6013x76596,(871)032-9340x635,xmorales@munoz.com,2021-01-03,https://www.baird.com/
29-Oct-2020,Bill,00.00,"187,873.77","1,127,242.62",1F7cF53c7ebFc3D,408,Francis,Bradford,Contreras PLC,New Hayley,Sudan,(266)493-2713x08961,241.387.2339x4572,alejandra14@quinn.com,2022-01-11,http://maynard.com/
29-Oct-2020,ATM,00.00,"125,249.18","1,001,993.44",81edA8bf788Fb5D,4284,Barbara,Duke,Mayer PLC,West Tylerport,Mali,+1-603-025-9942x6515,(886)335-1044x223,krivas@eaton-stanton.com,2020-12-03,https://www.acosta.com/
29-Oct-2020,ATM,82.50,00.00,"1,002,075.94",76EdEe5baEBEc5B,3709,Mario,Wise,"Norton, Harrington and Tate",Nguyenhaven,Syrian Arab Republic,144-270-5826x07621,(593)104-7360x8991,whansen@mckee.com,2020-05-25,http://thomas-dougherty.org/
29-Oct-2020,RTGS,90.98,00.00,"1,002,166.92",B3a7dbC2CaBD55e,1996,Jackson,Fitzgerald,"Nelson, Bates and Arias",Daltonstad,South Africa,046-079-7300,687-842-3722x547,savageeddie@wells-villa.com,2021-07-16,https://www.santana.com/
29-Oct-2020,Interest,00.00,"111,351.88","890,815.04",Fa08f2adbDa958a,6981,Travis,Duffy,"Chen, Shea and King",East Miafort,San Marino,134.270.0119x570,852.359.1371,pearsonalexandra@mcfarland-frye.biz,2021-04-08,http://hanson.info/
29-Oct-2020,Commission,00.00,"296,938.35","593,876.69",803e5ed400fF3AF,1623,Bobby,Cervantes,Hicks-Hoover,East Levi,South Georgia and the South Sandwich Islands,001-432-239-2866x38094,8505627187,gabriela69@thomas.com,2020-08-09,https://www.rios-morgan.com/
29-Oct-2020,RTGS,"2,013,326.00",00.00,"2,607,202.69",CFf86B15D85dBD1,4469,Gwendolyn,Lutz,Schmidt Ltd,Port Bryan,Congo,195-867-1828,(991)359-5176x666,richardfarley@bender-sloan.com,2021-01-05,http://mathis-norton.com/
29-Oct-2020,Commission,00.00,"521,440.54","2,085,762.15",e090f2CAF78D1fa,2497,Erica,Sloan,Rowland LLC,West Noahview,Botswana,+1-092-286-3619x944,001-666-132-2734x6100,hendrixshelby@gallagher-villanueva.com,2021-12-15,http://vargas.com/
29-Oct-2020,Debit Card,00.00,"695,254.05","1,390,508.10",DAFE4aEB6c2eD69,4876,Kaitlyn,May,"Guerra, Washington and Mcfarland",Port Sheliaberg,Benin,(121)530-1014x978,451-217-2296x76566,jimmyanderson@casey-liu.com,2020-09-01,http://www.terrell.biz/
29-Oct-2020,Cash,00.00,"695,254.05","695,254.05",fEbD9DF696e83E4,2331,Russell,Benitez,Rodgers-Gilbert,Hendersonmouth,Macao,741.664.5984x79479,+1-049-168-4965x79444,lcarson@schmitt.biz,2020-07-31,http://booth.org/
29-Oct-2020,ATM,00.00,"139,050.81","556,203.24",bA939dE996CF4BF,1495,Ian,Pennington,Roy-Riggs,West Patrick,Algeria,+1-500-645-4371,999.108.0534x8807,danielewing@mcgrath-dunn.com,2021-05-09,https://bond.info/
29-Oct-2020,Interest,"495,357.00",00.00,"1,051,560.24",7B0CCfAbfC9f2AE,8470,Krystal,Summers,"Mcfarland, Mitchell and Yoder",North Terranceside,Estonia,001-231-095-0722,(421)083-1666,dustin31@herrera-avila.com,2022-02-24,http://www.werner-gardner.net/
29-Oct-2020,Miscellaneous,45.00,00.00,"1,051,605.24",B7C8Ac33DcDA629,166,Patty,Estes,Potter-Doyle,Lake Johnathanborough,Mozambique,555.786.9024x8126,(526)826-8221x0813,vincent58@norton.com,2021-02-08,https://www.mendez-duran.com/
29-Oct-2020,Transfer,00.00,"116,845.03","934,760.21",cb4BD5bD4D661C3,4638,Isabella,Mccullough,"Griffin, Palmer and Ray",North Cheryltown,Cayman Islands,001-370-997-0972,001-597-044-7808,brad02@mclaughlin.com,2021-10-12,https://www.obrien.com/
29-Oct-2020,IMPS,"98,096.50",00.00,"1,032,856.71",E4B6Ba2F9b8358D,5225,Collin,Sweeney,"Sexton, Krueger and Levy",Rosemouth,Benin,(624)273-9813x89833,(191)925-5904,franciscovargas@wilkerson-ryan.biz,2022-03-18,http://foster.com/
29-Oct-2020,Bill,00.00,"344,285.57","688,571.14",f2BcB41D5d1BE28,7187,Jackie,Gamble,"Bruce, Harper and Shelton",North Marcobury,Nepal,888-502-5416x717,214-090-7087x136,ericprice@andrade.com,2021-01-24,http://chambers-ashley.com/
29-Oct-2020,IMPS,00.00,"344,285.57","344,285.57",dcfAfBdf61cEFBB,8630,Ruth,Brewer,Clay-Cisneros,North Joburgh,Korea,+1-305-702-0894x344,+1-328-369-5423,kentanthony@mosley.com,2021-08-25,http://www.chavez.com/
29-Oct-2020,Bill,00.00,"344,285.57",00.00,1a030C658EC6b5F,6932,Jenna,Mcclure,Galvan-Rosales,New Isabellaburgh,Lao People's Democratic Republic,001-631-149-6657,(216)957-6215,kingerik@yang.info,2020-03-29,http://www.salazar.org/
29-Oct-2020,Bill,"721,519.00",00.00,"721,519.00",dB9f0CDE30628DE,6185,Leah,Cowan,Woodard Group,Morseport,Burkina Faso,636.466.0262,498.078.8081x43224,faith08@bray-riddle.org,2020-01-27,https://www.mitchell.biz/
29-Oct-2020,IMPS,00.00,"240,506.33","481,012.67",C5FbA08308f596b,7982,Melinda,Fields,Vang-Ochoa,Dixonton,Montenegro,034-808-3993x2357,546.919.6522x77779,cody03@webster-vance.com,2021-12-02,https://www.kelly.com/
29-Oct-2020,Cheque,00.00,"120,253.17","360,759.50",FA1BAa4BabCD83A,4225,Tony,Huang,Abbott-Pena,Boothfort,Syrian Arab Republic,884.384.2903x23861,010-516-8943,michele72@garrett.org,2020-07-04,http://www.newman.org/
29-Oct-2020,Cash,00.00,"51,537.07","309,222.43",95299c08e6C0a9D,6419,Gordon,Lindsey,Bray-Small,East Aimee,Angola,(711)940-7991,+1-003-005-2217x25865,santosnathaniel@glover-patel.com,2020-06-19,https://www.bernard.info/
29-Oct-2020,Transfer,"1,968.00",00.00,"311,190.43",538Bdaef89F7672,96,Elaine,Hendrix,"Goodwin, Lambert and Lowery",South Veronicafurt,Fiji,3010334267,111-173-4785x11133,maureen18@barr.org,2020-12-24,http://mccarty-meza.info/
29-Oct-2020,Commission,513.29,00.00,"311,703.72",aC3CC586cfEbF6B,6802,Latoya,Avila,Cuevas-Boyer,Lake Erikfort,Pakistan,593.570.1320x32993,(229)029-5391,anthonyfischer@yoder.info,2021-11-01,https://www.herring.com/
29-Oct-2020,Bill,07.00,00.00,"311,710.72",7dBbE5Fe53DD9D2,5981,Logan,Pham,Rich LLC,West Oscarchester,Rwanda,001-600-457-2788,(819)815-0306x59513,mortonterrance@graham-foley.biz,2021-01-04,http://www.medina.info/
29-Oct-2020,RTGS,503.93,00.00,"312,214.65",CcC907c6eCC1D67,8445,Peter,Norman,"Lawrence, Frye and Bradshaw",North Yolanda,Cape Verde,+1-522-587-2128x0374,234.105.0576x5051,cody10@flores-kelly.com,2021-10-04,https://jimenez.info/
29-Oct-2020,Debit Card,"27,652.58",00.00,"339,867.23",baBDfE3ACE109be,8924,Mikayla,Roach,Yang-Alvarado,East Karen,Chad,(287)827-6054x274,7878571847,dpowers@wolfe.org,2020-12-18,https://caldwell.com/
29-Oct-2020,Tax,00.00,"48,552.46","291,314.77",b2DafC2bD849F4b,8130,Marissa,Roberts,"Rivera, Cabrera and Meyer",Shawnburgh,Senegal,+1-984-442-0921x7473,102-340-8844,ebonymathis@small.net,2020-11-18,http://www.fuentes.com/
29-Oct-2020,Cheque,00.00,"145,657.39","145,657.38",E487E76fa55e7a0,4536,Deborah,Buck,"Gonzales, Kline and Moore",Aguirreburgh,Senegal,+1-354-196-1458x54828,(660)752-6621x11121,pettysean@golden.org,2020-01-16,https://cisneros.net/
29-Oct-2020,Debit Card,00.00,"16,184.15","129,473.23",Aa920beB51C3dEe,4383,Malik,Orozco,Richard-Cochran,Taraland,Haiti,494-882-4525,188-291-6539x6081,ashleehickman@norris.com,2022-02-26,https://www.valencia.info/
29-Oct-2020,Reversal,00.00,"12,947.32","116,525.91",75578FB58Dcfe6E,5474,Margaret,Casey,Maxwell Inc,Port Erinville,United Kingdom,001-429-525-8997x7292,156.138.8305,bethany89@hartman.com,2021-05-25,https://evans.com/
29-Oct-2020,Cash,"1,864,732.00",00.00,"1,981,257.91",71F1Bd8C5f80Ca7,8282,Anne,Branch,"Pruitt, Mcclure and Gordon",Petersenstad,Estonia,+1-368-672-0701,+1-083-203-1136x096,wwhitaker@mitchell.org,2020-09-14,https://www.payne-chan.com/
29-Oct-2020,Cash,00.00,"990,628.96","990,628.96",E8F27Bb9e2bf1C6,3161,Duane,Ward,Torres LLC,East Patriciaborough,Heard Island and McDonald Islands,556-612-5431,123.125.5585x879,stacielittle@kirk.biz,2021-08-26,http://bernard.com/
29-Oct-2020,Interest,00.00,"110,069.88","880,559.08",86DFA57E6c7cDDd,9324,Hunter,Maynard,Baird-Sandoval,Timothystad,Costa Rica,5056175641,737.334.4381,mitchell21@graham.biz,2022-04-26,http://roy.org/
29-Oct-2020,Tax,00.00,"293,519.69","587,039.39",D7eED7FEFeB5cFe,7756,Douglas,Mitchell,Myers-Montoya,Christieside,Nigeria,+1-543-834-2230,(599)695-2927,rileymanuel@chen.com,2022-01-16,http://www.guzman.biz/
30-Oct-2020,NEFT,00.00,"65,226.60","521,812.79",dd6fc2216aE3cc9,5725,Stacey,Allison,Blanchard Group,Donaldchester,Netherlands Antilles,212-658-3367x088,272.715.9788,serranotasha@watson.com,2021-08-22,https://hopkins-yates.com/
30-Oct-2020,Debit Card,00.00,"74,544.68","447,268.11",d7a1c828dc04Ff7,515,Bonnie,Booker,"Pearson, Hubbard and Alvarez",South Christine,India,6961498901,412-244-1070x4570,penafrancisco@flowers.org,2021-02-25,https://gray-bowers.net/
30-Oct-2020,Interest,"2,679.80",00.00,"449,947.91",DbCdEc4b7aa13e3,7174,Deborah,Bush,Webb LLC,Sweeneychester,Falkland Islands (Malvinas),(716)311-5808,(940)279-7031x73044,gstafford@kline-shepard.com,2020-12-26,http://leon.com/
30-Oct-2020,NEFT,00.00,"64,278.27","385,669.64",D7ffdaBD6d1E492,6460,Harold,Davidson,"Conley, Bolton and Lucas",Gilbertstad,Czech Republic,181-662-5793,844-432-6174x4741,whitney04@peters-brewer.com,2022-02-26,http://www.mcintosh.com/
30-Oct-2020,Bill,"1,656,865.80",00.00,"2,042,535.44",9b70DDbA0fa6Def,5656,Dustin,Walsh,Murray and Sons,Chaneybury,Martinique,3168912917,(172)215-1305x32180,vickifranklin@kennedy-stephenson.info,2022-04-16,https://wilkinson.com/
30-Oct-2020,Bill,"92,824.90",00.00,"2,135,360.34",15aCEa7A1429dbB,6317,Warren,Schneider,Crosby and Sons,Jorgeville,Egypt,001-490-286-3089x440,+1-699-439-5730x049,ibauer@nguyen.com,2021-02-20,http://www.salazar.com/
30-Oct-2020,Purchase,"1,309,383.25",00.00,"3,444,743.59",AAfafCeF567c6BD,2701,Roger,Walters,Klein Inc,Hollowaystad,Vanuatu,486-839-2532x401,325.138.8648,courtney74@eaton.net,2021-08-24,https://www.acevedo.biz/
30-Oct-2020,ATM,00.00,"1,722,371.80","1,722,371.80",b5CdCc5dfB1821f,5793,Marcia,Bailey,Newman-Richardson,North Faith,Christmas Island,001-390-043-9251,001-433-047-5520,murillostephanie@whitaker-griffith.com,2021-02-05,https://www.woods-freeman.com/
30-Oct-2020,ATM,00.00,"215,296.48","1,507,075.32",1aBF7f8f5bE294c,2648,George,Giles,Woodward and Sons,Gilesview,Jersey,(376)267-0467x343,001-703-256-0245,zmcintyre@conley.com,2021-01-01,http://moody.com/
30-Oct-2020,Tax,"1,526,978.50",00.00,"3,034,053.82",ecCf3AB3616FA2A,3214,Mason,Baldwin,Short-Stephens,West Mindy,Palestinian Territory,+1-377-070-8117x83481,144-313-4185x3612,cunninghammicheal@stewart.com,2020-12-02,http://www.atkinson.com/
30-Oct-2020,Reversal,00.00,"337,117.09","2,696,936.73",C634aa2E042eCBB,7160,Darlene,Schaefer,Powers-Hartman,Clintonfurt,Liberia,001-058-976-2993,276.000.3656x46584,terristeele@lowe-chen.com,2020-08-23,https://curry.biz/
30-Oct-2020,Cheque,56.00,00.00,"2,696,992.73",b7beEa7fDE4eBb9,454,Jaclyn,Cardenas,"Noble, Downs and Knapp",Port Traci,Hong Kong,211-550-6047x8207,+1-193-800-2383x083,phebert@farmer.com,2022-03-24,https://hinton.com/
30-Oct-2020,Miscellaneous,"1,135.00",00.00,"2,698,127.73",33109D4a0173C75,1653,Kristopher,Mcmahon,"Clay, Hodge and Andrade",Lake Charlesside,Andorra,001-899-611-5856x118,001-632-770-8961,kyliemartinez@webster.net,2020-01-18,http://greene.biz/
30-Oct-2020,ATM,00.00,"674,531.93","2,023,595.80",98bF938AbFa3Aab,3655,Candace,Gilmore,Esparza Ltd,Terryberg,Wallis and Futuna,2610336041,+1-001-883-0834x2378,elliottmichaela@jones.com,2021-06-03,http://www.delacruz.com/
30-Oct-2020,ATM,04.10,00.00,"2,023,599.90",A0c82B2Ef6d3EaC,8921,Madeline,Woodard,Dodson-Flores,Howellbury,Netherlands,+1-863-491-8049,131.985.5308x4406,uadkins@ramsey.info,2020-04-09,https://www.joseph.com/
30-Oct-2020,ATM,"508,999.00",00.00,"2,532,598.90",d9b2f57eFb30259,955,Geoffrey,Compton,"Elliott, Richard and Nash",West Roy,Saint Kitts and Nevis,856.190.1560x87787,947.702.8297x066,cobbronnie@potter.com,2020-10-27,https://www.hansen.com/
30-Oct-2020,Cash,00.00,"422,099.82","2,110,499.08",d374A475969b53D,8075,Alfred,Lynn,Meyer PLC,Sandratown,Fiji,094-448-9347x1663,001-220-376-8196x6341,darren35@cardenas-byrd.com,2022-05-05,https://www.petersen.biz/
30-Oct-2020,Cash,04.40,00.00,"2,110,503.48",0F22271c8046fc3,1311,Gloria,Kidd,Mack Ltd,New Carol,Tonga,2223600964,+1-049-985-5194x4283,rebecca56@taylor-acosta.info,2020-04-23,http://castro.net/
30-Oct-2020,Cash,159.00,00.00,"2,110,662.48",22Db27d1A4622fB,8440,Reginald,Hurst,"Nunez, Pugh and Travis",Rivasmouth,Christmas Island,072.396.7117x201,(795)653-0560x0815,gregorymyers@odonnell-bryan.biz,2021-10-04,http://ward.net/
30-Oct-2020,ATM,60.00,00.00,"2,110,722.48",c69D4ddf5e0C3B3,3677,William,Farrell,"Zamora, Butler and Lozano",Drakeland,Bangladesh,+1-491-496-5204x967,572.440.9062x095,wernergarrett@trevino.org,2020-12-25,https://www.prince.com/
30-Oct-2020,ATM,00.00,"2,110,722.48",00.00,A6ad35DADECf47d,5789,Tamara,Montoya,Hinton-Carpenter,South Sheena,Rwanda,616.431.7352x4023,001-786-213-4921x3290,katie37@romero-mcdaniel.com,2020-09-24,https://www.fleming.com/
30-Oct-2020,RTGS,06.62,00.00,06.62,Bf3Bc19ed8deBe2,7054,George,Terrell,"Brandt, Torres and Stein",South Hailey,French Guiana,(879)372-8159,(971)947-5740x619,curtisshepard@wiggins.com,2020-02-25,http://www.dalton-leonard.com/
30-Oct-2020,NEFT,"1,926.00",00.00,"1,932.62",f5aC968bBF0e2fB,2890,Kenneth,Yu,"Forbes, Ellis and Michael",Lake Krystal,Estonia,1761914290,+1-363-018-1257x7158,alexaochoa@woodward.info,2022-01-28,http://www.vasquez.com/
30-Oct-2020,ATM,00.00,276.09,"1,656.53",0f769DC4FdB0c1D,3838,Mary,Duffy,Caldwell-Kelley,Audreyborough,Lao People's Democratic Republic,+1-022-004-3995x8343,001-692-908-5867,tcummings@barr.org,2021-12-05,http://www.olson.com/
30-Oct-2020,Cash,00.00,414.13,"1,242.40",5E7e1AeBC968a7C,5301,Mallory,Hunter,Durham PLC,Kaitlynville,Saudi Arabia,001-725-338-3759x6032,+1-189-543-8404,zmorgan@pineda.org,2022-05-19,https://www.cummings-stevenson.org/
30-Oct-2020,Debit Card,"1,732.47",00.00,"2,974.87",529e2b7ba1586E2,2841,Bob,Mcbride,Estrada-Ho,East Joyce,French Polynesia,1299351014,(526)325-3839x1431,raymondpaige@khan.org,2020-07-08,http://www.massey.com/
30-Oct-2020,Tax,01.10,00.00,"2,975.97",Fbe6BC97a0C2Ba3,3193,Jorge,Owen,Nixon PLC,South Christianview,Lebanon,249-752-1605,(325)715-3524x5298,dtyler@bell-bailey.com,2021-02-12,http://www.adams.net/
30-Oct-2020,Commission,00.00,496.00,"2,479.98",f0DAF3e0CCD0f1C,6437,Elijah,Bush,Cuevas Ltd,East Jerome,Ireland,+1-301-827-0954x2343,4884648542,cruzcory@romero.com,2021-12-09,https://www.shelton.com/
31-Oct-2020,IMPS,"1,868.80",00.00,"4,348.78",b2729cce9390e94,7256,Alec,Mayo,"Wade, Stuart and Charles",Thomasport,Indonesia,140-002-3731x05445,(486)905-4334x2619,lsingleton@hubbard.com,2020-01-21,http://hampton.com/
31-Oct-2020,Transfer,"1,592,073.50",00.00,"1,596,422.28",257e43Fe37EE83d,3108,Jerry,Stevens,Phelps Inc,North Cliffordview,Philippines,616.434.0090x779,(406)539-6197x046,ccrawford@ramirez.com,2021-12-05,http://www.lester.org/
31-Oct-2020,Purchase,01.35,00.00,"1,596,423.63",EFCFF9bCf4bE381,8550,Terri,Carpenter,"Price, Shelton and Moody",West Melody,Panama,994.576.6188,001-945-177-9212x99993,vcarrillo@ritter.com,2020-01-12,https://www.gibbs.com/
31-Oct-2020,Debit Card,"169,350.38",00.00,"1,765,774.01",1cE2C6FDDBbaD50,4951,Melody,Huff,"Paul, Mckinney and Macdonald",West Rogerhaven,Morocco,742.901.7887,584-662-0098x4681,grhodes@salas.com,2021-06-08,http://www.jensen.com/
01-Nov-2020,Commission,"26,815.61",00.00,"1,792,589.62",A561A1Dad20de31,7122,Misty,Mullen,"Reynolds, Mullins and Stuart",West Kristopherville,Norfolk Island,+1-896-335-7040,(761)948-0969,christieperez@long-briggs.net,2020-04-17,http://juarez-carney.com/
01-Nov-2020,Debit Card,00.00,"179,258.96","1,613,330.66",CF1C6b51A58C0aD,5476,Trevor,Strong,"Kaufman, Baker and Mendez",Xaviershire,Turkmenistan,7900361682,001-230-845-1088x5381,gavinfinley@bauer.com,2022-02-22,https://www.chang-cook.info/
01-Nov-2020,Transfer,00.00,"201,666.33","1,411,664.33",5a3Ed08524aA9CA,423,Cole,Byrd,Dillon-Perry,Hansenhaven,Aruba,+1-987-530-4402x2205,958-830-8852x883,obrienisabel@braun.com,2020-02-01,http://hudson.com/
01-Nov-2020,RTGS,00.00,"235,277.39","1,176,386.94",Df12bAEF5EE5baf,3966,Autumn,Galloway,Keller-Quinn,Port Lori,Maldives,001-908-885-5126,714-532-9173x425,gordonabbott@carson-robles.com,2020-09-06,http://perkins.com/
01-Nov-2020,Tax,"130,599.20",00.00,"1,306,986.14",13bDCB4C94342fA,2951,Tabitha,Maynard,Bennett LLC,North Brad,Macedonia,(046)638-2955x623,(435)615-1815,uprice@christian.net,2020-12-23,http://www.bonilla-rodgers.com/
01-Nov-2020,Purchase,00.00,"326,746.54","980,239.60",39C3B95bD6e0B04,503,Eileen,Holden,Shepard-Wells,Teresabury,Burundi,100-973-1145,+1-466-376-5355x08019,nichole01@clarke.com,2020-01-15,https://www.fuller.org/
01-Nov-2020,Debit Card,"108,107.90",00.00,"1,088,347.50",EAfBF262Df9E2fb,4079,Darlene,Horton,Benton and Sons,North Danny,Vanuatu,575.104.9648,220-882-6455,gavinriggs@maxwell.com,2021-08-26,https://www.becker.net/
01-Nov-2020,Transfer,06.14,00.00,"1,088,353.64",D2FbAeD7Ba92C14,2405,Abigail,Irwin,"Cross, Faulkner and Gross",Troyfort,Israel,4397995127,+1-809-338-4344x3263,bethanyestes@peck.com,2021-05-30,https://www.schaefer-rivera.com/
01-Nov-2020,RTGS,00.00,"120,928.18","967,425.46",cB6bAeb78dfac1f,2776,Damon,Rosario,Valencia-Moran,Coreychester,Myanmar,5287278408,001-977-243-3119x0987,jeffrey24@mccoy.com,2020-06-25,http://www.rosales.com/
01-Nov-2020,Interest,00.00,"967,425.46",00.00,7f8049e6324ED3e,2469,Tyler,Woodard,"Leon, Harrington and Mcintosh",Francesville,Micronesia,549.782.9473x892,001-629-745-8395x095,maxwellmarks@mayer-carey.com,2020-07-20,http://www.zhang.com/
01-Nov-2020,ATM,47.32,00.00,47.32,CCEF2Aa8B663F5E,1702,Lacey,Madden,"Wheeler, Sandoval and Gay",New Daniel,Estonia,437.467.6644x7230,940-053-3708x2393,zmaldonado@bass.com,2022-01-31,http://www.maldonado-armstrong.net/
01-Nov-2020,Miscellaneous,"453,428.00",00.00,"453,475.32",bd25EBD4ebf2C1d,3804,Courtney,Underwood,Robinson Inc,Terrellburgh,El Salvador,563-006-8236x186,001-524-355-3272x12845,rose11@knapp.info,2021-05-28,https://www.mcconnell.com/
01-Nov-2020,Tax,"215,608.00",00.00,"669,083.32",D858C7bfCa1cCb5,8795,Dave,Juarez,"Whitney, Russell and Massey",Lake Alejandro,Paraguay,+1-018-954-1808x1042,001-524-154-7180x8776,richardsonglen@brown.info,2021-02-03,http://gross-donaldson.com/
01-Nov-2020,Debit Card,"5,406.80",00.00,"674,490.12",9E4b0DD1C2B3C75,3210,Alexander,Navarro,Chase-Wilkins,Paynemouth,Uganda,707-146-2865,001-821-174-1865x56850,rollinseugene@wilcox.org,2020-08-22,https://www.espinoza.com/
01-Nov-2020,IMPS,00.00,"134,898.02","539,592.10",7fF7cc1A7E54DEB,8747,Chelsea,Forbes,Silva Ltd,Jordanshire,Liechtenstein,+1-000-143-3002x758,(231)273-9274x06784,kelseymontoya@roberts.com,2020-10-31,http://www.robles.com/
01-Nov-2020,ATM,06.00,00.00,"539,598.10",50f7D8E02dfB621,5524,Bill,Richards,Novak-Long,Byrdburgh,Switzerland,329-543-1121,+1-942-902-4458x281,lekellie@christensen-lam.org,2020-04-08,http://www.cooper.biz/
01-Nov-2020,Purchase,03.10,00.00,"539,601.20",Fc7a6097AAa657F,9770,Ian,Luna,"Hurley, Myers and Day",Duncanmouth,Northern Mariana Islands,001-926-079-7907x897,044.030.2200,kmonroe@ellison-shepard.com,2020-02-18,https://roberson.net/
01-Nov-2020,Tax,"189,438.06",00.00,"729,039.26",E3c7AD5Cde565cD,2516,Jesse,Marsh,May-Conley,Mcphersonshire,Marshall Islands,284-935-1119,505.619.7710,gabrielroach@jefferson-savage.info,2020-12-18,http://hardin.com/
01-Nov-2020,Debit Card,15.66,00.00,"729,054.92",AB78B6C32E16E6e,3649,Duane,Sosa,Martin LLC,New Jay,Andorra,(551)354-5347x543,+1-022-846-8813x4354,bullockshari@roth.info,2021-08-20,http://chandler-alexander.info/
01-Nov-2020,Cheque,00.00,"72,905.49","656,149.43",7Ed614755a6fB40,9093,Adrienne,Grimes,Conley-Massey,West Carmenside,Cook Islands,001-470-380-0001x26435,(507)481-5526x599,daltonguzman@townsend.com,2021-08-13,https://www.duffy-oconnor.org/
01-Nov-2020,Debit Card,00.00,"82,018.68","574,130.75",D9544D1Ba89D1c8,2545,Perry,Moody,Evans Ltd,North Susanmouth,Israel,943-114-1789,049.390.4695x7828,harperalfred@ford.info,2021-03-25,https://www.roberts.com/
01-Nov-2020,Debit Card,00.00,"63,792.31","510,338.44",d2DA1E92A7bEF4e,1003,Kathy,Dougherty,Cherry and Sons,Port Yvette,Costa Rica,503-427-4245x167,+1-469-698-5615x924,ricardo01@jones.com,2020-07-07,http://www.fletcher-beasley.info/
01-Nov-2020,Commission,398.80,00.00,"510,737.24",3f8a76c2CA8D3Dc,6634,Joy,Sawyer,Gould Ltd,North Marthafort,Papua New Guinea,605-277-2028,+1-782-983-1947,hamptonamanda@chavez-bender.com,2021-04-13,http://fischer-patton.com/
01-Nov-2020,Cash,00.00,"56,748.58","453,988.66",BD6eAcf3766539A,7463,Madeline,Lawson,"Rowland, Calderon and Davis",North Mercedes,Palestinian Territory,081-145-4613x473,+1-276-313-8392,foleyallen@chase-sellers.com,2021-12-31,http://www.luna.org/
01-Nov-2020,Cash,444.10,00.00,"454,432.76",5e4500A6D8f7e1F,6331,Nina,Knapp,Fleming-Mclean,South Hunter,Reunion,747.970.2386,969.292.2500x581,malik18@hancock.info,2020-01-31,https://pruitt.net/
01-Nov-2020,Reversal,00.00,"113,608.19","340,824.57",BDCCEdccFd0FB6a,78,Jillian,Ortiz,Bean-Fuentes,Josephtown,Israel,+1-696-155-3546,001-790-882-2468x3663,hsantos@lopez.info,2020-05-21,http://whitehead.info/
01-Nov-2020,Cheque,"196,301.80",00.00,"537,126.37",374c11F0c3204Bf,6229,Shaun,Freeman,Floyd-Little,South Kristen,Sri Lanka,+1-533-672-4377x32688,+1-142-039-2853x306,weberbeverly@forbes-brennan.com,2020-12-18,http://www.lynn.com/
01-Nov-2020,ATM,00.00,"134,281.59","402,844.78",EAb90cc4a23D5d1,5021,Troy,Melendez,Norman-Malone,East Daisy,India,898-747-4280x64816,001-224-413-0553x6502,jasminpatel@callahan.com,2022-05-26,https://mosley.com/
01-Nov-2020,Cheque,00.00,"201,422.39","201,422.39",91c6d84FDD1c92e,9484,Stacy,Francis,"Dennis, Haley and Morton",Christiefurt,Papua New Guinea,536-815-0342x47289,8259877351,fbarron@mack-mcgee.org,2021-08-06,https://davila.net/
01-Nov-2020,Cheque,00.00,"40,284.48","161,137.91",dDFe4C14d8FBfb8,9977,Chloe,White,Mcguire LLC,Kerryhaven,Guinea-Bissau,001-604-216-0584x442,9222541215,claire16@tapia-mcclain.com,2022-01-20,https://ferrell.com/
01-Nov-2020,NEFT,113.20,00.00,"161,251.11",baCA46b75Ef9463,3399,Christine,Burgess,"Ferrell, Mcintyre and Ortiz",Jessehaven,Timor-Leste,931.745.1458x6778,011-158-8126x19444,imclean@english.com,2021-05-24,http://www.stevens.com/
02-Nov-2020,IMPS,00.60,00.00,"161,251.71",a1F5BC70ef4AAfC,3367,Natasha,Hayes,Riley-Taylor,Tashaside,Bulgaria,001-433-991-3240x42563,895-508-8780x3821,arthur78@sandoval.com,2020-08-20,https://www.gallagher-levy.net/
02-Nov-2020,Tax,00.00,"17,916.86","143,334.85",7abBE6A996BEacd,6312,Gregg,Figueroa,"Callahan, Cuevas and Mcintosh",North Breanna,Antigua and Barbuda,(385)234-1824x07091,(351)703-9937x8945,arthurbell@henry.net,2020-12-18,https://marshall.com/
02-Nov-2020,Cash,"172,451.56",00.00,"315,786.41",A2ac71f11d7FEB6,7592,Lauren,Boyle,Braun-Turner,North Julieton,Barbados,1217939731,611.454.6479,marcus79@stanley.info,2021-07-28,https://www.guerra-holland.biz/
03-Nov-2020,IMPS,"1,150.00",00.00,"316,936.41",c7887Dc6dCaB2B0,9658,Kendra,Porter,Cooke and Sons,Lisaton,Turks and Caicos Islands,001-983-685-8519,+1-121-299-0250x918,chelseycrosby@day.com,2022-04-12,https://hahn.info/
03-Nov-2020,Commission,20.38,00.00,"316,956.79",BA91E6aDE5197fE,2846,Ray,Richards,Frost LLC,Port Jefferyberg,Georgia,321.913.6196,916.486.4599x5255,faith91@hart.info,2022-05-25,https://www.wolfe.com/
03-Nov-2020,Interest,"705,106.00",00.00,"1,022,062.79",9A7BCcfa837a79B,6505,Chelsey,Cline,"Levine, Bautista and Mercado",New Tina,Russian Federation,001-972-796-7158x16142,550-154-4275x488,tpaul@stafford-roy.org,2022-01-25,http://www.esparza.com/
03-Nov-2020,Tax,05.60,00.00,"1,022,068.39",D9CDD5E18954C76,9205,Mariah,Chan,Mahoney Ltd,Morenohaven,British Virgin Islands,+1-736-830-7096,(426)133-3322x2451,katelynmoore@buck.org,2021-09-22,http://www.oconnell.org/
03-Nov-2020,Reversal,00.00,"340,689.46","681,378.93",95cc1154Bcde7C0,3543,Theodore,Ballard,Small Group,Conradside,Senegal,953.344.8530x030,001-652-994-1452x0264,baileyshea@crawford-meadows.net,2020-11-22,http://davila-hickman.com/
03-Nov-2020,ATM,00.00,"340,689.47","340,689.46",4BfFABCc1c0395B,4698,Christine,Banks,Ali Group,New Brandonbury,Saint Kitts and Nevis,434-679-2867x4013,276-699-7668x38925,stefanie43@freeman-lambert.com,2020-04-11,http://www.cervantes.com/
04-Nov-2020,IMPS,00.00,"340,689.46",00.00,dDFAF539ff9af4A,8735,Madison,Hooper,"Kemp, Blackburn and Powell",New Travisview,Jamaica,+1-021-482-4675x22608,(976)089-9297x5595,brojas@washington.info,2021-10-28,http://marks-mcneil.com/
04-Nov-2020,Commission,"95,022.30",00.00,"95,022.30",CAE849F59bd4a4c,3093,Lorraine,Mcdowell,Peterson-Austin,Port Henryfort,Botswana,966-109-4315,+1-014-952-6421x45767,vincent67@cobb.net,2020-09-25,https://www.daugherty.com/
04-Nov-2020,Commission,"8,630.91",00.00,"103,653.21",0dcC6dAACc869B7,5381,Isabella,Frye,"Knox, Berry and Fuller",Roweland,Pitcairn Islands,001-353-927-4056x87809,7753993697,wendy99@boone.com,2020-01-09,http://www.mason-johnston.com/
04-Nov-2020,Purchase,"262,156.00",00.00,"365,809.21",A1FBac2dDdA8F4C,6613,Peggy,Conley,Dudley and Sons,Domingueztown,Colombia,852-554-2833,202.645.4482,pkline@morris-francis.org,2020-01-15,https://padilla.info/
04-Nov-2020,Bill,350.80,00.00,"366,160.01",48aFE66C2B48b37,6984,Mariah,Alexander,Ochoa-Stokes,East Alexandria,Ecuador,098.228.3878,+1-005-517-4027x8693,carolyn61@preston.net,2020-12-13,https://aguirre.info/
04-Nov-2020,Transfer,178.90,00.00,"366,338.91",7ba27bAD9bc9F5c,7977,Ellen,Leach,Mueller PLC,Port Pedroview,Egypt,688.830.0429,584-099-6520,shaunbass@shields-swanson.biz,2021-08-10,https://www.padilla-lester.com/
04-Nov-2020,Reversal,"187,267.70",00.00,"553,606.61",aaDdB8bD9aEc74C,8505,Shannon,Duncan,Waller LLC,New Howard,Timor-Leste,697-936-5998,701.195.2540x146,michael05@gibbs-salazar.net,2020-04-18,https://www.reese.com/
04-Nov-2020,Cash,"1,671,159.00",00.00,"2,224,765.61",f18bab4Fc7D0C1E,9103,Connor,Reilly,Franco LLC,Ellisonchester,Puerto Rico,472.884.3868x0922,(626)436-9075x4483,banksclayton@tran.com,2021-01-15,http://ramirez.org/
04-Nov-2020,Cash,00.00,"317,823.66","1,906,941.95",7FC5Bf7cF6A4AdC,9762,Andres,Weber,"Wagner, Avila and Mcclain",Pageland,Haiti,001-571-346-7011x25367,440-780-8773x740,randybruce@lawson-lambert.com,2020-04-24,http://hoffman.biz/
04-Nov-2020,Tax,00.00,"272,420.28","1,634,521.67",611aEAdBbfEF2c0,9589,Erika,Johns,"Wolf, Richardson and Peterson",Lake Shannonfurt,Senegal,376.163.8940x1648,595.701.2126x4871,nathanwang@walton.com,2020-12-30,http://joyce.com/
04-Nov-2020,NEFT,299.00,00.00,"1,634,820.67",BB9FaB97933D3FE,8384,Joann,Wagner,Cruz Inc,North Dean,Marshall Islands,847.868.3556x6249,(689)121-1008x91274,jane38@patel.org,2020-07-28,https://www.patel-riggs.net/
04-Nov-2020,RTGS,08.92,00.00,"1,634,829.59",36C7F6ec70BF1EA,7087,Adriana,Bender,Hubbard-Mann,East Georgemouth,Jersey,001-151-781-6175x041,(474)996-2888x11400,hillgabriela@shepard-vang.com,2020-02-20,https://frazier-mendoza.biz/
04-Nov-2020,RTGS,468.00,00.00,"1,635,297.59",CfE63DEacDedAcA,8283,Jack,Vance,Franco PLC,West Benjamin,Congo,+1-943-161-1263,8686313223,changlatasha@everett.com,2020-12-07,http://www.silva.com/
04-Nov-2020,IMPS,477.32,00.00,"1,635,774.91",3af1dfda07dbaA0,1584,Reginald,Pope,Choi and Sons,East Jane,Sweden,544.251.4289,4353767616,christensengreg@stein-randolph.org,2020-03-22,https://everett-sloan.org/
04-Nov-2020,Miscellaneous,"30,339.05",00.00,"1,666,113.96",EFccAEF5E8cE89d,8328,Rickey,Riley,"Diaz, Pace and Wilcox",Adamsfurt,France,+1-397-487-2507x983,801.561.8222x081,kennethcummings@yoder.com,2020-11-08,http://www.arellano.org/
04-Nov-2020,Cash,45.00,00.00,"1,666,158.96",FAa3224ddbdE48c,8314,Cameron,Olson,"Hobbs, Hartman and Graves",South Seth,Luxembourg,+1-931-097-3543,+1-477-067-7089x2613,karen91@huffman-montgomery.com,2022-02-12,https://jarvis.net/
04-Nov-2020,IMPS,00.00,"1,666,158.96",00.00,701EC3F3Aa5EA1b,7262,Arthur,Stokes,Boyer and Sons,Port Rebeccaport,Belarus,001-981-864-7055x101,+1-671-645-9797x29905,clayton77@gilmore.com,2022-05-26,https://www.pollard.com/
04-Nov-2020,Miscellaneous,"3,166.80",00.00,"3,166.80",B8c765Cc42b59bD,8988,Jesus,Peterson,Cline-Benson,Lake Jeanette,Sri Lanka,001-610-818-8971x29138,(744)969-2927,rileymcintosh@allison.net,2022-05-27,http://www.cook.com/
04-Nov-2020,Cheque,"12,348.00",00.00,"15,514.80",F0e14f4B5DbFcbc,8767,Marcus,Park,Savage-Terry,Lake Philip,Tonga,(618)369-9002x70064,(111)686-8412x61380,sydney29@jensen.biz,2020-01-04,http://frye.net/
05-Nov-2020,Commission,"7,727.00",00.00,"23,241.80",c0F95C4823CfbAd,1867,Lori,Fritz,Ramsey-Henry,West Anitafurt,Gibraltar,869-161-3806x72773,(620)496-6950,mandy36@benson.biz,2021-06-11,http://clayton.com/
05-Nov-2020,IMPS,00.00,"2,324.18","20,917.62",1Eb9FF517FB7eb0,4525,Ivan,Buck,"Pacheco, Carney and Bolton",Colemanside,Serbia,610-388-7384x86233,(208)175-4458x91180,roger06@bullock.com,2021-11-22,https://moran.com/
05-Nov-2020,IMPS,"26,726.90",00.00,"47,644.52",e263060dCDD13c3,8204,Molly,Kaufman,Mullen-Esparza,Copelandfort,Isle of Man,001-382-631-9739x00067,+1-856-552-9193x660,mkrause@sutton.info,2020-05-01,https://www.middleton.info/
05-Nov-2020,Commission,00.00,"6,806.36","40,838.16",B0ee2FCAAfBFeBF,4799,Steven,Heath,Cortez LLC,New Garrett,Micronesia,+1-825-961-4006x627,001-435-957-0162,roger82@manning.net,2020-02-21,https://ross-burgess.com/
05-Nov-2020,Debit Card,02.00,00.00,"40,840.16",AEee37Bb80cd75a,8231,Jane,Chambers,"Henry, Brooks and Malone",North Brendashire,Bolivia,+1-795-073-9423x42121,646.784.6266x56110,sharonschmidt@brooks-jefferson.org,2021-09-06,http://www.dalton-nixon.com/
05-Nov-2020,Interest,04.83,00.00,"40,844.99",Dc0ebFf203dECD9,9579,Troy,White,Ramsey LLC,Nicholashaven,Guam,+1-606-409-3991x30762,(300)047-8371,cummingsrose@kim-orr.com,2020-08-24,http://www.anthony.net/
05-Nov-2020,Commission,00.00,"8,169.00","32,675.99",fAae57eb4aa316c,2227,Jordan,Zhang,"Cox, Blevins and Savage",Georgeborough,Ethiopia,(521)658-8500x26417,390.001.0151x8617,sylviafernandez@murillo.org,2021-01-25,http://www.chapman.biz/
05-Nov-2020,Purchase,00.20,00.00,"32,676.19",A2B91cf8e62b786,3570,Maxwell,Short,Hoover-Joseph,Mccannborough,Gabon,(703)448-5846,(438)494-2500x18335,hahntim@wise.com,2020-06-20,https://barrera.com/
05-Nov-2020,Transfer,"1,496,046.00",00.00,"1,528,722.19",cA0FDFe071A4BED,3869,Billy,Schneider,Pugh-Snow,Graceport,Central African Republic,4697628364,001-531-312-6360x2292,mitchellerika@drake.com,2020-06-04,https://cochran-wu.info/
05-Nov-2020,Purchase,00.00,"1,528,722.19",00.00,da447C19eD3E9F0,5662,Andrea,Lara,"Abbott, Everett and Davidson",East Brent,Netherlands,7549053988,496-086-5405x3272,ashleeeverett@hampton.org,2021-03-01,https://www.calderon.com/
05-Nov-2020,Tax,"60,313.94",00.00,"60,313.94",AAf49FcB8DD5FF7,9706,Mariah,Holmes,Rubio Group,South Calvin,Tuvalu,(143)609-4524x13535,167.853.6773x892,velazquezglenda@mahoney.com,2020-04-20,https://www.harris.org/
05-Nov-2020,Purchase,00.00,"6,701.55","53,612.39",2BC8F630102BeFC,9545,Anthony,Joseph,Little-Norris,South Kirk,Syrian Arab Republic,+1-722-826-7852x68500,325-995-3108,mitchellpowers@manning-ho.org,2020-11-21,https://bernard.com/
06-Nov-2020,Tax,510.60,00.00,"54,122.99",6b77bdcCA49b46A,7710,Jodi,Vega,"Pope, Mccormick and Potts",West Ethan,Singapore,080-665-9736x9961,(658)660-1176,moodybrent@todd-blair.net,2021-11-30,http://kaufman.com/
06-Nov-2020,RTGS,"1,195.68",00.00,"55,318.67",bba04Afc10F5FF3,5824,Darlene,Hubbard,Sanford and Sons,South Meredith,Cambodia,1408737689,+1-327-112-7784x970,lukecuevas@conrad-patrick.com,2021-04-19,http://dominguez.com/
06-Nov-2020,Bill,"1,934.00",00.00,"57,252.67",4cAAecCc469aaE9,4167,Drew,Crane,Sawyer and Sons,West Kirsten,Brazil,3566371811,867.085.8119,kristenmurillo@serrano.com,2021-08-02,http://www.hoover.com/
06-Nov-2020,Cash,"47,946.28",00.00,"105,198.95",fbCafB6C12bced6,9364,Justin,Myers,"Levy, Floyd and Randolph",Kaylaview,Greenland,(613)718-1680,(102)628-1960x986,tbarker@moon.com,2021-01-27,https://www.mason-coffey.info/
06-Nov-2020,Interest,"11,764.00",00.00,"116,962.95",B1AF8BF3CFb0BdB,4190,Krista,Mcmahon,Schroeder PLC,Port Kristine,Myanmar,+1-384-017-1134x6171,8313149838,leonardterry@mclaughlin-ayers.com,2021-10-07,http://moore-fitzpatrick.biz/
06-Nov-2020,RTGS,00.00,"16,708.99","100,253.96",d342b8C9cbCfB4e,7932,Bridget,Carpenter,"Collier, Novak and Monroe",Mcconnellburgh,Vanuatu,404-593-8120x5650,833-845-3664,mconrad@lamb.com,2020-12-29,https://www.christian.com/
06-Nov-2020,Cash,"21,497.59",00.00,"121,751.55",FA05E9A4d17F6fc,7213,Meredith,Hall,Mckay Inc,Lucerofurt,Cote d'Ivoire,001-509-371-7918x55768,(827)315-2597,fstuart@clarke-rios.com,2020-02-10,http://www.glenn.biz/
06-Nov-2020,Purchase,00.00,"12,175.16","109,576.40",aFb3A7eDDBc01dE,9358,Spencer,Murphy,Wallace-Bradford,Flemingville,Saint Martin,+1-220-825-0451x617,+1-827-031-3235,shelleyevans@obrien.com,2021-01-03,http://www.mcmahon.biz/
06-Nov-2020,RTGS,"3,900.90",00.00,"113,477.30",deEfc43CaB3bB49,6043,Crystal,Cortez,Hays Group,Whitakerland,Grenada,(599)960-0048x42784,493-174-4405,jasminebrennan@cochran.info,2020-03-23,http://www.white-sharp.net/
06-Nov-2020,Commission,00.00,"56,738.65","56,738.65",4cb9D11EFCD696D,5496,Leroy,Burgess,Atkins-Zamora,New Ricky,Macao,8249238804,001-287-712-2670x73729,antoniovargas@franco.com,2021-06-28,http://nolan.com/
06-Nov-2020,Debit Card,00.00,"5,673.87","51,064.78",b52B9003Cf493D0,5580,Willie,Bird,Andrews Ltd,Joannamouth,Cote d'Ivoire,628-113-0516x92684,302.480.9289,nathan18@hayes-bradford.com,2020-11-27,http://holland-walter.net/
06-Nov-2020,Tax,368.00,00.00,"51,432.78",A77fc8e7C585cCf,4388,Mary,Stein,Henderson-Duran,Lake Matthew,Barbados,+1-119-575-2988x057,(516)713-0024,odunn@haley.com,2021-10-03,http://patterson.com/
06-Nov-2020,Debit Card,"12,593.40",00.00,"64,026.18",1cE4Ae451e4b06f,1560,Steven,Roberson,"Mclean, Pena and Decker",Sheppardmouth,Bulgaria,779-377-6508,635-106-6408x829,christine51@callahan.com,2020-09-18,https://campos.com/
06-Nov-2020,Miscellaneous,00.00,"16,006.55","48,019.64",32C993f1F0D1C9B,1885,Meredith,Roy,Mendez and Sons,Darinshire,United States of America,068.901.9170,(935)035-8188x0041,levinekelly@mays.net,2022-03-26,https://www.evans.org/
06-Nov-2020,Reversal,00.00,"5,335.52","42,684.12",f1fCDC389b6deF6,4409,Clifford,Duffy,Cooper and Sons,New Jenna,Guadeloupe,0861483008,001-388-309-6343x26974,priscillamoon@nash.com,2020-02-06,https://blackwell-bernard.org/
06-Nov-2020,IMPS,02.00,00.00,"42,686.12",4EE4cd7bfeA4Bc6,898,Preston,Rodriguez,Cantrell Group,South Leetown,Micronesia,(360)745-6810,(665)384-1044,brandyholloway@padilla.com,2020-04-21,http://beltran-wallace.com/
06-Nov-2020,Transfer,00.00,"14,228.71","28,457.41",87Beaf1eBCb7B5b,9192,Alejandro,Conley,Suarez-York,Sallyland,Central African Republic,099.850.6431x14971,(153)669-7485x4467,nelsonkari@thornton.com,2020-05-11,https://www.schroeder-hernandez.net/
06-Nov-2020,Miscellaneous,00.00,"4,742.90","23,714.51",d0ad5B7caCeb19b,3273,Tanner,Marshall,Fox Group,Phyllistown,Bahrain,+1-200-038-8570,198.688.9672,bonillagloria@gillespie.com,2020-08-09,https://www.pham.org/
06-Nov-2020,ATM,"1,241.98",00.00,"24,956.49",760FE1bb4727eCC,4237,Mark,Hendricks,"Horton, Sanders and Matthews",Huertachester,Belgium,001-892-084-0399x83092,654.227.4185,reginald38@orozco-hahn.com,2020-06-19,https://www.mcdaniel.com/
06-Nov-2020,Cash,06.00,00.00,"24,962.49",8d8Ec265ba4BBDC,6543,Lorraine,Franco,Cook PLC,New Antoniochester,Pakistan,(830)506-2373x15662,(382)010-8280x7467,isharp@lee.com,2021-05-30,https://www.johnson.com/
06-Nov-2020,IMPS,00.00,"4,992.50","19,969.99",c56a23Af743b6BE,928,Beth,Chaney,Santos Group,Hensleyburgh,Sudan,926.656.1870,2758606986,penningtonpam@wade.com,2020-04-02,http://murphy.com/
06-Nov-2020,Miscellaneous,00.00,"6,656.66","13,313.33",Fd0ca0CE86B752b,980,Maxwell,James,"Figueroa, Osborn and Ray",Coltonshire,Isle of Man,+1-319-885-4738,467.798.1722,danny17@roberts-oneal.com,2021-07-16,https://www.salinas-moss.com/
06-Nov-2020,Bill,00.00,"1,664.17","11,649.16",cC9Eb16B53F2C39,6168,Chad,Serrano,"Wilkinson, Townsend and Castillo",Hineshaven,Eritrea,+1-323-999-0434x85422,+1-198-286-0338,terryzhang@duncan.com,2021-06-08,https://www.ware-barber.com/
06-Nov-2020,Interest,00.00,"1,664.17","9,984.99",34616EE42FC1aeA,1421,Norma,Alvarez,Wyatt Ltd,New Melvinborough,Japan,774.852.8761x78970,565-081-2471x5617,ruizrichard@york-cummings.org,2021-02-22,https://alexander.net/
06-Nov-2020,Debit Card,319.00,00.00,"10,303.99",C1C62ff90D0AfED,9997,Jeremiah,Pena,Hodge-Nixon,Briggsport,Namibia,+1-531-494-7645x4844,001-295-324-5502x5411,tracy68@wade.com,2022-01-17,https://www.campbell.com/
06-Nov-2020,Tax,00.00,"1,030.40","9,273.59",A1Ea3ce88bca44D,8980,Allison,Dyer,"Allison, Hahn and Shea",South Logan,Isle of Man,948-456-1121x19391,(398)092-6689x4927,christensenmicheal@duncan.info,2020-05-26,http://bartlett-henson.com/
06-Nov-2020,Transfer,"2,071.20",00.00,"11,344.79",faE37c4DB5ecEbF,5257,Javier,David,Mooney Inc,Lake Tammiebury,Saudi Arabia,+1-643-532-6073x175,618.764.7064,buckleydominic@hampton.com,2020-06-30,https://decker.com/
06-Nov-2020,NEFT,47.00,00.00,"11,391.79",C0bB49b13054Cc9,5652,Fernando,Fitzpatrick,Zimmerman Inc,Beanburgh,Qatar,3952038506,001-162-189-1956x90984,margaretblake@shepard.net,2022-05-28,http://hampton.com/
06-Nov-2020,Commission,00.00,"2,278.36","9,113.43",bbB4342A6A7FcdD,7532,Jessica,Ruiz,Bright-Wilkinson,Tannerfort,Philippines,276.516.5070,582-013-4752x31354,petersongene@hutchinson-hale.biz,2020-03-22,https://gaines-ryan.com/
06-Nov-2020,Commission,03.00,00.00,"9,116.43",2DaB9ABBa4Ca31c,4592,Krista,Moran,"Hughes, Hayes and Hopkins",New Alvin,Norway,762.964.8815x57206,+1-886-963-1627x92095,rubenperry@klein.com,2021-11-24,http://www.estrada-hall.com/
07-Nov-2020,IMPS,00.00,"1,519.41","7,597.02",4Ff0c4681DD1fC9,5641,Nichole,Lutz,Joseph Inc,West Jonathonland,South Africa,994-324-9290x8047,821.952.2659x8728,vaughancollin@lester-lucas.com,2020-07-29,https://knight.net/
08-Nov-2020,Reversal,00.00,"7,597.02",00.00,9F02A428C922af8,3027,Roberto,Gregory,Mcconnell-Wang,New Toddland,Zambia,+1-845-707-3456x5968,894.653.5052,cheryl07@aguirre.com,2021-02-12,https://www.powers.biz/
08-Nov-2020,Debit Card,345.00,00.00,345.00,Aa15CDa4EDAFCCF,8886,Joe,Evans,Todd PLC,Mosleyville,Spain,001-910-852-7106,001-490-703-3573x01548,zball@bartlett.biz,2021-04-06,http://www.novak.net/
09-Nov-2020,Interest,"7,861.82",00.00,"8,206.82",d64aAa813DebAb4,2300,Penny,Dougherty,Munoz-Dorsey,Palmerchester,Anguilla,+1-740-942-7761x95649,+1-825-799-2306x94192,glen96@greer.info,2020-10-29,http://www.stephens.com/
09-Nov-2020,Miscellaneous,00.00,"4,103.41","4,103.41",06e3a0B88eFC96f,2488,Jane,Chambers,Gray-Huang,Lake Stuart,Paraguay,001-871-656-5065,+1-031-313-7096x554,stokessheri@reynolds.org,2021-10-04,https://www.franco-watson.com/
09-Nov-2020,Interest,00.00,"1,367.80","2,735.61",F02ABb05c4F7ac7,8814,Kylie,Simon,Barajas-Bonilla,North Kristenton,Saint Pierre and Miquelon,001-914-748-8049x2509,683.902.1144x426,emma97@shannon.biz,2021-03-07,http://drake.org/
09-Nov-2020,NEFT,05.00,00.00,"2,740.61",EA3Ce80DDEB462d,2847,Ana,Haas,Bird LLC,Leeburgh,United States Minor Outlying Islands,001-214-798-8963,654-482-9824x8698,teresa21@mcfarland.biz,2022-04-11,http://powers.com/
09-Nov-2020,Transfer,00.00,685.15,"2,055.46",6e6FeCf4D75F3d5,3334,Hannah,Gilbert,"Holder, Anthony and Fisher",Proctorberg,Ethiopia,662.179.3261x17327,012.064.6311,colleenpope@rosario-long.com,2020-06-15,https://www.summers-rogers.com/
09-Nov-2020,ATM,00.00,228.38,"1,827.08",ef2E35aaBbd01D2,2394,John,Hickman,"Hammond, Webster and Stewart",Faithchester,United States of America,+1-384-821-8201,(141)082-0694x4352,ngates@escobar-merritt.com,2021-10-28,https://www.may-owen.net/
09-Nov-2020,Transfer,"228,586.00",00.00,"230,413.08",0c3e46aEAcBdbFE,5371,Rhonda,Good,"Bass, Hebert and Mcfarland",Nataliebury,Moldova,001-631-221-7158x596,+1-237-338-2571x7137,keith42@acosta-wolfe.biz,2022-04-11,https://dodson.com/
09-Nov-2020,Debit Card,13.70,00.00,"230,426.78",43ea26e15bf1469,1680,Deborah,Espinoza,Kelly Inc,New Andrew,Rwanda,856-211-3344,001-897-860-2574x90718,meagan30@underwood.org,2021-11-26,https://www.huang.com/
09-Nov-2020,RTGS,00.00,"38,404.46","192,022.32",d7Aa0C4C34Ddcd3,1433,Alec,Norris,Stokes PLC,Harmonmouth,Malawi,6101512865,790-735-6172x815,summerwaters@mcneil.biz,2021-04-12,http://dougherty.biz/
09-Nov-2020,Interest,"2,250.49",00.00,"194,272.81",D80dbC9344A851E,8462,Garrett,Patton,Spence-Marsh,Lake Lisa,Suriname,(932)737-0805x91625,+1-476-821-1616x47148,acarroll@moreno.net,2020-12-05,https://stark.com/
09-Nov-2020,Miscellaneous,"6,137.25",00.00,"200,410.06",F7CFa3DA1a6Fceb,7881,Jeremiah,Brock,"Hart, Bates and Sanders",Port Kristenfurt,Malawi,001-741-915-9694x19681,001-531-716-1358x947,sally78@curry.net,2020-04-29,http://little.com/
09-Nov-2020,Commission,201.00,00.00,"200,611.06",DbE634fd0B4d8FC,1240,Larry,Sawyer,"Mccall, Padilla and Woodward",Port Carrie,Bulgaria,001-615-631-4552x37599,(353)522-3641x7791,cholder@mccarty.com,2021-08-14,https://burke.com/
09-Nov-2020,NEFT,407.80,00.00,"201,018.86",7F2f762eaafE03D,5358,Wayne,Landry,Brooks PLC,Kristabury,Northern Mariana Islands,(508)055-1774,(197)676-7251,cantumarilyn@stephenson.com,2020-08-26,https://www.trevino.com/
09-Nov-2020,Cash,00.00,"67,006.29","134,012.57",aB6077DdABFbBAd,6107,Stuart,Perez,Stevenson-Stevens,Loweryfurt,Hong Kong,739.132.0779,437-784-8255,armstrongmarvin@valenzuela-waters.com,2020-11-20,https://thomas-gallagher.org/
09-Nov-2020,Interest,00.00,"26,802.51","107,210.06",c7f6d3f7BeA0Ef3,581,Ellen,Quinn,Horton-Ware,Jamesside,Gambia,098.318.5155x15845,2138261062,annette75@cohen.net,2021-08-13,http://www.wade-scott.net/
09-Nov-2020,Miscellaneous,08.00,00.00,"107,218.06",5D5BFADedeCFBc0,7596,Drew,Harper,"Franco, Horne and Price",Carlyview,Panama,(139)166-8736x218,(231)128-3958x363,shelia47@landry.org,2021-08-08,http://www.cherry.info/
09-Nov-2020,Cheque,00.00,"107,218.06",00.00,B4EAEfaaD7690Fb,1528,Angel,Marsh,Boyer-Duffy,Lake Gerald,Malaysia,331-594-0023,+1-936-176-1411x125,umadden@le.com,2021-05-15,http://www.rhodes.com/
09-Nov-2020,IMPS,"3,017.00",00.00,"3,017.00",6618Cf94dEDdC37,6683,Doris,Sawyer,"Moss, Case and Camacho",Bernardstad,Bolivia,071-621-4097,353.944.7625x510,tinasuarez@charles.com,2022-05-08,https://www.tyler.info/
09-Nov-2020,Miscellaneous,00.00,431.00,"2,586.00",d84d17a0Ecd1fCb,8684,Tracey,Glenn,Haley Inc,North Kristineberg,Angola,487.450.2974x091,367-886-8853x63815,pmathis@maldonado.net,2020-11-15,https://cooke.com/
09-Nov-2020,Purchase,02.70,00.00,"2,588.70",DeaFaa03313Cbe9,9445,Tonya,Mcdowell,Woods-Gillespie,Jonathanstad,Nepal,(643)582-3735x6808,415-320-1680,ofletcher@andrade.com,2021-08-09,http://www.malone.org/
09-Nov-2020,Bill,00.00,369.81,"2,218.89",cED6aA1cE4d19Db,6840,Daisy,Wall,"Coleman, Holder and Cunningham",North Garrettville,Montserrat,9983233833,(808)680-9949x9873,roberta24@luna-montoya.com,2022-04-27,https://thomas-diaz.com/
09-Nov-2020,Bill,"3,524.21",00.00,"5,743.10",Cd937a5568Dec2C,8203,Trevor,Travis,Heath Inc,New Kirstenburgh,Honduras,919-740-4577x381,001-129-647-6961x814,gonzalezrobin@small.com,2020-10-07,http://www.hubbard.com/
09-Nov-2020,Miscellaneous,00.00,717.89,"5,025.21",bB60D35a77Ce07F,8780,Sydney,Mcclure,"Dennis, Mueller and Ponce",Port Frankshire,Cameroon,347.959.3820,001-982-921-1877x51003,sophiacantu@mckee.com,2022-05-04,http://holland.com/
09-Nov-2020,NEFT,00.00,"2,512.61","2,512.60",E495619Ee377dce,5293,Deanna,Waters,"Nash, Haley and Watkins",Lucasstad,Puerto Rico,001-279-844-7636x762,(658)092-8640,gnixon@clark.com,2020-02-27,https://www.may.biz/
09-Nov-2020,ATM,00.00,418.77,"2,093.83",5Bfef99aA5ba004,2664,Logan,Douglas,Oneill-Frey,Hannahmouth,Kenya,3428030633,654-515-9205x4181,wernertravis@dickson-wells.com,2021-12-12,http://morris.com/
09-Nov-2020,Commission,"72,645.00",00.00,"74,738.83",a81C9E005B089Df,7267,Molly,Nguyen,Mcdaniel-Briggs,Derekberg,Bangladesh,097-147-8720x751,+1-550-773-7834,carrillomckenzie@kline.info,2020-07-22,https://mcfarland.info/
09-Nov-2020,NEFT,"40,851.50",00.00,"115,590.33",5bcD12cf1A055C2,5734,Paige,Becker,"Avery, Weiss and Vazquez",East Scott,Estonia,059-010-6905x823,442-507-6131,osullivan@vaughan.biz,2021-12-16,https://www.mcfarland.org/
09-Nov-2020,Miscellaneous,00.00,"23,118.07","92,472.26",C24caA81ad61d6c,2409,Shawna,Erickson,Chen Inc,Port Gwendolynhaven,Seychelles,358.460.4582x773,7553849200,rodney94@vance.biz,2021-02-14,https://www.sparks.info/
09-Nov-2020,IMPS,00.00,"46,236.13","46,236.13",d630adD9A2Bce6b,6239,Gary,Lynch,Sweeney and Sons,Hesterside,Togo,+1-212-448-9273x681,001-790-495-5422x237,natalieryan@lawrence.com,2020-05-17,https://www.kerr-craig.com/
09-Nov-2020,RTGS,00.00,"5,137.35","41,098.78",e1Ee301D7d6ac1e,2707,Shane,Holloway,Davila-Trujillo,West Reginald,Korea,116-124-8781x69177,(784)179-4826,fritzgabrielle@hebert.biz,2021-04-01,https://www.barajas.org/
09-Nov-2020,Bill,00.00,"6,849.80","34,248.98",d46fb5EAD1CEDe0,6334,Rita,Harrison,Pugh Group,Kelliview,Myanmar,001-600-804-1569x47975,578.725.1434,nhumphrey@walters.com,2020-10-28,http://moreno-benton.com/
09-Nov-2020,NEFT,00.00,"17,124.49","17,124.49",eE718cdA1CCaA91,6195,Bradley,Clayton,Ramos Inc,Barberstad,Luxembourg,360.797.7453x7457,5987632252,mcclurejoel@hubbard-lawson.info,2021-01-14,https://www.ferguson.com/
09-Nov-2020,Reversal,339.00,00.00,"17,463.49",B6bF2E1D05CADE7,268,Rebekah,Weiss,Gallagher PLC,Lyonsshire,Oman,925.881.7050,(040)995-5358x7014,stoutwilliam@forbes.com,2020-03-12,http://lutz.org/
09-Nov-2020,Purchase,"55,418.50",00.00,"72,881.99",b5B9e9F4822121A,486,Helen,Farmer,Keller Inc,West Brandy,Lao People's Democratic Republic,(581)373-2751,(679)044-0922x68889,tyrone99@english.com,2021-09-11,http://www.conrad-wallace.org/
09-Nov-2020,Bill,00.00,"24,294.00","48,587.99",6DfCf0BBFA5AF2A,5484,Carmen,Wolf,"Cannon, Levy and Pittman",Weberfurt,Turkmenistan,862.600.5924x44611,(052)060-8341x85340,kroach@walton.biz,2020-04-20,http://mcdaniel.info/
09-Nov-2020,Reversal,00.00,"5,398.67","43,189.32",65D17Ecf29913A4,5123,Kent,Santos,Tucker-Gould,Edwardtown,Guernsey,115.285.6685x0927,+1-903-659-4957x5322,nhardin@orozco.info,2020-09-21,http://cooper-gallegos.com/
09-Nov-2020,Miscellaneous,"1,420,831.80",00.00,"1,464,021.12",b24f6baAB432DAf,2921,Amy,Duran,"Bird, Moreno and Griffin",Kochtown,Switzerland,001-001-002-8164x33186,1214411111,nancymccoy@gates.com,2020-04-13,http://hester-randolph.com/
09-Nov-2020,Cheque,00.00,"209,145.87","1,254,875.25",9E7eCc6317cC74d,8839,Shelia,Barrett,George and Sons,Port Alfred,Congo,549-766-1751x422,001-144-735-3834x3886,zbrennan@morales.com,2020-05-11,https://www.salas.com/
09-Nov-2020,Cheque,19.80,00.00,"1,254,895.05",d0D80547aD45beA,7505,Martha,Bush,Weaver Ltd,New Danamouth,Azerbaijan,589-139-2372x06877,+1-270-573-0732,erodriguez@mosley.info,2021-11-29,https://yoder.com/
09-Nov-2020,NEFT,394.00,00.00,"1,255,289.05",C1bDECDF855C8d6,6050,Madison,House,House and Sons,Darrellland,Vanuatu,573.093.4281x741,+1-104-933-5919x4821,juliebuchanan@duran.net,2020-08-08,https://dean-shah.com/
09-Nov-2020,Debit Card,00.00,"209,214.84","1,046,074.21",84828Ab23aFecB7,5753,Hannah,Larson,"Trevino, Wong and Farmer",West Audrey,Honduras,836.623.6633x624,591.815.9308x7929,cesarparsons@barr-hughes.com,2021-05-19,https://moore.com/
09-Nov-2020,IMPS,00.72,00.00,"1,046,074.93",506DD5A84Ef0bcC,8872,Micheal,Mercer,Travis-Reeves,Mcdonaldport,Guam,625-812-1157x1827,(481)524-7054x01593,jeffperez@vance.com,2020-08-08,http://haas.com/
09-Nov-2020,Miscellaneous,"3,026.45",00.00,"1,049,101.38",803579cd2cDDCb6,2390,Julie,Sloan,Sherman-Harding,West Julieville,Mexico,001-582-709-1361,831-060-0158,morganroberts@tran.com,2020-10-06,http://riggs.com/
09-Nov-2020,ATM,00.00,"104,910.14","944,191.24",DD45d02DF247316,4005,Adrian,Norris,Gardner-Mason,East Hector,Algeria,618.756.2410x200,+1-369-741-9669x03694,laurablankenship@wolf.com,2022-02-04,http://rose.com/
09-Nov-2020,Debit Card,"4,076.57",00.00,"948,267.81",119AbFA21C7aaeE,7897,Kristina,Maddox,Mcpherson PLC,Kurthaven,Falkland Islands (Malvinas),822-567-7729x5545,495.670.7564x22299,vtaylor@boyle.com,2021-07-24,https://carter-hoover.biz/
09-Nov-2020,Interest,00.00,"948,267.81",00.00,E65dfB345A26Ea8,6335,Daniel,Tapia,Barrett-Berg,Colonmouth,Mozambique,489-080-9304x2773,(805)326-1599x72114,natalieellis@russell-simpson.com,2022-03-14,https://www.christensen.com/
09-Nov-2020,Miscellaneous,"895,883.00",00.00,"895,883.00",543faE91f2eC0Cc,8560,Alicia,Weiss,Bird-Golden,Tashamouth,Barbados,(383)232-8495x29548,+1-533-580-8287x292,mercadoandrew@goodwin.com,2020-05-04,https://rhodes.com/
09-Nov-2020,Miscellaneous,00.00,"895,883.00",00.00,9A479F7D485ea5e,6767,Ricky,Kane,"Collier, Sanchez and Valencia",North Paula,Peru,001-947-085-1450x6338,514.175.5819x863,staffordshirley@zamora.org,2022-04-28,https://www.gillespie.com/
09-Nov-2020,IMPS,273.60,00.00,273.60,eafeF71b6b3Df9B,5086,Walter,Holloway,Livingston Group,Pachecofort,Korea,9044849616,(581)769-0497,lhartman@turner.net,2021-02-14,http://www.bryan.net/
09-Nov-2020,Cheque,421.50,00.00,695.10,c643FC3e4e0F3b5,9214,Meredith,Christian,Mccarthy and Sons,North Terri,Sweden,908-224-0368x67018,(353)058-9932x90966,pedro23@weaver.com,2020-04-28,https://gentry.com/
09-Nov-2020,IMPS,452.60,00.00,"1,147.70",4277ca3aa0c7aE2,2726,Aaron,Hamilton,Decker Inc,Cesarbury,Nicaragua,923-194-6702x8699,(801)805-2422x474,zpark@carter-compton.com,2021-10-08,https://www.neal.org/
09-Nov-2020,Debit Card,"108,416.00",00.00,"109,563.70",9E0fDCA5069Ac32,9837,Darryl,Dixon,Murillo Ltd,East Kristen,Palau,001-291-829-6323x9058,263-786-3375x9325,karina46@bradley-bender.com,2022-03-10,https://www.hurley.com/
09-Nov-2020,Cheque,00.00,00.00,"109,563.70",CB0dFD3dFEFC89D,1292,Clayton,Spence,Hicks-Hoffman,New Sergiohaven,Samoa,7437891008,624.970.7671x3047,kayleemorrison@smith.com,2021-01-17,https://www.rose-farmer.info/
09-Nov-2020,Cheque,00.00,00.00,"109,563.70",7Edf7f101C819FD,3812,Hayden,Benton,"Sosa, Glass and Mcfarland",East Melissaport,Guyana,949.746.7498x9558,511-072-9991,bryanglen@freeman.org,2022-03-25,https://kemp-leblanc.org/
09-Nov-2020,Cheque,00.00,"15,651.96","93,911.74",bd25EBD4ebf2C1d,3804,Courtney,Underwood,Robinson Inc,Terrellburgh,El Salvador,563-006-8236x186,001-524-355-3272x12845,rose11@knapp.info,2021-05-28,https://www.mcconnell.com/
09-Nov-2020,Cheque,00.00,"31,303.91","62,607.83",FADa2dff9E8f3bC,442,Kayla,Fry,Vazquez-Wilson,New Andrew,Botswana,(986)611-0141,001-625-816-0923x62214,patriciagiles@oneill-chung.com,2020-01-14,http://www.flores.com/
10-Nov-2020,ATM,726.00,00.00,"63,333.83",e5bB2bBdB0383B9,2711,Russell,Haney,Ruiz-Donaldson,West Erikaburgh,Palau,121.011.8056x27792,+1-099-870-3380,kenneth71@cline.com,2022-01-31,http://www.hull-wolf.com/
10-Nov-2020,Reversal,00.00,"7,037.09","56,296.74",01edC7DffC4d6cE,9700,Jasmine,Buck,Wang LLC,Pattersonside,Cayman Islands,978-437-2464,(935)947-7473,jacksonruiz@barnett.com,2022-01-17,https://lowery-burton.org/
10-Nov-2020,Cash,988.80,00.00,"57,285.54",94EEdA87cf6e26C,4217,Chloe,Hayes,"Glass, French and Marshall",Wigginsland,Portugal,098.220.8579x396,875.905.1389,wcummings@robinson.com,2020-01-28,http://www.carlson.net/
10-Nov-2020,NEFT,01.80,00.00,"57,287.34",4ede9D5B2cD79bd,2149,Joann,Mckay,Mckay PLC,Port Cole,Dominican Republic,+1-007-507-9444x917,037.504.6947x546,dlowery@austin.com,2020-12-26,https://www.knox.com/
10-Nov-2020,Reversal,"4,043.35",00.00,"61,330.69",BFfdCEbaFc2a8c6,1593,Nichole,Decker,Hinton LLC,New Tara,Malta,105.423.2913x19422,001-591-271-5276x691,dicksonshane@pearson-sheppard.com,2020-02-24,http://www.bean.com/
10-Nov-2020,Interest,00.00,"7,666.34","53,664.35",08910FdBc7C7941,8638,Darlene,Mayo,Odonnell and Sons,Huffmanland,Gambia,(361)160-3500x35754,447.056.2453x2077,kristine88@barnett.org,2020-11-16,https://nunez-hartman.biz/
10-Nov-2020,RTGS,00.00,"26,832.18","26,832.18",Af6E7dE01DAEEb1,5161,Christopher,Prince,Welch-Mack,Malonemouth,El Salvador,5404872238,001-384-394-2755x8139,downsgabrielle@jones.com,2020-03-28,https://www.pittman.com/
10-Nov-2020,Reversal,00.00,"2,683.22","24,148.96",90D853A55e68d3e,5702,Regina,Wheeler,"Sims, Hardy and Esparza",Clairehaven,Guinea-Bissau,2979664806,559.551.0348x515,isaacmercer@kelley.com,2021-10-19,http://www.douglas.com/
10-Nov-2020,Purchase,19.64,00.00,"24,168.60",4f3Dff09a16e3Bd,5709,Joan,Donovan,Wu-Ayala,Lake Jaredchester,Denmark,049.776.1594x838,001-696-811-3950x83728,schwartzlisa@grimes-lamb.net,2021-05-25,http://bennett-hurley.com/
10-Nov-2020,ATM,00.00,"2,416.86","21,751.74",26b77e7CBf59856,5006,Connie,Porter,Benjamin-Galloway,Curtisfurt,Barbados,499.382.3292x88532,(449)116-4209,yolandapaul@durham.com,2020-03-21,http://www.combs.org/
10-Nov-2020,Interest,00.00,"2,416.86","19,334.88",2aeB0fAF9Fd1A2A,359,Jill,Schaefer,Molina-Fritz,West Carl,Cook Islands,+1-983-220-0215x955,+1-210-246-0470x5906,bfitzpatrick@kelly.com,2022-03-08,https://callahan.com/
10-Nov-2020,NEFT,"1,074,028.00",00.00,"1,093,362.88",0efD10acCBDB0FE,4855,Anthony,Carroll,Mueller-Kane,East Ronnietown,Montenegro,657-614-8920x82155,001-281-158-4824x87041,kiddkellie@arellano.org,2022-02-24,http://www.black-powers.com/
10-Nov-2020,Cheque,"649,527.80",00.00,"1,742,890.68",88341bA88185aE2,937,Derek,Turner,"Branch, Proctor and Zamora",South Audreymouth,Cook Islands,410-732-1199,018.021.8316x16430,kirsten02@maynard-dunlap.org,2021-09-29,https://cunningham.org/
10-Nov-2020,Commission,00.00,"193,654.52","1,549,236.16",3a18072Fc0bEfBC,6096,Kurt,Park,"Sanchez, Glover and Ali",Marcoberg,Bolivia,644.514.3029x529,348-194-6255,mathisnancy@melendez.net,2020-12-17,https://www.downs.com/
10-Nov-2020,RTGS,63.00,00.00,"1,549,299.16",e8dCA474DDC5ADB,2124,Isabel,Sellers,"Collier, Dean and Armstrong",Port Hunterfort,Uganda,470.009.2801x45179,048-989-7704,stefanienielsen@warner.com,2020-09-04,https://chambers.biz/
10-Nov-2020,Purchase,00.00,"154,929.92","1,394,369.24",B9Df6c1dB8531dc,9702,Maria,Thornton,"Cooke, Ross and Holt",Lake Kathrynstad,Azerbaijan,+1-294-490-8506x24576,+1-965-833-4871x974,woodardkylie@mack-kline.com,2022-05-17,http://sanford.com/
10-Nov-2020,Bill,08.00,00.00,"1,394,377.24",14cA2aCba51FD06,6795,Kiara,Winters,Maldonado Ltd,Elizabethtown,Cote d'Ivoire,(248)740-5970x66105,(246)972-6419x79675,danagaines@combs-glass.org,2020-01-24,http://www.hale.net/
10-Nov-2020,Tax,00.00,"348,594.31","1,045,782.93",5B7DfFF7cBF76AA,873,Daryl,Bernard,Mccarty LLC,New Dillonstad,Jordan,+1-311-382-3733,786-745-7786x63827,pbrandt@malone.com,2020-04-18,https://www.blackburn-kline.com/
10-Nov-2020,IMPS,00.00,"522,891.47","522,891.46",Aa7e782d09Ab3c4,7920,Warren,Carpenter,Thompson-Wagner,West Jenna,Uruguay,001-137-136-9762,950.148.2990,alvarezmaxwell@pineda-edwards.com,2021-07-27,http://www.hendricks.net/
10-Nov-2020,Cheque,00.00,"74,698.78","448,192.68",0cbb5Ac5DDBDE8d,7304,Frank,Daniel,Arias-Stanley,Lake Natalie,New Zealand,488-233-1146x7821,001-671-573-3842x2848,sho@johnson.org,2021-05-27,https://www.blankenship.com/
10-Nov-2020,RTGS,00.00,"64,027.53","384,165.15",07a0251Cff0A6Bb,5735,Dale,Pruitt,Burnett Ltd,Port Hollystad,Russian Federation,505-469-2224x227,+1-236-835-9930,xmora@barron.net,2020-05-07,https://pugh.com/
10-Nov-2020,Tax,"28,074.10",00.00,"412,239.25",FeDc06C4D5cdD50,4737,Jackson,Huber,Hinton-Bautista,Traciehaven,Syrian Arab Republic,+1-878-854-1035x153,+1-224-676-3734x21683,joycemarks@massey.com,2020-02-02,https://www.walls.com/
10-Nov-2020,Interest,00.00,"51,529.91","360,709.34",e212B5C986BF9bf,2487,Roger,Dorsey,Mcdonald Ltd,Acostafurt,Equatorial Guinea,045.569.6915x059,2514580822,mindy94@hebert.com,2021-02-10,https://www.mayer.biz/
10-Nov-2020,Commission,00.00,"120,236.45","240,472.89",3EFf74fCE09e7de,4196,Virginia,Ball,"Copeland, Montgomery and Ware",North Jacksonland,Malta,031.395.5571x4612,001-444-607-1228x82713,zlara@koch-fields.net,2021-04-17,http://www.pham.com/
10-Nov-2020,Bill,00.00,"40,078.82","200,394.08",fCd8c13197D6a1D,7098,Traci,Erickson,"Spears, Meadows and Lam",West Abigailburgh,Dominican Republic,(176)537-6983,082-628-5836x097,evelynwebster@greer.com,2021-09-11,http://jarvis.info/
10-Nov-2020,ATM,00.00,"50,098.52","150,295.56",7D1BA693cCdB72C,939,Cassidy,Mueller,"Wright, Cooper and Branch",East Daniel,Congo,1036359279,873.072.1906x12239,alisonburch@kim-small.com,2020-04-22,http://www.lamb-bradshaw.com/
10-Nov-2020,Cash,"3,078.00",00.00,"153,373.56",52f3a91f56ecb06,5088,Carmen,Sawyer,"Norris, Jacobs and Fields",South Annestad,Nigeria,(509)640-1130x42003,(338)917-0266x421,traciecordova@adams.com,2022-01-12,http://horton.com/
10-Nov-2020,Transfer,00.00,"30,674.71","122,698.85",05f5e8C38afaADa,6155,Claudia,Mcdaniel,Le-Herrera,North Marissaport,Georgia,001-492-070-8996,345-503-3304x523,jwallace@archer-ewing.net,2021-03-12,http://allen.com/
10-Nov-2020,Cheque,00.83,00.00,"122,699.68",62C7851C12fe8F9,9894,Chelsea,Peterson,"Pineda, Santiago and Todd",New Glen,Cameroon,755.093.5558,558-875-2788x95565,hendrickstraci@acevedo-olson.biz,2020-01-04,http://www.arnold-waller.biz/
10-Nov-2020,Interest,00.00,"13,633.30","109,066.38",8d32c2fcD809843,2223,Earl,Mccormick,"Montoya, Hensley and Bush",Valerieville,Afghanistan,216-956-5845,001-799-776-5269x7242,cdunlap@woodward.com,2021-03-28,https://www.curtis.com/
10-Nov-2020,Miscellaneous,140.40,00.00,"109,206.78",4aB3CAeE3C27Bfc,6210,Kerri,Rowe,Frank Group,West Jeannemouth,Zimbabwe,(534)885-7802x849,4681470227,gzamora@joyce.com,2020-10-28,http://schmidt.com/
10-Nov-2020,RTGS,635.60,00.00,"109,842.38",6aFe67Fa630bffA,7090,Miranda,Hodges,Solomon LLC,North Debbiechester,Cook Islands,545.298.4243,001-281-077-3424x794,chelsey96@hahn.biz,2022-01-01,https://dodson.com/
10-Nov-2020,IMPS,05.00,00.00,"109,847.38",2A4AE5dE3fbfAE6,1664,Ashlee,Dixon,Reese Ltd,Mcmahonborough,American Samoa,001-674-243-7422x57501,001-078-052-4654,jorgenewman@bullock-welch.com,2020-09-07,https://www.boyle-berry.com/
10-Nov-2020,Cheque,"15,643.00",00.00,"125,490.38",Da2efbC6fCc5b74,9950,Sandra,Silva,Gonzalez PLC,Tabithaberg,Bangladesh,(434)277-0630x7629,634-816-4808,ablackwell@watkins-mcmahon.com,2020-09-03,https://www.campos.com/
10-Nov-2020,IMPS,00.00,"62,745.19","62,745.19",2C5856eBEEdbe29,3339,Guy,Mayo,"Estrada, Heath and Dunn",South Leon,Niue,894-925-7760x168,+1-812-310-4347x32477,chavezemma@butler-hart.com,2022-04-28,https://stokes-chambers.com/
10-Nov-2020,Cash,05.36,00.00,"62,750.55",8dDABC46a53C84B,9970,Kristie,Burgess,"Pineda, Webb and Eaton",Port Earlmouth,Tokelau,+1-440-955-0154x4525,001-434-841-2635x23222,carloskey@mercer-pena.com,2022-04-04,https://lloyd.com/
11-Nov-2020,Cheque,00.00,"7,843.82","54,906.73",43b624ad3BEB86F,7960,Toni,Hester,Gonzales-Arias,Carsonland,Saint Pierre and Miquelon,001-580-863-3359x4420,001-670-919-4323x47851,rowlandsandy@schwartz.com,2020-12-19,https://www.woodard.com/
11-Nov-2020,Miscellaneous,00.00,"27,453.37","27,453.36",88af0Ff9CD0Cf6B,3402,Bethany,Becker,Aguilar-Boyle,West Sydneyton,New Zealand,(191)752-3373x104,454-454-1411,jalvarez@riddle.com,2020-08-20,http://www.morse-henry.net/
11-Nov-2020,NEFT,00.00,"5,490.67","21,962.69",65Dffa81Ba6AAD0,3917,Shannon,Holt,"Daniel, David and Mullen",Transhire,Maldives,+1-246-417-4877x14677,942-271-3136x6287,kathychang@peterson.com,2022-02-22,https://www.dunlap.com/
11-Nov-2020,Tax,"489,721.00",00.00,"511,683.69",2DD738e7980FBcE,4829,Alec,Abbott,"Ali, Dalton and Mcknight",Logantown,Rwanda,239.375.7512x598,001-701-638-5003x20650,benderlogan@sexton.com,2020-07-03,https://edwards-flowers.info/
11-Nov-2020,Bill,00.00,"51,168.37","460,515.32",FeDffAcFa7B5b79,4641,Tara,Hall,Moses LLC,Contrerasburgh,Costa Rica,579-861-1629,(989)419-5924x7534,jeancarrillo@cobb-mcmillan.com,2021-03-30,https://www.mason.com/
11-Nov-2020,Purchase,00.00,"65,787.90","394,727.42",9aF244b44Dc6d7e,7712,Kaitlyn,Webster,"Lawrence, Camacho and Herring",Branchstad,Bangladesh,001-246-652-6955,504-017-2781x9320,willie54@stephens.net,2020-12-12,https://gamble.com/
11-Nov-2020,Reversal,00.00,"43,858.60","350,868.82",796aefD7c70afB0,6297,Sally,Richards,"Stevenson, Hawkins and Davidson",Port Ronald,Saint Martin,001-291-218-1573x511,504.439.5574x43515,ohubbard@deleon-christian.biz,2021-06-25,http://arellano.com/
11-Nov-2020,ATM,"143,368.50",00.00,"494,237.32",FC4EDBc20Cfb8e5,7567,Diane,Rivas,Duffy Ltd,West Christieshire,Ethiopia,001-388-744-7046x9352,(860)761-8474,travismaurice@calhoun.info,2021-09-21,http://kramer.com/
11-Nov-2020,Debit Card,"19,535.80",00.00,"513,773.12",8BD947727bAe5dA,2740,Judith,Love,Barr-Sexton,Lake Ernest,Saint Helena,(119)749-6980x0344,+1-073-682-0734x0254,cesarburns@mays-mcdonald.com,2021-10-08,https://strong.com/
11-Nov-2020,ATM,00.82,00.00,"513,773.94",4f8C01FDceBcd23,374,Samuel,Yates,Fleming-Dunn,Zimmermanside,Spain,694-008-9791,343-349-2513,ayerschris@gilbert-landry.org,2021-03-17,http://page.com/
11-Nov-2020,Transfer,"2,674.04",00.00,"516,447.98",3B6FEB4DC7FA6B2,1281,Heather,Higgins,Luna-Hampton,Anthonyview,Sudan,914.966.3356x726,426-118-5249x006,lyonskirk@barrett.com,2021-06-13,http://www.diaz.org/
11-Nov-2020,Interest,"69,157.90",00.00,"585,605.88",bEeB4bF2C0B9A3b,7103,Terrence,Ellison,Irwin Ltd,Angelland,Chad,+1-377-268-9393x19984,819.130.3197x390,sarah65@preston.com,2020-04-10,http://www.sanford-castillo.biz/
11-Nov-2020,Purchase,05.00,00.00,"585,610.88",03D5DDC0B1CeCa0,3239,Karl,Mejia,Molina-Durham,East Selenafort,Hong Kong,001-715-402-2928x82037,538.454.8560,kthomas@simpson.net,2020-09-28,https://barron.com/
11-Nov-2020,Cash,35.13,00.00,"585,646.01",d86Ce96cEe1343d,3345,Caitlin,Carr,Arias-West,North Connorland,Hungary,825.157.2957x6170,589.382.1840x8887,wwright@bernard.com,2022-02-05,http://www.mccormick-mcguire.com/
11-Nov-2020,Miscellaneous,00.00,"585,646.01",00.00,BCAB40FE65fE3AD,6260,Vicki,Jordan,"Singh, Velazquez and Mooney",Farmerberg,Taiwan,596.770.5777x8632,(030)096-0051,wcampos@murphy.com,2020-05-31,https://www.roman.com/
11-Nov-2020,ATM,31.40,00.00,31.40,FA05E9A4d17F6fc,7213,Meredith,Hall,Mckay Inc,Lucerofurt,Cote d'Ivoire,001-509-371-7918x55768,(827)315-2597,fstuart@clarke-rios.com,2020-02-10,http://www.glenn.biz/
11-Nov-2020,Reversal,42.10,00.00,73.50,Ed31EE0B2E2D4D9,9475,Yvette,Kramer,"Graham, Herrera and Carson",South Bonnie,Cocos (Keeling) Islands,+1-935-578-7423x553,+1-248-261-2166x029,carlos70@wilkerson.com,2020-02-19,https://www.rollins.com/
11-Nov-2020,Commission,00.00,14.70,58.80,a21F7EBd0DB37AB,4004,Valerie,Levine,Fuentes LLC,Lake Melvin,Fiji,001-800-225-6167x140,+1-289-909-0302x82263,tamipacheco@hays.com,2021-05-23,https://www.kline.org/
11-Nov-2020,Interest,00.00,14.70,44.10,931e8EfAA0fEB78,2084,Brittany,Russell,Mayo and Sons,Cartermouth,Togo,687-383-5794,2558222891,gwendolyntaylor@sosa-holt.com,2021-09-02,https://www.shepherd.com/
11-Nov-2020,NEFT,00.00,14.70,29.40,bCCaDdA9C688FcB,6642,Marisa,Wolfe,Greer-Mata,South Joanneton,Turks and Caicos Islands,457-963-6670,(652)249-9217,ashleygates@greer.com,2020-02-01,https://cohen-burgess.biz/
11-Nov-2020,Bill,61.42,00.00,90.82,A976D0fe6C4c4ec,6320,Hailey,Washington,Coleman PLC,Tommyborough,Belize,855.592.2004x9865,+1-698-198-6426x66973,faulknerkellie@chandler.com,2020-02-11,http://williamson.com/
11-Nov-2020,Purchase,00.00,09.08,81.74,1b9CDDceC017308,4324,Emily,Yang,Richards Ltd,Port Karen,Holy See (Vatican City State),924.290.7172,(205)466-3521,pwhitney@sharp-powell.net,2022-01-09,https://gonzalez-lucero.org/
11-Nov-2020,Commission,"2,440.00",00.00,"2,521.74",03D5DDC0B1CeCa0,3239,Karl,Mejia,Molina-Durham,East Selenafort,Hong Kong,001-715-402-2928x82037,538.454.8560,kthomas@simpson.net,2020-09-28,https://barron.com/
11-Nov-2020,Interest,00.00,"1,260.87","1,260.87",9931eB23F1CdDC9,2190,Judy,Rivas,Haas Ltd,Lake Rodney,Netherlands,397.535.8713x219,(499)453-8284,alexa93@love.net,2021-09-19,http://www.bolton-mcbride.com/
11-Nov-2020,IMPS,"1,297,628.00",00.00,"1,298,888.87",CEc2AA2fc5dd5d5,9910,Sonya,Contreras,Herman Ltd,Port Warren,Tunisia,+1-885-755-8588x161,+1-165-942-2079,jonathanweiss@moore.net,2022-02-23,https://www.hurst.org/
11-Nov-2020,Cash,02.00,00.00,"1,298,890.87",b2BDA178e8DDE2c,1121,Oscar,Bush,"Hayden, Woodard and Arnold",Matthewfurt,Peru,+1-212-463-4605,(539)758-6391x3930,ichang@schmitt.com,2021-10-17,http://goodman-morrison.info/
11-Nov-2020,NEFT,00.00,"432,963.62","865,927.25",e9Ff8F4EfdA7DB5,4660,Christine,Hooper,Ferrell-Franco,Port Tashahaven,Romania,+1-321-571-3120,140-955-2145x76654,haynesalison@barnes.com,2021-11-22,https://byrd-garner.com/
11-Nov-2020,Debit Card,308.00,00.00,"866,235.25",342ADDf1c69d1Cc,2436,Richard,Blake,"Horne, Choi and Mcguire",Adambury,Trinidad and Tobago,(620)116-0145x6077,857.530.3868,dsaunders@nicholson-park.info,2020-03-17,https://fitzpatrick.com/
11-Nov-2020,IMPS,00.00,"144,372.54","721,862.71",a69FE7b7Bff9DE4,7611,Charles,Ibarra,"Buck, Travis and Kent",North Catherinemouth,Uzbekistan,587-944-5718,980-889-2048x349,calhounalejandra@silva.com,2020-04-04,http://fitzgerald.biz/
11-Nov-2020,Cheque,"252,645.56",00.00,"974,508.27",9c1d6AE7E1bAE3b,5879,Nathan,Skinner,Evans-Lawrence,Brandtville,Hungary,020-248-9522,+1-918-222-3477,summersperry@davis.com,2021-09-21,http://oconnor.com/
11-Nov-2020,Commission,00.00,"487,254.14","487,254.14",e205B68c24D0f8E,1770,Edwin,Strickland,Strong-Acosta,Lorishire,Guadeloupe,(551)071-3254,+1-582-291-6550x101,harry18@stuart-bean.com,2021-03-12,https://www.lara.com/
11-Nov-2020,ATM,257.63,00.00,"487,511.77",CE7a979fba79b49,5373,Maurice,Huerta,"Dickson, Wall and Acosta",West Marciaville,Netherlands Antilles,(557)067-2738x387,(326)306-5251,tonya48@johns-valentine.com,2021-07-28,http://www.cline-bradshaw.net/
11-Nov-2020,Reversal,00.00,"487,511.77",00.00,7aa0bBb2c8afBfc,1273,Robin,Bernard,Hayes-Conrad,New Bob,Macao,+1-179-164-4027,(566)245-3647,pbentley@jensen-marshall.org,2020-07-30,http://www.manning.com/
11-Nov-2020,Commission,"1,499,015.50",00.00,"1,499,015.50",E495619Ee377dce,5293,Deanna,Waters,"Nash, Haley and Watkins",Lucasstad,Puerto Rico,001-279-844-7636x762,(658)092-8640,gnixon@clark.com,2020-02-27,https://www.may.biz/
11-Nov-2020,Interest,"792,455.00",00.00,"2,291,470.50",2dB372f8296dDCd,9330,Marco,Salazar,Burke Ltd,Paigetown,Botswana,(264)553-9129x40137,457-767-9954x21015,tgilbert@valencia.org,2021-10-07,https://kelly.com/
11-Nov-2020,RTGS,00.00,"286,433.81","2,005,036.69",42eAF89915dD6C9,6004,Devin,Reynolds,Austin-Wilkins,Stoutmouth,Namibia,009.876.8912x29513,921-793-7636x0041,hooverdebbie@hess.com,2020-09-06,http://www.rogers.com/
11-Nov-2020,Tax,"562,644.75",00.00,"2,567,681.44",93344fC5a123DA4,5274,Ashley,Leon,"Joseph, Lowe and Wilson",North Racheltown,Christmas Island,(242)517-7147x86318,4753224037,grahambethany@cochran-sexton.com,2022-01-15,http://www.goodwin.com/
11-Nov-2020,RTGS,00.00,"256,768.14","2,310,913.30",b5d1Ba4BE81d0Bd,8045,Cheyenne,Estes,Dyer-Hayes,Montgomerybury,British Indian Ocean Territory (Chagos Archipelago),001-719-961-7063x96172,593-564-3966x450,oknight@howard.com,2021-03-08,https://www.shelton.com/
11-Nov-2020,Interest,00.00,"231,091.33","2,079,821.97",F506aff4D8D38B0,5807,Nicole,Lamb,Snyder-Huber,Gordonhaven,Portugal,+1-070-675-7939x50644,326.671.9817x835,trangel@washington-swanson.com,2021-09-24,http://bridges-peters.com/
11-Nov-2020,RTGS,336.00,00.00,"2,080,157.97",0dd16A135Bcfd3D,9334,Makayla,Jordan,Johnson and Sons,Lake Suzanneside,Kyrgyz Republic,001-592-096-3097,868-608-8988,ryancortez@reed.com,2020-03-13,http://moody.org/
11-Nov-2020,Reversal,00.00,"346,693.00","1,733,464.98",ABDfB9aE6FE5Bbf,391,Ana,Lopez,"Gentry, Carr and James",Barnettmouth,Angola,(999)273-7424x0499,(443)757-1385x002,bwalter@church.net,2021-10-26,http://jones-hendrix.com/
11-Nov-2020,Reversal,"70,755.70",00.00,"1,804,220.68",3BC681EBdC551FD,8794,Allison,Roy,Horton-Maldonado,Carolineburgh,Zimbabwe,+1-393-992-6682x15632,001-868-785-6831x6130,lancemcknight@harrington.com,2021-11-22,https://www.joyce.org/
11-Nov-2020,Cash,"122,285.25",00.00,"1,926,505.93",A8CFadf479eb7cD,1225,Ana,Dougherty,Stokes-Hubbard,South Melissa,Rwanda,365-917-3233,(123)299-6663,xedwards@goodwin-waters.net,2020-11-11,http://www.thomas-mccoy.com/
11-Nov-2020,Purchase,"16,844.10",00.00,"1,943,350.03",EDeEdC52ab405e0,3049,Yesenia,Cochran,"Welch, Villarreal and Morrison",Lesterbury,American Samoa,(089)608-0820x9309,850.809.3733,hstevens@choi.info,2021-09-21,http://www.ramirez-schultz.info/
12-Nov-2020,Commission,00.00,"971,675.02","971,675.02",c0C7e5A4C769766,5683,Jasmin,Ramsey,Acosta Group,Francisberg,Hungary,+1-283-109-1879,922.690.1716,francisco29@allen.com,2020-09-02,http://www.schwartz.org/
12-Nov-2020,IMPS,00.00,"971,675.02",00.00,dB52fA7Bec665C1,19,Kristin,Valencia,Liu-Douglas,Martinezstad,French Southern Territories,443-671-1725x7073,6244311825,andrewsanders@marks.com,2021-04-17,http://www.myers.com/
12-Nov-2020,Purchase,"821,424.20",00.00,"821,424.20",DCA0bE4346ef397,6458,Perry,Pearson,Ward-Buckley,Port Marcia,Jordan,(067)479-9607,514-727-7809x0410,andre08@norton-pruitt.com,2020-12-28,http://nguyen-bright.com/
12-Nov-2020,IMPS,00.00,"821,424.20",00.00,2D5E1ee98d4EfDe,6104,Kyle,Carney,"Foster, Huber and Torres",Lake Alejandro,Sierra Leone,(748)934-3172,+1-513-642-4682,penamikayla@vega-chambers.biz,2022-01-13,http://www.charles.com/
12-Nov-2020,Debit Card,05.00,00.00,05.00,e95c2e094B65Ad7,7470,Debbie,Ashley,"Summers, Serrano and Best",Dixonhaven,Myanmar,(159)127-5290,001-250-519-7716x89828,bianca48@davenport.com,2021-01-18,https://baxter-black.info/
12-Nov-2020,Cheque,"177,318.00",00.00,"177,323.00",2DD738e7980FBcE,4829,Alec,Abbott,"Ali, Dalton and Mcknight",Logantown,Rwanda,239.375.7512x598,001-701-638-5003x20650,benderlogan@sexton.com,2020-07-03,https://edwards-flowers.info/
12-Nov-2020,Commission,06.15,00.00,"177,329.15",dAfC3DdDf2CdFa3,4727,Gabriel,Pierce,Beard Inc,South Ralph,Israel,(053)912-0408x297,(889)147-2000,zachary49@burnett-dominguez.com,2021-04-14,http://frost.com/
12-Nov-2020,Cheque,00.00,"17,732.92","159,596.23",CF48dffcfc6d7cB,2666,Kara,Hinton,"Hensley, Mccarthy and Chung",Boydstad,British Indian Ocean Territory (Chagos Archipelago),+1-418-708-5989x5899,653-320-9868x512,uwarner@wagner.com,2020-07-21,http://www.guerra-wagner.com/
12-Nov-2020,Transfer,"14,592.00",00.00,"174,188.23",Ba8AC9FEE6c53BF,9666,Destiny,Goodman,Rogers and Sons,Perryville,Bahamas,+1-188-348-5380,001-279-136-4271,reeddean@watkins-chandler.biz,2020-07-16,http://wilkerson.com/
12-Nov-2020,Tax,00.00,"29,031.37","145,156.86",9D9B2e5Be8847Df,6823,Bobby,Whitehead,"Allison, Goodman and Camacho",North Jaclyn,Antarctica (the territory South of 60 deg S),+1-471-424-7726,067-371-5960,rebekahlynch@gray.info,2021-10-12,http://www.mckinney.net/
12-Nov-2020,IMPS,00.00,"24,192.81","120,964.05",AFa9Bb0e32bfD60,9491,Wayne,Roberts,Brady and Sons,Mitchellville,Iraq,+1-984-991-6960,287.937.6081,wilkinsonrick@suarez.com,2021-02-11,https://www.stout-castillo.com/
12-Nov-2020,Debit Card,00.00,"30,241.01","90,723.04",A6c0BaFbd38Bdce,6657,Christian,Carney,"Harrell, Carr and Tran",Bettyborough,French Guiana,+1-560-075-2040x02447,(288)777-0688,nparsons@hernandez.com,2021-06-03,http://diaz.org/
12-Nov-2020,Tax,167.00,00.00,"90,890.04",f5E80Bd7e96b5D6,7696,Edwin,Wang,Mcknight LLC,Jodimouth,Gabon,379-077-6024x411,852-408-8261,dsheppard@mcintyre.info,2020-02-29,http://www.whitney.com/
12-Nov-2020,Reversal,07.00,00.00,"90,897.04",13BbcBAFeb8EbF1,3143,Johnathan,Hancock,Thomas Ltd,South Reginastad,Qatar,(459)591-9891x9329,001-600-403-0864x7546,zmaynard@gaines.info,2020-06-06,https://www.richards.info/
12-Nov-2020,Reversal,00.00,"30,299.01","60,598.03",6d1de21C407B2f4,9497,Jeffrey,Costa,"Howe, Berg and Brewer",Alexandertown,Bulgaria,389-590-6544,(345)309-5112,jaydominguez@molina-sharp.com,2020-01-05,https://walker.com/
12-Nov-2020,Commission,00.00,"15,149.51","45,448.52",bc12F82EAff157f,2178,Rebekah,Frazier,"Bailey, Dominguez and Bullock",South Joeberg,Israel,930.122.4682,+1-326-938-0075x7694,cruzjuan@waters.com,2021-07-14,http://www.welch-green.com/
12-Nov-2020,Transfer,"3,384.00",00.00,"48,832.52",3F486cAd1D029ff,9288,Tammy,Marsh,"Huber, Stevens and Conley",East Nancyborough,Congo,161.762.3261x30064,001-884-669-5329x70421,jackie75@conley.net,2020-03-10,https://adkins-bates.net/
12-Nov-2020,Bill,00.00,"48,832.52",00.00,6A4dE6A871C9764,1039,Wesley,Adkins,"Hernandez, Miller and Mcgee",Port Maxton,United States of America,458-389-2932x5337,298.939.3461x1618,watsonclifford@barton.com,2020-04-02,https://bolton.com/
12-Nov-2020,Bill,"3,691.49",00.00,"3,691.49",f2AF1ECB3F7E5DA,4460,Jonathon,Glover,Kelley PLC,Nguyenport,Marshall Islands,063.375.9723x160,2526554719,treeves@cervantes-houston.com,2022-05-25,http://petty.info/
12-Nov-2020,Cash,00.00,738.30,"2,953.19",A9E54B22bf2DaFc,7825,Evan,Mitchell,Herrera-Zuniga,South Courtneymouth,Guinea,+1-485-783-4375x229,815.396.7827x3959,jocelynlucero@mcbride-watson.org,2021-04-24,https://kline-mcclain.net/
12-Nov-2020,Commission,00.00,328.13,"2,625.06",5fBDE5cDc5F4B96,3499,Angel,Kim,Fox-Conrad,Thomasshire,Oman,635.882.8193x809,001-406-615-9671x81681,tomhall@kline.com,2021-08-25,http://www.grant.com/
12-Nov-2020,Cheque,00.00,875.02,"1,750.04",ec33A8bC91BDeE4,2622,Ronnie,Vazquez,Smith LLC,Collinfort,Colombia,397.647.5403x467,001-245-793-9435,dmcconnell@bowman.com,2021-02-05,https://sullivan.info/
12-Nov-2020,Bill,05.00,00.00,"1,755.04",3f52aAfAe6DDfCa,4796,Jocelyn,Herring,Wise-Cuevas,Deniseberg,Niger,880-255-2628,+1-399-116-9490,stuartrichards@barron.com,2022-01-26,https://davidson.com/
12-Nov-2020,Miscellaneous,15.00,00.00,"1,770.04",1BF1798e57e461D,953,Marie,Leblanc,Huff and Sons,Ronaldbury,Jordan,001-210-355-5380x643,(780)346-0158,brandy33@larson-blair.com,2020-11-03,http://www.marquez.org/
12-Nov-2020,Bill,00.68,00.00,"1,770.72",bffF52a944A3652,8254,Dean,Bruce,Cabrera Ltd,Wernermouth,Antarctica (the territory South of 60 deg S),762-256-4477x67554,(772)855-7711x83954,omckay@daugherty.com,2020-12-01,http://www.kelley.com/
12-Nov-2020,Bill,"995,802.00",00.00,"997,572.72",a36c5b1abF472De,4256,Curtis,Cline,Rios LLC,Chapmanton,Mexico,748-254-0082x413,841.440.8802x9050,agamble@ochoa-davidson.net,2021-07-14,http://george-campos.com/
12-Nov-2020,Debit Card,00.40,00.00,"997,573.12",cc0ddAc3FBCE7D0,6701,Melvin,Key,Oconnor and Sons,Eduardofort,Kazakhstan,057.797.6613,442.938.0294x7730,luke40@holloway.info,2021-04-24,https://www.riddle.com/
12-Nov-2020,Interest,00.00,"166,262.19","831,310.93",D9EfbE27CcfCBad,727,Roberto,Tran,"Wall, George and Villa",North Paulamouth,Grenada,(134)787-5481x36759,3964008369,jasonmiranda@baird.com,2021-05-11,https://mcclure.org/
12-Nov-2020,Transfer,00.00,"118,758.70","712,552.23",78a2aeFd5bE26cE,8191,Carol,Wong,Lynch Ltd,South Rubenmouth,Greece,(649)319-7804x654,614-981-1536x3272,tcrane@bolton.com,2021-12-09,http://neal.com/
12-Nov-2020,Tax,00.00,"712,552.23",00.00,315Cdbcb5E28FeC,3920,Alice,Wise,Church and Sons,Brookeville,Bahamas,981-437-8438x582,989-263-5161,cdiaz@roth-fry.com,2020-01-05,https://rivera.org/
12-Nov-2020,IMPS,61.00,00.00,61.00,BB0ec00797C1d29,8668,Earl,Floyd,Alvarado-Warren,East Javier,Iraq,+1-513-923-1611x508,319-847-0473x921,alisha44@peters.com,2020-05-28,https://www.christian-moore.com/
12-Nov-2020,Commission,00.00,12.20,48.80,93Dc2FA13F8bab3,149,Casey,Miles,Church-Boyle,Jocelynbury,Italy,(219)384-5940,8480138604,elizabethcopeland@morris-moss.info,2021-09-17,http://bautista.com/
12-Nov-2020,Cheque,00.00,16.27,32.53,D738bdE54ce14f6,9592,Jasmine,Hammond,Weaver LLC,South Marcview,Kazakhstan,(363)137-4115x33296,630.027.3000x23175,lvillanueva@orr-gutierrez.com,2020-06-11,http://bush.info/
12-Nov-2020,NEFT,00.00,03.25,29.28,Fcf8da8eCA6B825,1255,Karl,Barron,Fisher-Chapman,Kimside,Morocco,1986634320,144.099.5421,figueroacarmen@cardenas.com,2021-01-12,http://www.villanueva.com/
12-Nov-2020,Interest,00.00,03.66,25.62,5fD07a2a2c7aFf1,3915,Daisy,Kennedy,Paul-Snyder,Mcneilmouth,Svalbard & Jan Mayen Islands,001-054-825-3040,351-255-0443,robyn25@cortez.com,2022-03-28,https://martin.com/
12-Nov-2020,ATM,00.00,12.81,12.81,55ccE335EaAD335,2307,Zoe,Walsh,Hughes-Steele,Lake Devin,United States of America,5425875834,+1-293-673-7840x39730,alex34@barajas.com,2021-11-08,http://ramos-chandler.org/
13-Nov-2020,Transfer,"1,391.00",00.00,"1,403.81",DF8c99a02e97c74,3731,Ashley,Wells,Cooper Group,Jonathonbury,Afghanistan,(742)386-1902x069,389.084.7867x8436,jnash@mcgrath-monroe.com,2021-09-27,https://poole.com/
13-Nov-2020,Cheque,"46,033.00",00.00,"47,436.81",aAc24D7D5AbdBc8,6606,Alicia,Hester,"Kennedy, Lam and Reynolds",Andrademouth,British Virgin Islands,001-990-231-3794x7129,162-269-5850,novakdominique@gould.com,2022-01-12,http://richmond-ross.biz/
13-Nov-2020,Tax,"1,894,891.25",00.00,"1,942,328.06",a70D52BEA11F6ff,3121,Selena,Walter,"Hull, Sandoval and Werner",East Jacob,Guatemala,997.846.9769x8096,001-100-451-5269x20593,robertohodges@sweeney.info,2020-03-31,http://robbins.net/
13-Nov-2020,Miscellaneous,00.00,"194,232.81","1,748,095.25",6ffFD3b28812EB5,507,Johnathan,Howard,Zuniga Group,West Wanda,Kyrgyz Republic,+1-525-473-4159x4761,001-821-438-5165,xfriedman@aguilar.biz,2021-04-28,https://christian.info/
13-Nov-2020,Tax,"3,193.00",00.00,"1,751,288.25",5aF9ed3b66B0DFF,6247,Theodore,Klein,Hardin-Melendez,New Franklin,French Southern Territories,771.344.4116,001-129-960-4938x146,phillip33@owen.com,2020-06-29,https://sutton.com/
13-Nov-2020,RTGS,"2,881.00",00.00,"1,754,169.25",Bc038b4f5831d4c,5275,Eddie,Bautista,"Patel, Zamora and Choi",New Marcton,Somalia,960-906-0763x75895,010.484.4109,sallywu@everett.com,2021-01-04,http://arias.com/
13-Nov-2020,Interest,00.00,"438,542.31","1,315,626.94",d6866bBAdd79aFa,8199,Danny,Lowe,Rich-Burgess,West Jacksonstad,Mayotte,416.656.0933x34559,073-877-9368,veronica96@dyer-romero.com,2020-12-24,https://www.adams.com/
13-Nov-2020,Cheque,46.62,00.00,"1,315,673.56",b9B3B5f1ba40FD3,28,Roberta,Walton,"Lamb, Little and Frazier",Campbellshire,Tonga,805-974-3346x026,001-324-540-6599x3227,sharigriffin@cameron.com,2020-11-15,https://quinn.biz/
13-Nov-2020,Reversal,00.00,"131,567.36","1,184,106.20",cFc5Aea6e0BCA73,2874,April,Rubio,"Wall, English and Kaiser",West Tyronechester,Nigeria,001-187-576-2694x7806,023-267-9858,jillbaldwin@santiago.com,2020-07-23,http://moreno-hines.com/
13-Nov-2020,Interest,00.00,"197,351.03","986,755.17",abF564950aaddbE,4770,Jocelyn,Buchanan,Munoz-Macias,Lake Perrymouth,Honduras,001-202-160-8632x8457,705-444-2110,byrdkim@guerrero.com,2020-04-22,https://www.lyons-baker.info/
13-Nov-2020,Cash,00.00,"493,377.59","493,377.58",dA6B9aacf9ED25A,8552,Gene,Hunter,"Kramer, Mathews and Daniels",North Rebeccaberg,Lao People's Democratic Republic,(009)437-2061x9175,+1-677-926-2878x4384,kathy68@watkins.info,2021-09-11,http://www.fowler.com/
13-Nov-2020,NEFT,"33,561.38",00.00,"526,938.96",ef19F3E31A3E65e,535,Phyllis,Giles,"Reeves, Hayes and Whitehead",Reneemouth,Benin,(652)842-4012,+1-118-686-7313x65876,mcleanarthur@erickson.com,2020-08-30,https://caldwell-estrada.com/
13-Nov-2020,Cheque,00.00,"263,469.48","263,469.48",5c8d356A16FfeEB,9112,Sonya,Andersen,"Rowe, Mosley and Stephens",Lake Kurt,Chad,417.387.6781x50654,001-162-465-5741x435,yeverett@ewing-anthony.com,2021-08-18,http://eaton.info/
13-Nov-2020,Purchase,03.70,00.00,"263,473.18",8d9AfDF5d4B5ed5,6513,Darrell,Hoffman,"Browning, Becker and Meyers",New Terri,Venezuela,902.666.8908x060,(397)779-8873x954,johnskaren@parks.org,2020-02-20,http://nelson.com/
13-Nov-2020,Purchase,440.79,00.00,"263,913.97",b67ae17e6BA1D9e,4544,Lawrence,Little,Mullins-Alvarez,Daisyville,Bouvet Island (Bouvetoya),590.009.0191,279-078-5612x523,sherry20@love.com,2020-05-01,http://www.franco.info/
13-Nov-2020,Tax,170.49,00.00,"264,084.46",8cc8C8AD1E5BDa9,5482,Jennifer,Cook,Knapp Group,Caitlynshire,Brazil,+1-523-745-6893,+1-706-399-8385x541,hardingsamantha@hobbs.com,2021-11-05,http://www.bentley.com/
13-Nov-2020,Commission,"23,468.00",00.00,"287,552.46",7808aDd6df0cFE1,3026,Edwin,Rodriguez,Jones-Holland,Adamville,Cote d'Ivoire,4792636874,237-003-1367,kathleenblake@drake-schmitt.com,2021-12-21,https://pittman.com/
13-Nov-2020,RTGS,205.00,00.00,"287,757.46",3E8fC81654d1079,3393,Sophia,Norris,"Rangel, Turner and Huber",Mooreport,Estonia,790-569-3769,866.261.1745,elizabeth40@bradley-james.com,2021-06-25,http://www.anthony.com/
13-Nov-2020,Tax,"218,582.91",00.00,"506,340.37",EBEd3f98C1E1cFa,6917,Bob,Meyer,"Beck, Horne and Oneill",New Annette,Zambia,+1-520-081-3843,9210233722,uho@bryan-zuniga.com,2020-05-25,https://benjamin-webb.org/
13-Nov-2020,Miscellaneous,"15,266.00",00.00,"521,606.37",DAD2fBCc3ce4AF2,7444,Julie,Rose,"Noble, Valencia and Cannon",West Marisaland,Lebanon,196-737-2030x8798,+1-951-445-5821,tatesheena@griffin.org,2020-03-24,http://www.moyer.com/
13-Nov-2020,Debit Card,509.01,00.00,"522,115.38",1ebde0dE870884c,2849,Debra,Neal,Brooks-Kent,East Barbara,Congo,(570)973-6088,+1-988-802-4835x8726,lamkatie@coffey.com,2020-05-12,https://hurley.info/
13-Nov-2020,Interest,134.10,00.00,"522,249.48",dD5Ac6b31f802D7,9613,Sheri,Dickson,Hancock PLC,Bradyberg,Serbia,627.954.6520x894,255-278-6685,phyllis67@kennedy-becker.com,2021-03-03,http://www.conrad-valdez.info/
13-Nov-2020,Interest,00.00,"74,607.07","447,642.41",16E4eEF96bb4AE7,9437,Dominique,Perkins,"Hughes, Richmond and Roberson",North Ivan,Iceland,983-310-8861x3767,549.819.0873,dustinduke@hammond-porter.com,2021-06-05,https://www.ayers-lin.com/
13-Nov-2020,Reversal,00.00,"223,821.21","223,821.20",02Ea36f8a0a8A3A,7114,Corey,Ritter,"Davila, Gomez and Jarvis",Port Yvettefurt,Kazakhstan,001-887-121-9789x06672,(959)560-2442x27504,danielssandy@mejia.com,2021-08-16,https://mendez.biz/
13-Nov-2020,IMPS,00.00,"223,821.20",00.00,d40c9828C71Ba14,6438,Reginald,Dixon,Acevedo Inc,Stevenberg,Argentina,+1-940-136-4477x5736,(829)242-3932x852,dmolina@daniel-galloway.info,2021-04-19,http://www.mccall.net/
13-Nov-2020,IMPS,112.61,00.00,112.61,0889389B1c9bf63,2066,Tanya,Holmes,Kaufman-Marshall,South Thomas,Turks and Caicos Islands,639.257.4677,001-642-440-7290x57943,bridgetbarton@schmitt-case.net,2021-12-20,http://www.watson-graves.org/
13-Nov-2020,Tax,00.00,112.61,00.00,b86AfB34C99d83e,1581,Derrick,Braun,Schultz-Montoya,Sergioborough,Sweden,+1-940-585-6448x85995,607-836-7219,tstevenson@mcguire.com,2021-02-17,https://kline.com/
13-Nov-2020,Debit Card,395.00,00.00,395.00,ffBc6F82c3f4dCF,2113,Clarence,Patton,Sharp-Santos,East Caitlin,Montserrat,322-766-0233x20165,(693)481-9042x6188,avelez@johnston.org,2020-05-20,http://www.beltran.net/
13-Nov-2020,Cheque,00.00,43.89,351.11,16Dd5C5b16Bc373,5091,Claudia,Simpson,"Daugherty, Oneill and Stone",Foxbury,Wallis and Futuna,324.119.8170x0114,001-321-462-1074x02124,margaret02@huff-barrett.net,2021-07-12,http://www.griffith.com/
13-Nov-2020,Reversal,00.00,58.52,292.59,A9bDA2C696C8C1C,1790,Vernon,Gilmore,"Wagner, Briggs and Watts",Port Kaitlinburgh,Malawi,583.153.2719x071,256-050-8318x197,sara83@tran-dorsey.info,2021-04-19,http://www.gould.com/
13-Nov-2020,RTGS,00.00,29.26,263.33,363B5210b1dDeCe,6469,Ricardo,Duffy,"Morgan, Macdonald and Byrd",Hollowaystad,Ghana,1296671689,232.090.8664x80963,carmenfrancis@ward-meza.net,2021-03-20,https://hays.org/
13-Nov-2020,Bill,00.00,52.67,210.66,0A8CDa9FF9DeCEd,3445,Franklin,Hale,"Patton, Walters and Perry",North Darrellport,Gabon,(013)297-9332x3515,+1-013-365-2630x92686,huangjillian@mathis.com,2022-01-17,http://hardin.info/
13-Nov-2020,NEFT,04.50,00.00,215.16,3B002Ca124e6a04,7192,Bridget,Branch,"Daugherty, Howell and Poole",Port Toni,Trinidad and Tobago,201.050.4291x408,(385)378-0018,julianmorse@castaneda-juarez.net,2021-10-01,https://warren.com/
13-Nov-2020,Tax,00.00,26.90,188.26,8b019Fc206f7601,2365,Amanda,Thompson,"Jacobson, Curtis and Montgomery",Leviburgh,Saint Kitts and Nevis,+1-333-869-4717x79570,(190)186-1138x2786,huertarandy@burnett.com,2021-09-17,https://morris-sutton.org/
14-Nov-2020,Cheque,237.84,00.00,426.10,7FC5Bf7cF6A4AdC,9762,Andres,Weber,"Wagner, Avila and Mcclain",Pageland,Haiti,001-571-346-7011x25367,440-780-8773x740,randybruce@lawson-lambert.com,2020-04-24,http://hoffman.biz/
14-Nov-2020,Tax,44.71,00.00,470.81,afe2C0C71D31209,2233,Heidi,Clements,Wood-Murillo,North Darrylton,Tanzania,115-702-9505x922,+1-413-892-8360x4139,shortjasmine@gamble.org,2021-08-19,http://www.nielsen.com/
14-Nov-2020,NEFT,00.00,58.85,411.96,5CB579BEec65Ff9,9177,Calvin,Garza,"Roy, Frederick and Wilkins",Yvettemouth,American Samoa,408-979-2338x3285,(467)666-4336x25268,buchananmichaela@castro.com,2020-09-17,http://www.gordon-stanton.net/
14-Nov-2020,Tax,"1,256.00",00.00,"1,667.96",FC7Fc11c2195998,6064,Alison,Mueller,Tucker-Russo,Hobbsberg,San Marino,138.919.5321x31662,+1-497-116-8185x5820,nathaniel38@burgess.info,2020-06-06,https://www.leach-pham.net/
14-Nov-2020,Commission,00.00,833.98,833.98,600c1738d3Eeea8,1838,Wyatt,Roy,"Bond, Petty and Carey",New Alvinstad,Guyana,9311252418,879-230-3040x834,alex50@choi-booker.com,2022-05-28,http://www.colon-santiago.com/
14-Nov-2020,Cheque,00.00,833.98,00.00,2edD358FAC2153D,6343,Gavin,Sanford,Mcmillan PLC,South Dylanberg,Bosnia and Herzegovina,(190)605-9342,919.676.3762x5265,diana07@roman.com,2020-05-02,https://wagner-shepard.net/
14-Nov-2020,Purchase,03.00,00.00,03.00,D72c1BAdDAFfECa,2560,Bradley,Richard,Durham-Martinez,Lake Deanna,Korea,001-598-694-3519x215,+1-151-437-1818x9987,sbaxter@burnett.info,2022-02-22,https://weaver.info/
14-Nov-2020,Reversal,00.00,00.30,02.70,6aFe67Fa630bffA,7090,Miranda,Hodges,Solomon LLC,North Debbiechester,Cook Islands,545.298.4243,001-281-077-3424x794,chelsey96@hahn.biz,2022-01-01,https://dodson.com/
14-Nov-2020,Tax,00.00,00.34,02.36,Cbf5CfccF97Cac8,1777,Dean,Stone,Patel-Mercer,Caitlinland,Saint Kitts and Nevis,3237621468,(348)743-8731x95608,wesley97@keller-walters.com,2022-04-18,https://www.bell-murphy.com/
14-Nov-2020,NEFT,00.00,00.30,02.06,1a7cED1E5b8Cc1b,6968,Misty,Moody,Michael-Mcguire,East Austin,Dominica,828-525-2286x453,681-274-1259,ediaz@pruitt.com,2021-11-01,https://reed-peters.net/
14-Nov-2020,NEFT,00.00,01.03,01.03,bE5a71E34feAE0D,1082,Lawrence,Barr,Combs-Reeves,Lake Karenfurt,Montenegro,001-300-079-0012x014,001-783-852-7340x1307,crosbycaitlyn@sharp.biz,2021-08-14,https://www.holland.com/
14-Nov-2020,Purchase,"2,029,620.00",00.00,"2,029,621.03",3e751A7A3D70A2b,9692,Emma,Booth,Rivers-Moyer,Lake Tom,Oman,+1-801-357-4774,001-248-857-1395x4891,hlloyd@saunders.com,2021-06-16,https://shepard.com/
14-Nov-2020,ATM,00.00,"338,270.17","1,691,350.86",f80b25aeEA96Eef,9624,Levi,Mathews,Graves-Luna,Rosechester,Rwanda,(741)987-0097x4137,590.093.5339x201,elainefrench@krause-coleman.com,2022-02-05,https://www.blankenship.net/
14-Nov-2020,Reversal,"27,179.00",00.00,"1,718,529.86",7fcC0CB80f178Db,7497,Sheila,Small,Vargas-Cobb,Lake Steven,Jersey,302-918-0698,090-965-3545,fsellers@copeland.com,2021-06-01,http://www.mccann.com/
14-Nov-2020,RTGS,03.80,00.00,"1,718,533.66",FAe4Db53CABC0cD,8802,Dwayne,Reeves,"Hancock, Kelley and Simmons",Port Christian,Isle of Man,415-744-5631x238,001-856-677-9099x97129,treese@guerrero.com,2021-06-15,http://www.heath.com/
14-Nov-2020,Reversal,00.00,"1,718,533.66",00.00,4EA04B80A5fc7fD,8642,Jacqueline,George,Murphy Ltd,Stacyport,Cameroon,273-598-2082,(849)313-1804,megancraig@bowen.com,2021-03-21,http://www.brandt.com/
14-Nov-2020,Bill,"1,865,295.20",00.00,"1,865,295.20",6000498dbbcaCCD,750,Roy,Solis,Houston PLC,South Gene,Canada,+1-174-537-7539x484,(864)349-1991,glen37@kaiser-walter.com,2021-12-18,http://clay-hunter.com/
14-Nov-2020,Cheque,00.00,"932,647.60","932,647.60",87E8bcaa763C106,6400,Cathy,Johnston,"Kane, Mercer and Mccall",Lake Shelleyside,Turkmenistan,991-190-3160x31545,585-904-4791,carly75@cordova.com,2021-03-19,https://ortiz.com/
14-Nov-2020,Transfer,00.00,"466,323.80","466,323.80",88Ecd5ff77F037d,9128,Douglas,Gross,Parsons-Key,North Marilynbury,Holy See (Vatican City State),+1-103-710-2409x79008,(952)120-8001x189,claire74@schwartz.biz,2022-04-26,http://www.rose.com/
14-Nov-2020,Tax,00.00,"116,580.95","349,742.85",66938A6bc87CDCA,9535,Jeanne,Swanson,Price-Morrison,Franciston,Iraq,+1-893-735-5729x00502,(708)570-6795x554,esparzaleroy@andersen.com,2021-10-12,https://mcknight.com/
14-Nov-2020,Cash,00.00,"43,717.86","306,024.99",bCA1a4fAe7dE8E8,9626,Gwendolyn,Morton,Ochoa-Vaughan,South Heidi,Christmas Island,+1-383-484-8071x757,271-099-2933x7222,comptonmark@sparks.com,2022-05-26,https://frederick-mosley.com/
14-Nov-2020,Purchase,00.00,"30,602.50","275,422.49",5900F88dA25cFa5,1479,Sheena,Hughes,Hurst and Sons,Lake Walter,Syrian Arab Republic,+1-813-843-9655,679.277.8243,tonyagallagher@barajas-goodwin.biz,2022-01-11,http://franklin.com/
14-Nov-2020,Bill,00.00,"55,084.50","220,337.99",5Fece6694B192e8,6137,Diana,Carroll,Bolton Inc,Port Tracey,French Guiana,264-623-7629,+1-852-236-0166x070,penningtonphillip@stafford.net,2021-02-12,https://fischer-craig.com/
14-Nov-2020,Tax,00.00,"36,723.00","183,614.99",4eC92c6fA2b3EC5,8245,Dave,Buckley,Stark-Andersen,Sylviashire,Timor-Leste,001-673-774-3501x37741,001-874-932-7727x7122,droberts@horne.com,2021-09-22,http://www.mitchell-farley.com/
14-Nov-2020,Cheque,00.00,"61,205.00","122,409.99",f2bd6BEea14F3cC,2181,Summer,White,Luna-Frank,South Tom,Singapore,961.188.6252x629,5160126775,dawn82@carey-richmond.com,2020-01-05,http://www.velez-garrett.com/
14-Nov-2020,RTGS,"72,977.90",00.00,"195,387.89",AbE2c5cbecb1EF8,7069,Betty,Golden,Ramirez Ltd,West Tom,United Kingdom,+1-634-664-0363x70216,001-221-870-5056x210,alexmatthews@hudson-dougherty.net,2020-08-14,https://may.com/
14-Nov-2020,Tax,"20,679.54",00.00,"216,067.43",cc13180BECF51CF,5192,Jorge,Dunlap,Leon Inc,Port Courtneyview,Congo,514-924-4194x8604,706-865-8593,stricklandmarilyn@pruitt.biz,2021-08-25,http://newton.com/
14-Nov-2020,Reversal,00.00,"30,866.78","185,200.65",A2cEcEB5F5decBe,9059,Perry,Lee,"Duran, Byrd and Dudley",Dixonland,Mexico,001-157-122-0632x746,9249485693,wyatt11@kline.com,2020-02-26,https://watkins-compton.info/
14-Nov-2020,IMPS,00.00,"23,150.08","162,050.57",82bFf35ccaa1eca,9773,Brian,Dixon,Browning-Crosby,Isaacmouth,Saint Martin,734-926-7481x012,289-462-3915,dwalters@weiss.info,2022-04-23,http://www.henson.com/
14-Nov-2020,ATM,00.00,"18,005.62","144,044.95",B91C97bf7EA52Db,5732,Virginia,Kirk,Gay-Hendrix,Kaitlinborough,Botswana,(007)769-4144x96722,(247)323-2881x0513,campbellglen@baxter-gonzales.biz,2021-06-26,https://www.kelly.biz/
14-Nov-2020,Bill,00.00,"144,044.95",00.00,D714f8EebcA6b80,4299,Patricia,Wise,Wall-Khan,Gainesfurt,Germany,973-818-8867,+1-109-429-8987x03818,sheri69@blanchard-burton.com,2022-03-29,http://www.woodward.com/
15-Nov-2020,Purchase,53.00,00.00,53.00,D50D23abB640878,1126,Jerome,Horn,Gibson-Shepard,West Luketon,Luxembourg,(843)059-8343,555.720.1946x09358,hallsusan@nelson-joseph.com,2021-01-25,https://www.noble.com/
15-Nov-2020,Interest,00.00,17.67,35.33,a2c9eeFD2B0EC97,8781,Candice,Crawford,Gray PLC,Rossfurt,Tonga,485.006.7348x1130,0842225941,robin39@grimes.com,2021-08-02,http://www.adams-beard.com/
15-Nov-2020,Transfer,00.00,35.33,00.00,F4195E9e1621bD7,960,Alison,Riggs,Hall-Blackburn,Judithbury,Ethiopia,960.068.4536,(071)103-8359x4594,duranshawn@bowers.com,2022-03-30,http://www.mullen-morris.com/
15-Nov-2020,Purchase,"4,071.10",00.00,"4,071.10",D3adB8EcC411db8,2649,Mathew,Choi,"Mason, Ibarra and Pace",East Gina,Somalia,524-019-0586x32049,279-862-5911x704,alejandro59@mcintosh.com,2021-07-20,http://www.kline-lozano.com/
15-Nov-2020,Cheque,"16,598.80",00.00,"20,669.90",62591BdCf896dE5,5909,Larry,Herring,Gibbs Inc,Malikland,United Kingdom,629-233-4454x25483,+1-229-524-4867,bryanmeredith@sawyer.org,2020-01-19,http://pope-baxter.biz/
15-Nov-2020,ATM,44.90,00.00,"20,714.80",Ff9ea1647acFb6B,4567,Jodi,Newton,Kaiser-Dorsey,Angelberg,United States Virgin Islands,832-114-1565x1026,001-951-329-3477,mackenziemcneil@stewart-manning.com,2020-01-23,https://randall.com/
15-Nov-2020,Cheque,"2,852.00",00.00,"23,566.80",7eDeE5dBFEaBD9C,5838,Jasmin,Cuevas,Wyatt-Walter,Orozcoshire,Kiribati,(905)027-3698x19725,001-341-012-5973x197,staffordsavannah@jarvis.org,2022-04-24,http://www.rojas-reeves.biz/
15-Nov-2020,Purchase,"26,407.47",00.00,"49,974.27",C7c74ec7c0EC5DD,9559,Cindy,Roth,"Alvarez, Sosa and Pearson",Lake Beverly,Greenland,+1-400-284-6158x2720,569-905-9588x7626,juliadavies@wells-waters.com,2021-03-01,https://www.horton-finley.com/
15-Nov-2020,Transfer,51.00,00.00,"50,025.27",2Fd3d1AFE2FbeE1,7249,Johnny,Gibbs,Mooney PLC,Mcdowellmouth,Sierra Leone,(922)213-0228x3570,001-203-981-3343x3179,careymargaret@logan.com,2021-01-31,https://www.marquez.info/
15-Nov-2020,Cash,321.14,00.00,"50,346.41",aB8dEb7cF7F338C,3839,Katrina,Dunlap,"Cunningham, Berg and Hughes",New Sheri,Honduras,148.243.7554,760-310-5308x529,miguel93@hendricks.biz,2021-03-23,https://hodges.com/
15-Nov-2020,Purchase,00.00,"5,594.05","44,752.36",F9C7d45Ef5Eed58,198,Stephen,Robbins,"Holt, Ewing and Deleon",Claudiahaven,Haiti,969.360.0190x7658,(360)355-3360x3498,cuevasgeorge@navarro-mcmahon.com,2022-03-24,https://mccarthy.com/
15-Nov-2020,IMPS,00.00,"4,972.48","39,779.88",6BF0F748795Ef68,1515,Johnathan,Stephenson,"Drake, Vaughn and Abbott",Herringland,Gambia,(200)506-2953x6401,666-564-1328x0955,isaiahlara@khan-garrett.com,2021-05-26,http://www.whitehead.biz/
15-Nov-2020,IMPS,00.00,"9,944.97","29,834.91",4ac3FBBD6a53390,1060,Lindsey,Frye,"Vega, Villarreal and Wheeler",Sherylburgh,Bouvet Island (Bouvetoya),425.493.0735,+1-939-128-1334,wendy75@newman.org,2022-02-07,https://www.yoder.com/
15-Nov-2020,RTGS,07.20,00.00,"29,842.11",6031baa7b9DF130,3765,Crystal,Davis,Tran-Zavala,Port Savannah,Poland,309-417-0204x611,001-164-880-6032x7398,chelsea91@good-morgan.org,2021-11-08,https://www.galvan.net/
15-Nov-2020,Bill,05.71,00.00,"29,847.82",1188C7553bDB6cd,2717,Micheal,Knight,Barrett and Sons,East Rose,Croatia,294.648.9937x128,(274)483-1425,katherine15@elliott-warren.info,2021-07-22,http://hayes-crosby.com/
15-Nov-2020,Tax,00.00,"3,316.42","26,531.40",EA3Ce80DDEB462d,2847,Ana,Haas,Bird LLC,Leeburgh,United States Minor Outlying Islands,001-214-798-8963,654-482-9824x8698,teresa21@mcfarland.biz,2022-04-11,http://powers.com/
15-Nov-2020,Reversal,"3,378.45",00.00,"29,909.85",86FC4E3087C3eD7,6246,Alan,Callahan,"Francis, Paul and Avery",Anahaven,Ecuador,(321)655-5671x37772,898-657-8110x81307,haileycherry@allen-cobb.com,2020-02-23,https://www.house-banks.com/
15-Nov-2020,ATM,04.00,00.00,"29,913.85",fe40333cFDFc6eB,4625,Ronnie,Schroeder,"Huff, Lowe and Cunningham",Blairmouth,Jamaica,149.938.8263x713,001-572-540-1085,ashley15@booker.com,2022-03-19,https://guerra-newman.biz/
15-Nov-2020,ATM,"29,190.00",00.00,"59,103.85",97acd1e5655a58C,6843,Joan,Mejia,"Ramsey, Wilkerson and Cooper",North Vicki,Puerto Rico,022.253.4820x42626,6798642114,friedmansummer@burns-chen.com,2021-08-14,https://www.bolton.com/
15-Nov-2020,Miscellaneous,00.00,"6,567.09","52,536.76",f0Fcfe0dB0BFdae,7546,Bonnie,Perkins,Sutton-Choi,Marioton,Singapore,001-906-473-5978x03292,1352570363,shaunhenson@parrish.com,2022-03-17,https://www.cooley.com/
15-Nov-2020,Debit Card,00.00,"17,512.25","35,024.51",339fbf1fe8096D6,4073,Dave,Hampton,"Horn, Crane and Day",East Sonia,Luxembourg,185.834.5802x084,001-784-299-8759x800,montesdaisy@browning-paul.com,2020-12-23,http://www.mccann.biz/
15-Nov-2020,Commission,00.00,"35,024.51",00.00,21b5Da71bc814aA,7116,Ebony,Franklin,Novak-Woodward,South Leonshire,Singapore,(644)366-4492x4516,8926761448,shannon15@hull-richards.com,2021-09-25,http://berger.com/
15-Nov-2020,Purchase,"222,479.50",00.00,"222,479.50",DcE3Ab0EE75b9E1,7488,Earl,Parrish,Rocha Group,East Stephanie,Panama,510-908-4956x46473,+1-379-207-7768x6488,nicholas95@mcfarland-stewart.com,2020-05-27,http://barnett.biz/
15-Nov-2020,Purchase,"3,145.89",00.00,"225,625.39",5F4892bAcEfc3ff,1974,Phillip,Pollard,Kline and Sons,Port Caseytown,Kuwait,+1-761-873-8836x57095,(874)698-0951x57206,meghandalton@glenn-madden.biz,2021-04-02,http://www.wood.com/
15-Nov-2020,NEFT,00.00,"32,232.20","193,393.19",FaD7BcB59a69F04,5344,Cole,Mcdowell,Martinez-Casey,Dillonview,Reunion,091.366.5461,+1-173-411-6745,drewknight@mckenzie.net,2021-06-01,https://silva-gates.com/
15-Nov-2020,IMPS,37.25,00.00,"193,430.44",160f25dBD433cb5,2768,Raymond,Ferrell,Brandt and Sons,Port Yolandahaven,Maldives,406.633.4946x02959,(505)277-2815,judithmontoya@dunn.net,2021-12-22,https://www.bernard.info/
15-Nov-2020,Cash,"23,081.60",00.00,"216,512.04",B0e0e2EF5CEDD25,810,Devin,Glass,Foster-Howard,Port Juliaview,Lithuania,(138)220-9880x6075,344.054.9744x972,tayloranthony@smith.org,2022-05-21,http://www.farmer.com/
15-Nov-2020,RTGS,00.00,"72,170.68","144,341.36",BE0E1c7FD8d54D9,6285,Maria,Bean,Nixon-Walters,West Charleneburgh,Vietnam,815-225-4166x1872,+1-952-402-5101,lauragriffin@dennis.info,2022-02-09,http://www.henry-gomez.com/
15-Nov-2020,Debit Card,00.00,"14,434.14","129,907.22",147387Db3f806D9,5139,Marvin,May,Rivera Ltd,West Katrinaborough,Seychelles,001-320-865-0560x87977,(032)886-6695x04824,tfranco@campos-boyd.com,2022-02-16,http://www.kim.org/
15-Nov-2020,ATM,07.40,00.00,"129,914.62",A5Ff9F7a17c0d0c,5224,Robyn,Roth,Greene-Rubio,West Adrienne,New Caledonia,+1-340-339-7433x63285,001-496-478-2943,dianarichmond@mercado.com,2020-12-08,http://johnson-chung.com/
16-Nov-2020,Reversal,00.00,"12,991.46","116,923.16",Cf5b3E6bDe2a93c,4693,Duane,Macdonald,Nolan PLC,Kaufmantown,Cyprus,(985)098-9066x2265,0718533231,yquinn@galloway-kelly.org,2022-05-09,http://www.singh-stark.info/
16-Nov-2020,Reversal,00.00,"19,487.19","97,435.97",7Ed614755a6fB40,9093,Adrienne,Grimes,Conley-Massey,West Carmenside,Cook Islands,001-470-380-0001x26435,(507)481-5526x599,daltonguzman@townsend.com,2021-08-13,https://www.duffy-oconnor.org/
16-Nov-2020,Cash,00.00,"97,435.97",00.00,a21Ce6067cD633E,360,Drew,Patterson,"Ruiz, Leon and Salinas",Diazmouth,Congo,+1-629-893-3866x5762,484-379-5918x42421,mbanks@dorsey-sanchez.biz,2020-01-25,https://www.hunter.net/
16-Nov-2020,RTGS,"227,222.41",00.00,"227,222.41",CfFCa1A289c824b,6711,Alfred,Kennedy,"Boone, Robertson and Morse",Barkerberg,Guinea,810-098-4074x823,001-951-761-0386x7820,stonebrittney@best.com,2021-03-09,http://www.shepherd.com/
16-Nov-2020,Tax,"1,366,813.00",00.00,"1,594,035.41",fA6f2A6b1bc2c0B,5357,James,Keith,Mays-Murray,Rangelview,Andorra,5282748394,+1-534-128-9357x931,arianarichards@vargas-bartlett.com,2020-02-27,http://www.fox.info/
16-Nov-2020,IMPS,"784,448.80",00.00,"2,378,484.21",0929F53A08faE52,6472,Tanya,Fuentes,Leonard-Hunt,Bobtown,Grenada,+1-302-340-3595x5894,(824)151-9119x448,isaiah58@burke.com,2021-09-08,https://hanson-wiley.com/
16-Nov-2020,NEFT,05.79,00.00,"2,378,490.00",57946C5bb887d0D,4631,Miguel,Kemp,Odonnell-Roberts,Barbaraburgh,Macedonia,001-006-991-3927,6828981454,beckyhowe@reeves.net,2020-11-10,https://holden.com/
17-Nov-2020,Commission,00.00,"297,311.25","2,081,178.75",2AdF17bc246Cd51,3351,Jimmy,Parsons,Valdez PLC,Joymouth,Tunisia,(391)523-2433x789,294-069-3486x9319,reedhayden@chen.info,2022-03-18,https://house.org/
17-Nov-2020,Interest,04.50,00.00,"2,081,183.25",30Ffff3C9Cdea0d,8708,Jaime,Allison,Winters-Bruce,Port Karinaburgh,Palestinian Territory,874.570.1802x2775,001-772-960-1204x673,haley47@petty.com,2021-09-16,http://atkins.com/
17-Nov-2020,Bill,00.00,"2,081,183.25",00.00,597df5C8A75B14D,1430,Dale,Solis,"Knapp, Huff and Garner",Spencertown,Jersey,(027)060-5731,054.420.9064x49651,jorge56@mendez-nicholson.biz,2021-08-04,https://coleman.info/
17-Nov-2020,Commission,"30,221.00",00.00,"30,221.00",f9Da46dDaF2FccC,6230,Alfred,Pena,Franklin LLC,Colliertown,Thailand,001-251-341-7476x1026,415.058.0950,gabrielleroach@li.org,2020-01-19,https://www.duffy.com/
17-Nov-2020,Cash,00.00,"4,317.29","25,903.71",9a00E62352Ec874,5681,Duane,Pearson,Fuller LLC,South Shirleychester,Uzbekistan,327-846-4136x247,001-627-861-9612,teresa89@robbins.biz,2021-03-23,https://blanchard.com/
17-Nov-2020,Reversal,00.00,"8,634.57","17,269.14",D5Ce15306dFde9b,6849,Kirk,Le,Downs-Boone,Connieview,Chad,986.831.0613x3159,481-095-6468x08735,garrett72@miller.biz,2021-12-09,http://garrett.com/
17-Nov-2020,Cheque,05.60,00.00,"17,274.74",c8C9AbEcaCEDD01,4399,Leonard,Glover,Lloyd LLC,Lake Jadeshire,Iceland,+1-031-520-3709x9130,(744)307-8807x0627,cole79@dillon-braun.net,2021-07-27,http://morse.org/
17-Nov-2020,Tax,00.00,"5,758.25","11,516.49",4c1FEa0fa8AD569,500,Lee,Boyle,Lang LLC,Vangmouth,Ethiopia,242-082-5755x4541,+1-092-028-1774,deanstacie@carson.com,2021-03-02,http://yu-george.com/
17-Nov-2020,Cheque,00.00,"1,151.65","10,364.84",fe8aBD23AD863eB,5387,Jeanette,Tanner,Miles Ltd,Rebekahtown,Austria,099.671.2570x16105,0070378809,kclay@nielsen-gray.biz,2022-03-11,https://www.brock.org/
17-Nov-2020,Commission,"3,012.00",00.00,"13,376.84",E8fA43fedefE20C,1958,Vanessa,Cain,"Pham, Roy and Gibbs",Ninachester,Bouvet Island (Bouvetoya),483.348.7492x5170,590-032-9673x62007,seancruz@chung.com,2020-08-06,https://payne-nielsen.com/
17-Nov-2020,Debit Card,320.90,00.00,"13,697.74",1f270C64Ffc08ab,2647,Johnny,Strickland,Collins PLC,Glennshire,Albania,+1-183-463-2732,+1-958-796-7553x8125,nortonclifford@newman-santos.biz,2020-08-05,http://www.fletcher.net/
18-Nov-2020,IMPS,36.08,00.00,"13,733.82",005EB04d7818AcE,4441,Kevin,Proctor,"Bray, Frederick and Holt",South Parkerview,American Samoa,727.213.2667x207,0914876216,robynramos@rivera-steele.com,2021-12-19,https://crawford.com/
18-Nov-2020,ATM,25.98,00.00,"13,759.80",eF265Ffe5F32251,2407,Darin,Frye,Barron PLC,Cunninghamburgh,Norway,137-447-1793,(540)399-2312,anna44@eaton-ferrell.com,2020-02-04,http://www.bruce-lin.biz/
18-Nov-2020,Cheque,00.00,"13,759.80",00.00,e7a408b98CF5de7,7707,Deborah,Cannon,Kerr-Gross,Shawnaborough,Tonga,(199)031-6824,(450)755-8359x86865,gvance@lin.com,2020-10-12,http://miles-meyer.biz/
18-Nov-2020,Interest,"179,277.00",00.00,"179,277.00",00edbFDE79692BC,5205,Wendy,Cardenas,Hoover Ltd,North Leslie,Western Sahara,7513221972,950-308-1916,alan39@payne.biz,2022-05-14,http://garrison-gomez.com/
18-Nov-2020,Commission,00.00,"44,819.25","134,457.75",9A32945a97f55a4,1318,Alexa,Chambers,Raymond-Huerta,West Justinton,Malawi,011.712.0179,001-294-280-0827,brady58@rios-gardner.com,2021-03-02,http://haynes.com/
18-Nov-2020,Interest,00.00,"67,228.88","67,228.88",AbF8bD3DDaAd3C7,3756,Ashlee,Cochran,Hickman PLC,Port Felicia,Burkina Faso,824-397-8126x7867,+1-810-552-9823x0585,dickersonmaria@lester-curry.com,2022-03-10,http://hines.com/
18-Nov-2020,Bill,00.00,"11,204.81","56,024.07",0A3b2f5F057B9FD,6010,Eddie,Mccormick,Bailey Ltd,Lake Jesusville,United Arab Emirates,(285)504-4426,001-104-343-3432x981,andrewsherman@davis.com,2021-01-01,http://www.hartman.com/
18-Nov-2020,Miscellaneous,04.98,00.00,"56,029.05",C9dBA2f2e264d80,6741,Angie,Huber,"Boyer, Bennett and Kirby",Autumnshire,Bosnia and Herzegovina,960-570-1312x12031,5399319942,gspears@frederick.com,2021-01-04,http://franco.org/
18-Nov-2020,Transfer,03.00,00.00,"56,032.05",3AD32Dab554fcaD,1373,Kyle,Jefferson,Farley-Mcgrath,Lorettatown,Australia,435-303-9388x292,(703)354-0004x2229,natalie51@reid.com,2021-07-13,http://cole-melton.com/
18-Nov-2020,ATM,00.00,"11,206.41","44,825.64",442D27014152266,9755,Mariah,Hensley,Lloyd-Schmitt,Port Angelaview,Sierra Leone,+1-375-554-4372x616,692.082.8435,thomas31@trujillo-bowers.info,2021-07-31,http://richard.com/
19-Nov-2020,Interest,00.00,"5,603.21","39,222.44",65EfcbFAaBc9755,171,Steve,Booth,"Cooke, Zuniga and Maldonado",North Glendaborough,Saint Helena,(390)652-3650x10148,995.423.9151x965,perry87@nichols.biz,2021-10-12,https://molina.com/
19-Nov-2020,IMPS,04.90,00.00,"39,227.34",3e61E93EE5BdA6C,5330,Kerry,Giles,Sharp-Salazar,Eddieton,Czech Republic,+1-836-193-5017,106-257-0584x356,alejandroconley@burch.com,2020-12-10,https://barber.com/
19-Nov-2020,IMPS,00.00,"19,613.67","19,613.67",0Ba16339Ec9a97a,160,Bridget,Vaughan,"Ponce, Wade and Cowan",Lake Cristian,Svalbard & Jan Mayen Islands,(097)547-0859,0841167321,kari95@henry.org,2021-01-31,https://weber.net/
19-Nov-2020,Tax,71.60,00.00,"19,685.27",FA1BAa4BabCD83A,4225,Tony,Huang,Abbott-Pena,Boothfort,Syrian Arab Republic,884.384.2903x23861,010-516-8943,michele72@garrett.org,2020-07-04,http://www.newman.org/
19-Nov-2020,ATM,272.55,00.00,"19,957.82",A7aC1b5E554b41C,9965,Rita,Berry,"Fernandez, Nielsen and Ortiz",Frankside,Egypt,808.643.9160,408-324-9457,mcknightvictor@owen.com,2022-01-17,https://pope.com/
19-Nov-2020,Tax,00.00,"2,494.73","17,463.09",659E922BDc0b2a1,7180,Daryl,Cross,Carney and Sons,Miatown,Guyana,(793)766-8763x525,230-638-3215,mossclaire@wright-wallace.biz,2020-07-29,http://www.bailey-holloway.com/
20-Nov-2020,Cheque,00.00,"5,821.03","11,642.06",B7A38CEFF3c04F6,9960,Carl,Lin,Chapman Group,Timothychester,Antigua and Barbuda,001-054-077-3590x9538,4210511927,stevensonstuart@leon.com,2022-02-28,https://sandoval.com/
20-Nov-2020,Transfer,00.00,"3,880.69","7,761.37",eE5a4e00d9Be04a,4740,Patrick,Hughes,"Blackburn, Fritz and Soto",North Taylormouth,Holy See (Vatican City State),002.356.5147x00309,5810688916,greg00@strong-chang.net,2020-11-30,http://www.summers.com/
20-Nov-2020,Cash,"19,451.83",00.00,"27,213.20",13BbcBAFeb8EbF1,3143,Johnathan,Hancock,Thomas Ltd,South Reginastad,Qatar,(459)591-9891x9329,001-600-403-0864x7546,zmaynard@gaines.info,2020-06-06,https://www.richards.info/
20-Nov-2020,NEFT,00.00,"3,887.60","23,325.60",E1D7a92cd7Bd9ba,9047,Jaime,Burnett,Vega and Sons,Molinaton,Chad,001-022-466-2918x7201,953.563.1751,cherylserrano@ballard.com,2020-03-03,https://ali-ferrell.org/
20-Nov-2020,Debit Card,02.34,00.00,"23,327.94",7FE2bDC4a7d25AF,5394,Donna,Cline,Landry-Cross,West Selenafurt,Maldives,+1-797-536-7823x4448,654.741.0759,everettisabel@rangel.com,2020-10-02,http://richards.com/
20-Nov-2020,ATM,00.00,"11,663.97","11,663.97",87Beaf1eBCb7B5b,9192,Alejandro,Conley,Suarez-York,Sallyland,Central African Republic,099.850.6431x14971,(153)669-7485x4467,nelsonkari@thornton.com,2020-05-11,https://www.schroeder-hernandez.net/
20-Nov-2020,Reversal,00.00,"3,887.99","7,775.98",Be68a1f75F6cBCB,7681,Ross,Zimmerman,Dickson-Thompson,East Albertshire,Uruguay,304-826-2097x5386,001-750-249-2695x959,chelsea02@sharp-flynn.net,2020-12-22,http://www.holmes.com/
20-Nov-2020,RTGS,"2,088,811.80",00.00,"2,096,587.78",f7F909A8143F0D5,7112,Tiffany,Bass,Brewer-Obrien,Wiseville,Myanmar,331-716-9416x957,+1-111-306-0496,preston28@simon.net,2020-05-21,https://rubio-haynes.com/
20-Nov-2020,Debit Card,02.70,00.00,"2,096,590.48",8bebEEd1A3D8108,4065,Jesus,Marsh,Washington-Thornton,Lake Shawnamouth,Mauritius,(045)364-4689x018,709.091.2452x913,ana28@griffin.com,2020-07-09,http://www.graves-yates.com/
20-Nov-2020,IMPS,00.00,"349,431.75","1,747,158.73",cE19c4B101cD7bF,3075,John,Fields,Sandoval-Ponce,West Lisa,Ireland,563.414.4375,(287)463-1916,jessicasimpson@ewing.org,2021-11-05,https://curtis-rocha.org/
20-Nov-2020,Miscellaneous,45.00,00.00,"1,747,203.73",72AD1509E35FFB2,2528,Hailey,Zamora,Holloway-Hatfield,Acostaberg,Namibia,644.633.3850x67815,(779)904-8242,rdouglas@mcknight.com,2021-02-04,http://www.jenkins-pruitt.biz/
21-Nov-2020,NEFT,05.04,00.00,"1,747,208.77",696c6A3aDE5Cc08,8521,Carla,Gamble,"Weaver, Harrell and Hanna",Sethfurt,Vanuatu,313-205-1196x6372,954.346.0670x911,ethanbush@waller-andersen.com,2020-09-16,https://neal-bullock.net/
21-Nov-2020,Cash,00.00,"291,201.46","1,456,007.31",1f7BBF50fCfE25a,7084,Marissa,Robbins,"Franco, Gross and Ayala",Mitchellberg,Belarus,001-112-477-2281,001-669-430-3653x565,beardandres@lee-bartlett.info,2022-04-19,http://avila.com/
21-Nov-2020,Tax,262.75,00.00,"1,456,270.06",E3D5B6ee13A76eE,2255,Mitchell,Duarte,"Mcfarland, Boyle and Bender",Rickberg,Nepal,478.634.2906x2672,127-991-5720,kaylee69@george-gilmore.com,2020-11-30,https://gould-diaz.biz/
21-Nov-2020,Cheque,00.00,"208,038.58","1,248,231.48",E2BDceAcC8947Fd,3443,Leah,Baird,Ferrell-Carney,Mullenshire,Jamaica,920-425-5587x25484,001-289-101-5858,christinale@stevenson.info,2020-11-01,https://fitzpatrick.com/
21-Nov-2020,Purchase,"2,143.72",00.00,"1,250,375.20",1586F447E7E2C88,2131,Jonathan,Sloan,Robinson Inc,Raymondton,Brazil,001-543-376-4039x834,(200)828-2914x00513,rangelrachael@carr.net,2021-09-13,http://www.wade.com/
21-Nov-2020,Transfer,"4,043.80",00.00,"1,254,419.00",dE4A3EeFBe8fEDa,8221,Henry,Cherry,Young LLC,New Damon,Indonesia,001-132-580-7917,+1-966-552-6754x33300,amorton@bell-lane.org,2021-10-17,https://andersen.org/
21-Nov-2020,Cash,00.00,"313,604.75","940,814.25",f3831cb4cbeFB2e,1299,Rodney,Sparks,Cabrera PLC,South Alan,Wallis and Futuna,(162)929-4966x02329,+1-243-393-6517x549,fitzgeraldsandy@oconnell-rollins.com,2021-10-08,https://www.greer.net/
21-Nov-2020,Cash,00.00,"134,402.04","806,412.21",1bf18C935CFb182,3453,Aaron,Dyer,"Roberts, Austin and Hale",Franceston,Madagascar,+1-327-109-9246x5636,184-006-7292,dsummers@page.biz,2021-04-19,https://www.stokes.com/
21-Nov-2020,Cheque,00.00,"134,402.04","672,010.18",aBb40F04d1F5A0A,3903,Tyler,Dyer,Galvan Group,Moranview,Iraq,349.660.5542,001-369-699-8295x24013,jon39@merritt-deleon.net,2022-05-07,http://www.dalton.com/
21-Nov-2020,Purchase,04.38,00.00,"672,014.56",B4d02ec0f67FdDd,4008,Isabel,Spence,Melendez-Hobbs,West Nicholas,Thailand,(940)558-2369x91831,872.351.2292x05858,drichardson@thompson.net,2021-01-10,https://gill-stout.com/
21-Nov-2020,Reversal,00.00,"67,201.46","604,813.10",5CadAa9a1F50adB,3466,Gabriel,Gomez,Villarreal-Morales,Torresville,Senegal,101.248.2284,001-273-174-5529x600,vmahoney@wiggins-flowers.com,2020-12-15,http://www.hoffman.com/
21-Nov-2020,RTGS,00.00,"67,201.46","537,611.64",eC8beEC3dcB9fA0,566,Jodi,Fowler,Pitts-Lowery,Castilloview,French Southern Territories,(770)638-4350,(892)611-4626x440,burnettjohnathan@pena.info,2021-04-24,http://www.stewart-mann.info/
21-Nov-2020,RTGS,"1,663,480.00",00.00,"2,201,091.64",eF0b0cfcDFe4C8F,9985,Jaime,Patel,Richard-Frost,Port Evelyntown,Sudan,000-256-0158,8632275982,jsandoval@weaver.com,2021-06-11,https://tanner-silva.com/
21-Nov-2020,Bill,00.00,"366,848.61","1,834,243.03",eD2beaBab3f749a,9945,Jerome,Norman,Vargas and Sons,Stokestown,Timor-Leste,001-271-274-3044x4118,967-929-7687x033,fsnyder@rhodes.net,2021-09-13,https://warren.com/
22-Nov-2020,Cash,00.99,00.00,"1,834,244.02",1F1dB9afA5C0dEa,1416,Adriana,Clark,Riley-Tapia,West Janefurt,Guam,311-903-6878x123,969-861-2386x8241,jacobwatkins@george.net,2020-05-28,https://velasquez.com/
22-Nov-2020,NEFT,20.00,00.00,"1,834,264.02",FADb6fb75C85226,7643,Amber,Schaefer,Preston Group,Derrickmouth,Suriname,847-709-9847x948,001-357-629-6425x160,madeline47@browning.com,2020-09-12,https://choi.info/
22-Nov-2020,Miscellaneous,"90,437.30",00.00,"1,924,701.32",291e2a66b9ac66D,5114,Dylan,Lin,Hanna LLC,Rayside,French Polynesia,074-522-6106x934,(016)905-8785x5550,fryrichard@rios-johnson.com,2020-08-19,http://sanders.com/
22-Nov-2020,ATM,00.00,"962,350.66","962,350.66",3Bde0AecDdcd9B5,3422,Janice,Daniel,"Jensen, Cooley and Merritt",South Terranceshire,Guinea,(085)451-7811,(454)438-6204,katrina61@kramer.com,2022-04-21,https://www.johnson.biz/
22-Nov-2020,Tax,772.00,00.00,"963,122.66",2767ABc11576256,951,Devon,Ellis,"Wilcox, Sawyer and Walter",Aliland,Albania,(371)254-8019,+1-017-156-5577x813,bjuarez@leon.com,2020-09-05,http://archer.com/
22-Nov-2020,Cheque,00.00,"192,624.53","770,498.13",0507bEE6705B1Be,2239,Janice,Walsh,Hall PLC,Curtisshire,Hong Kong,339.659.9922,292-296-2107x486,millsariana@vincent-pittman.com,2022-04-02,https://www.camacho-george.com/
22-Nov-2020,Reversal,00.00,"128,416.36","642,081.78",B9EDf9fE373df4d,1376,Gerald,Salinas,Moore and Sons,Micheletown,Montenegro,+1-622-637-0984x117,(957)190-5716,tcardenas@koch.com,2021-09-02,http://craig.biz/
22-Nov-2020,IMPS,289.30,00.00,"642,371.08",84a37Cb3792AAdD,8325,Natalie,Merritt,Whitaker and Sons,Lake Samanthaland,Azerbaijan,001-609-457-1190x533,(350)382-2521,tonyalara@landry.com,2021-05-31,http://www.fox-moore.com/
22-Nov-2020,Transfer,499.70,00.00,"642,870.78",CBfdD9f1e70AC78,6135,Dominic,Bush,Vazquez PLC,Port Gina,Mali,438.434.7616x397,+1-395-376-6671x6083,ajohnson@moyer.com,2020-10-15,http://davila.com/
22-Nov-2020,Transfer,00.00,"91,838.68","551,032.10",5Fe6A5796fc19c5,6991,Veronica,Prince,"Bennett, Allison and Brandt",Lake Hector,French Guiana,521-877-7221x7293,001-332-408-6052x2867,doughertyterry@bender.info,2021-06-11,http://spears-mccoy.com/
22-Nov-2020,ATM,"902,256.80",00.00,"1,453,288.90",9163deeC45020Fe,7635,Emily,Sharp,Anderson Inc,South Edwin,Taiwan,898.240.8662,358.268.7598,iwatkins@sanchez.com,2020-07-01,https://www.cantu.org/
22-Nov-2020,Cash,"197,432.00",00.00,"1,650,720.90",EBacAAA71010CD8,6736,Breanna,Travis,"Villegas, Rodgers and Andrews",Traceyhaven,Bhutan,194-080-4778,519.239.6958x84362,albertmullen@soto.net,2021-01-09,http://www.donaldson-lowe.org/
22-Nov-2020,NEFT,"2,099.07",00.00,"1,652,819.97",f4aD7548C1c3C9C,5320,Michael,Daugherty,Paul-Reilly,Bobview,Saint Martin,(557)411-6536,058-979-3609x690,bryantmelinda@leblanc.biz,2021-04-04,https://ortiz.net/
22-Nov-2020,ATM,"229,747.00",00.00,"1,882,566.97",bb73D4b16c10c22,4603,Kara,Fuller,Carney-Perkins,East Brookeland,Philippines,674-187-1327x06750,001-992-118-8078x176,cheryl30@cox.com,2021-08-02,https://www.hart.com/
22-Nov-2020,Reversal,00.00,"268,938.14","1,613,628.83",7F4cA4bC877ffEE,5927,Valerie,Hodge,"Nash, Dougherty and Gallegos",Haileymouth,Armenia,574.808.9283,111-390-0972x95526,hwaters@murillo.com,2020-10-15,https://www.foley.com/
22-Nov-2020,Interest,"3,721.00",00.00,"1,617,349.83",7FbdA5BEF5Fd39d,9831,Todd,Michael,Barr and Sons,Hamiltonton,Falkland Islands (Malvinas),(833)177-1811x777,+1-736-331-9814x49621,dalton16@frey.info,2020-05-06,https://wright-burnett.net/
22-Nov-2020,Transfer,05.20,00.00,"1,617,355.03",1beD5BFC5C034D5,8484,Roberto,Payne,"Day, Massey and Dyer",Port Alejandrahaven,Jamaica,6524853010,138-198-7253,idavis@sheppard.net,2020-02-24,http://www.fisher-graham.com/
22-Nov-2020,Purchase,00.00,"161,735.50","1,455,619.53",dfdb4D3CafBfcde,2732,Nichole,Sosa,"Choi, Flores and Morgan",West Harold,Samoa,9780713652,001-291-967-7030x1344,gvilla@clarke.com,2021-02-11,https://norton-cook.com/
22-Nov-2020,Purchase,00.00,"363,904.88","1,091,714.65",6800CCbFb15ebf1,1997,Norman,Sosa,"Pitts, Dougherty and Petty",West Holly,Bouvet Island (Bouvetoya),154.383.5296x028,164-866-6809,lindacraig@guzman-estrada.biz,2020-07-30,https://www.sheppard.com/
22-Nov-2020,ATM,"29,862.00",00.00,"1,121,576.65",A92054Cd8b9D34e,6879,Samuel,Mccormick,"Reed, Phelps and Gray",Claytonland,Thailand,+1-794-566-3044x91163,749-385-2991x87686,bonnie24@perkins.com,2020-05-24,http://www.caldwell.org/
22-Nov-2020,Debit Card,"8,506.19",00.00,"1,130,082.84",0dD33e46C7bE769,6391,Charlotte,Richards,"Atkins, Austin and Wiley",Tomtown,Nepal,001-926-089-1322x021,8230513700,yrobbins@macdonald.com,2020-06-15,https://www.yu.info/
22-Nov-2020,ATM,00.00,"565,041.42","565,041.42",58DEaeF3df1dB4D,2598,Eric,Shepard,Whitney Ltd,Mayshire,Austria,748-496-6988,+1-009-078-2471x8921,autumn39@flores.info,2020-05-11,https://medina-peters.info/
22-Nov-2020,Interest,00.00,"188,347.14","376,694.28",106027EF3688844,3666,Tristan,Farmer,Francis Ltd,South Gabriellatown,Saint Kitts and Nevis,150-687-4659x3786,3500906497,chamberstraci@cardenas-haney.com,2022-02-28,https://ferrell.com/
22-Nov-2020,Purchase,"221,597.90",00.00,"598,292.18",cfE22Ab14e04E4f,8152,Kristen,Gilmore,"Wyatt, Oconnor and Caldwell",Villanuevatown,Germany,(353)053-5976,897-447-6689,desiree54@rosales-obrien.com,2020-09-18,http://walls.com/
22-Nov-2020,RTGS,08.29,00.00,"598,300.47",BEb090eEcd50deD,7060,Misty,Strickland,Lin Inc,New Brandon,British Indian Ocean Territory (Chagos Archipelago),254.934.8712x60950,641.001.4447x3970,blackburnkristopher@blackburn.biz,2020-05-02,http://massey.com/
22-Nov-2020,Miscellaneous,"3,340.00",00.00,"601,640.47",EE526B8Fbde0AE6,5195,Adrienne,Novak,Douglas Inc,Stacietown,Singapore,250.749.5145x2466,386.700.8102x9602,snolan@ochoa.org,2021-12-07,https://cline-hensley.net/
22-Nov-2020,Interest,"1,945,724.80",00.00,"2,547,365.27",f1d636E3Ae03dAA,7677,Becky,Bullock,Massey Inc,Port Brittney,Canada,001-920-757-4752,+1-056-604-7720x7148,reyesshelby@cantu.biz,2020-09-09,https://www.gardner.com/
22-Nov-2020,Transfer,00.00,"509,473.05","2,037,892.22",4ac6566fbd45D1d,4377,Willie,Morales,Wu Ltd,Port Carlos,Malawi,620-810-9894x2242,4189002252,judithhogan@mahoney.net,2021-01-14,http://paul.com/
22-Nov-2020,Transfer,"17,454.00",00.00,"2,055,346.22",dd509eaBA3F8089,260,Patrick,Barnett,"Riley, Phelps and Castro",Gabrielleland,Saudi Arabia,486-945-7392x76409,907-200-5367x69663,cassie94@booth.biz,2021-08-12,https://melton.com/
22-Nov-2020,Reversal,00.00,"342,557.70","1,712,788.52",0D5f3351A8aF3F8,837,Savannah,Miller,Hurst and Sons,Hammondtown,Croatia,789-182-3093x002,670.210.9484x4151,ronniepatton@ashley.com,2022-02-04,https://www.lyons.com/
22-Nov-2020,Miscellaneous,"1,044.00",00.00,"1,713,832.52",E2Db2C74d54fD8E,774,Crystal,Wilkinson,Buck-Good,Port James,Bulgaria,040.967.3830x85094,869.043.6506,nathaniel99@rubio.info,2020-12-06,https://diaz.com/
22-Nov-2020,Commission,00.00,"190,425.84","1,523,406.68",dd6BBbdEFD7A1e6,8068,Rebecca,Fowler,"Walton, Salas and Rosales",Lake Ronnieburgh,Maldives,184-815-5397,874.398.1523,ihouston@long-skinner.info,2020-10-26,http://www.hughes.com/
22-Nov-2020,Interest,38.10,00.00,"1,523,444.78",01ccDdeBCfA0579,3123,Fred,Oconnor,Carpenter-Wheeler,Jefferyton,Djibouti,+1-346-364-8014x66653,8550810356,bnewman@roberts-small.com,2021-05-18,https://www.tate-graham.org/
22-Nov-2020,Tax,"32,639.73",00.00,"1,556,084.51",6043B3aEDeB001b,585,Victor,Donaldson,Beard Ltd,Port Claire,Romania,408-072-6826x680,001-354-947-3754x916,gabriella33@huerta.com,2021-04-27,http://morales.org/
22-Nov-2020,Cheque,00.00,"518,694.84","1,037,389.67",88A1c9A2462DDe9,7563,Kristie,Black,Booth-Matthews,Rebeccachester,Togo,705-262-4238,001-854-954-0084,boltonsteven@ibarra-ho.com,2020-11-26,http://www.gallagher.com/
22-Nov-2020,Bill,05.00,00.00,"1,037,394.67",22D621f990AA28c,3778,Bradley,Park,Clements-Curtis,West Barryborough,San Marino,(411)060-0600x58715,(696)895-1708x60556,bonnie48@fritz-costa.org,2022-05-26,https://montoya.com/
23-Nov-2020,Commission,00.00,"115,266.07","922,128.60",66EE3788a20e1f7,6094,Eddie,Mendoza,Mckee-Anderson,Nicoleside,Jordan,007.511.3746x345,+1-825-973-9771x3984,zunigajoan@wilkerson-hendrix.com,2020-01-23,http://www.erickson-rollins.org/
23-Nov-2020,ATM,"659,066.00",00.00,"1,581,194.60",cAFAADf9faa4C17,4622,Caitlin,Vincent,"Shepard, Mata and Newman",Cabrerashire,Somalia,408-359-8660,(455)047-8411x3098,jermaine61@woodard.com,2022-01-30,https://ochoa.com/
23-Nov-2020,ATM,257.00,00.00,"1,581,451.60",fe48DdfFa269FB2,2999,Kenneth,Mcdonald,Savage LLC,Stephenberg,Burkina Faso,+1-653-702-1534x287,370-138-7666,mcintoshcaleb@hogan.info,2020-01-14,http://www.shannon.com/
23-Nov-2020,Reversal,00.00,"225,921.66","1,355,529.94",e579EE45fe95AdE,713,Jackie,Whitaker,Christian PLC,Lake Catherine,Vietnam,828.391.9202,1433171103,xgalloway@young-singleton.com,2021-12-02,https://li.com/
23-Nov-2020,IMPS,00.00,"135,552.99","1,219,976.95",dB438DAa2D14cC8,516,Frederick,Valdez,Burnett-Lowery,Jacksonfurt,Luxembourg,001-168-547-8993x47666,214-410-1000x86942,vcarpenter@humphrey.com,2020-09-10,http://fuller.net/
23-Nov-2020,ATM,00.00,"203,329.49","1,016,647.46",1f902AB4DB3Afa5,641,Wendy,Kline,"Parks, Bonilla and Wright",Annaborough,Liberia,439-686-6897x955,+1-954-840-7514x8329,luisnorman@clay-reilly.org,2021-12-01,http://www.hensley.com/
23-Nov-2020,Reversal,"158,929.09",00.00,"1,175,576.55",6Fecdbe3D32D557,680,Kylie,Sellers,Frost-Moreno,East Anna,Sierra Leone,0807147436,561.188.4914x29747,mcfarlandbilly@ford.biz,2021-11-09,http://mendez.info/
23-Nov-2020,Commission,"163,331.00",00.00,"1,338,907.55",9eAeE9Af1dfaE25,7778,George,Mason,"Blanchard, Gibbs and Franco",Irwinshire,Brunei Darussalam,+1-433-517-8394x7079,846.745.6818,rmcfarland@good.com,2020-12-17,http://www.houston.info/
24-Nov-2020,Interest,"2,691.00",00.00,"1,341,598.55",f1faebFDF1Ee1dE,7785,Jamie,Houston,"Reid, Keller and Ellis",New Reginaldland,Maldives,001-523-482-9298,(780)414-1126x89792,spencestuart@richard-alvarado.org,2020-12-29,https://holmes.net/
24-Nov-2020,Cash,00.00,"447,199.52","894,399.03",cdeEE7cbc8DD57B,4301,Yvette,Blake,Waters and Sons,Lake Curtis,Burundi,+1-649-525-0885x3863,9061380375,russotracy@benson-hodge.com,2020-04-04,http://www.powers.com/
24-Nov-2020,Bill,00.00,"127,771.29","766,627.74",5EFecD4Ffdfe83B,6031,Clayton,Hanna,"Frank, Cooper and Fisher",Meghanmouth,Vanuatu,848-883-4894x699,(066)198-7738x3268,uramos@dalton-mullen.org,2021-08-25,https://www.ashley.info/
24-Nov-2020,NEFT,00.00,"255,542.58","511,085.16",30cFbF2cdeA99EF,6292,Gabriela,Branch,"Rasmussen, Daniels and Rogers",New Gilbert,Mexico,0933663417,704-665-7790x8983,dawn45@burke.com,2021-12-08,https://boyle-browning.com/
24-Nov-2020,Debit Card,00.00,"56,787.24","454,297.92",eC83DEa5B25B8e6,7959,Ralph,Dougherty,Luna PLC,Donhaven,Cayman Islands,790.463.1260x1371,001-923-977-2120,natalie38@vang-obrien.com,2020-02-12,https://www.kline.com/
24-Nov-2020,Cash,389.24,00.00,"454,687.16",e3E846defcaC4Fa,2157,Tabitha,Mendez,Faulkner-Novak,Katrinaton,Bahrain,071.074.5629,929-840-2669,markscaleb@diaz-roth.com,2021-10-23,http://sutton-perry.biz/
24-Nov-2020,Tax,00.00,"64,955.31","389,731.85",D9e3c6dCE0D1d4c,2744,Jeanne,Farrell,"Martin, Mcclure and Conley",East Ellen,Korea,622-847-6153x2911,345-137-0848x42951,kristine34@rivas-suarez.net,2020-07-15,https://boyer.com/
24-Nov-2020,Commission,00.00,"194,865.93","194,865.92",C7ea2F05ECFFC1d,4303,Bob,Nunez,Fox-Hodge,Port Laceyfort,Tokelau,+1-255-741-7308x51133,493.902.7517,hmcgrath@michael-schultz.com,2020-08-17,https://zhang.com/
24-Nov-2020,ATM,"3,949.00",00.00,"198,814.92",90D853A55e68d3e,5702,Regina,Wheeler,"Sims, Hardy and Esparza",Clairehaven,Guinea-Bissau,2979664806,559.551.0348x515,isaacmercer@kelley.com,2021-10-19,http://www.douglas.com/
24-Nov-2020,Miscellaneous,00.00,"99,407.46","99,407.46",3F6df9C42AAD5E1,4507,Samantha,Whitehead,"Shelton, Booker and Morales",Riggsburgh,Mexico,283.215.7200x7282,+1-448-131-8298x6715,ericksonmakayla@acosta.org,2022-05-03,https://harrington.com/
24-Nov-2020,Cash,"23,142.50",00.00,"122,549.96",280ccddE4302CbD,5848,Kenneth,Hogan,Velazquez-Walker,Goodmanhaven,Lesotho,028-041-1457x5362,150.470.5889x3676,coxbobby@brady.net,2020-12-31,http://www.clay.com/
24-Nov-2020,Interest,07.10,00.00,"122,557.06",CA416877BCc63B5,4614,Francisco,Mckee,Daniel Inc,West Rickymouth,Cambodia,+1-664-418-6315x95083,5463161505,staceyhamilton@villa.com,2020-06-19,https://key.net/
24-Nov-2020,ATM,"14,545.11",00.00,"137,102.17",afcACDAae7ae7cC,6951,Bob,Bonilla,Sawyer-Acevedo,North Terrance,Barbados,+1-954-175-5823x340,(987)517-1030,opalmer@cooke.net,2020-11-14,http://www.ray-cochran.com/
24-Nov-2020,RTGS,00.00,"68,551.09","68,551.09",43CBf9ff825E10f,3308,Kari,Mercer,"Dodson, Baxter and Raymond",Hodgesshire,Montenegro,+1-788-058-7303,288.830.4455,annawu@vasquez.net,2020-12-30,http://vargas.info/
24-Nov-2020,Purchase,00.00,"68,551.09",00.00,fAB97e675E327F3,6395,Philip,Shannon,"Butler, Perez and Christian",Lake Danburgh,Saint Pierre and Miquelon,253.805.6031x67014,2509607820,schristian@frey.org,2020-09-06,https://hicks.net/
24-Nov-2020,Transfer,499.10,00.00,499.10,74f8Ef1AccabE68,9251,Brittney,Downs,"Merritt, Powell and Briggs",Eugeneview,South Georgia and the South Sandwich Islands,936-822-8317,001-228-322-1830x0718,zbernard@shaffer-christensen.biz,2022-03-11,http://www.harper.info/
24-Nov-2020,Miscellaneous,00.00,124.78,374.33,b9Be8b78fdc6855,2268,Nicholas,Wagner,Lozano-Copeland,Jeremyfort,Belgium,001-587-273-8752x75427,545-994-2839x7784,jillianbooker@mills.com,2022-02-03,https://www.dudley.com/
24-Nov-2020,Bill,997.90,00.00,"1,372.23",A72a000b54dBcdA,3320,Tyrone,Friedman,Rivas-Dyer,Joycechester,Faroe Islands,019-527-6736x03280,6451866526,noah84@bush-peters.org,2022-02-10,https://www.ellis.net/
24-Nov-2020,Cheque,06.00,00.00,"1,378.23",15aCEa7A1429dbB,6317,Warren,Schneider,Crosby and Sons,Jorgeville,Egypt,001-490-286-3089x440,+1-699-439-5730x049,ibauer@nguyen.com,2021-02-20,http://www.salazar.com/
24-Nov-2020,Cash,"262,075.69",00.00,"263,453.92",37ed252DFAA5BEd,890,Summer,Myers,"Massey, Sherman and Mckinney",Kimbury,Serbia,453.702.0051,(516)442-5898,dylan60@wilkerson.com,2020-03-18,http://holland.com/
24-Nov-2020,Reversal,468.65,00.00,"263,922.57",31B68C3A8c8c3Bb,6503,David,Page,Rivera-Rivera,New Normaland,United States Virgin Islands,001-751-614-9145x35749,304-445-3680,jacob41@pierce-cruz.com,2020-06-17,http://www.johnston.com/
24-Nov-2020,Tax,306.11,00.00,"264,228.68",fEDE736fa595485,5434,Peggy,Skinner,"Conway, Trevino and Chang",Julieton,Croatia,(656)258-3354x881,(420)427-3082x69268,annettegordon@bradford-fitzgerald.com,2021-12-05,https://www.stafford.net/
24-Nov-2020,RTGS,00.00,"264,228.68",00.00,238aF9eBbB8b1cd,870,Carly,Goodman,"Gomez, Chapman and Villarreal",Tiffanyfort,Mali,110-760-4208x740,234.218.1772x6891,holly09@burke.com,2021-09-28,http://lin.com/
24-Nov-2020,Debit Card,"588,056.50",00.00,"588,056.50",Fe9B4De4DC87d8a,2159,Jean,Bennett,Welch Inc,Cooperfurt,Guatemala,(567)792-4538x39826,001-997-798-0860x828,pelliott@carlson-zhang.biz,2021-04-05,https://compton-lyons.com/
24-Nov-2020,Miscellaneous,50.20,00.00,"588,106.70",5dAcb0eC6AE7e30,8121,Catherine,Barrett,Lara Ltd,Lucasbury,Senegal,423.266.1108,778-557-1404x74354,latashaharding@frost.com,2022-04-02,https://pace-page.com/
24-Nov-2020,IMPS,00.00,"58,810.67","529,296.03",CFefa76aB91EaD6,1621,David,Figueroa,Coleman Ltd,New Vicki,Norfolk Island,128.691.1808x0491,+1-251-523-4339x2439,maxwell03@whitaker-shaffer.com,2022-02-19,http://www.green.com/
24-Nov-2020,Cash,"16,548.71",00.00,"545,844.74",5Fece6694B192e8,6137,Diana,Carroll,Bolton Inc,Port Tracey,French Guiana,264-623-7629,+1-852-236-0166x070,penningtonphillip@stafford.net,2021-02-12,https://fischer-craig.com/
24-Nov-2020,RTGS,"1,384.00",00.00,"547,228.74",92bFddD0C16C99c,342,Brent,Maldonado,English and Sons,New Darren,Puerto Rico,665-732-3833x685,+1-194-449-2684x4178,phillip17@wade.net,2020-02-02,https://www.dominguez.biz/
24-Nov-2020,Interest,06.00,00.00,"547,234.74",A0BFCD290BB9Ffc,5570,Ruben,Hutchinson,"Hicks, Hunt and Fuentes",Kelleyberg,French Polynesia,763-794-0913x5540,652.420.4168x747,mathewrogers@little.com,2021-07-13,http://www.erickson.com/
24-Nov-2020,Interest,00.00,"547,234.74",00.00,Bc9Cda3AAEED2DA,434,Kristi,Dixon,Kim Inc,South Rodneystad,Palau,(523)214-3540,001-614-536-6394,lindsaymiranda@atkinson.info,2021-12-04,https://wiggins.com/
24-Nov-2020,Miscellaneous,451.04,00.00,451.04,0c3BFAea87873e4,8276,Kirk,Hull,Cunningham LLC,Deborahhaven,Nepal,+1-177-273-5731x350,9020051327,brittany74@warren-williams.info,2022-03-02,http://merritt-maynard.com/
24-Nov-2020,Cheque,"12,985.73",00.00,"13,436.77",56124Dc5553DDc0,5319,Derek,Chambers,Knox-Cooper,Port Savannahview,Taiwan,+1-627-339-7450,+1-473-653-3405x171,ralphperez@blake.com,2020-09-10,http://www.kirby.org/
24-Nov-2020,NEFT,"675,670.00",00.00,"689,106.77",d5A99Eb3AC6F6ca,5782,Jonathan,Cohen,"Barr, Mcgee and Archer",Lake Cesarburgh,Nauru,424.665.2177x40509,(442)095-8222x98019,lozanoisabella@little.com,2020-01-25,http://www.hatfield-golden.org/
24-Nov-2020,IMPS,00.00,"68,910.68","620,196.09",FB358C9e5bC0E12,2188,Jackie,Becker,"Ramos, Bryant and Goodwin",West Shane,Brazil,001-911-744-0581,001-070-356-5674x587,haguirre@cherry.com,2021-01-13,http://www.reese.com/
24-Nov-2020,Cash,"29,714.80",00.00,"649,910.89",FeD98cAd15eFAB7,934,Kevin,Cantu,"Bowers, Todd and Hansen",East Parker,Albania,(238)436-6057,950.654.7052x53552,miatravis@carney-riddle.com,2020-02-25,https://www.rush.com/
24-Nov-2020,Purchase,00.00,"72,212.32","577,698.57",5b0b116e0976700,601,Kathleen,Middleton,Mcdaniel and Sons,Derrickshire,Brunei Darussalam,(797)881-0287,988.927.5270,danielwyatt@shannon.info,2021-01-01,https://herrera.com/
24-Nov-2020,Purchase,"3,427.10",00.00,"581,125.67",a21Ce6067cD633E,360,Drew,Patterson,"Ruiz, Leon and Salinas",Diazmouth,Congo,+1-629-893-3866x5762,484-379-5918x42421,mbanks@dorsey-sanchez.biz,2020-01-25,https://www.hunter.net/
24-Nov-2020,IMPS,"3,492.80",00.00,"584,618.47",1c98Da1cbab2Ff9,2289,Brianna,Levine,Mathis-Mckee,East Tara,Poland,001-699-245-3788x9827,001-843-129-8436x0172,plindsey@ballard-case.info,2021-04-14,https://www.reyes-floyd.com/
24-Nov-2020,Purchase,00.00,"292,309.24","292,309.24",09Ec145B716b8fd,6119,Ernest,Holland,Ochoa Inc,North Jasonland,Brunei Darussalam,001-548-547-5511x0181,995.117.0463x9829,kristi29@bishop.biz,2021-09-28,http://stevens.biz/
24-Nov-2020,Miscellaneous,"1,946,180.50",00.00,"2,238,489.74",FccE8Bf3cecdBEb,175,Monique,Ewing,"Lester, Ayala and Harmon",East Maxborough,Antigua and Barbuda,972.635.8026,332.322.2094x970,evansstuart@griffin.org,2021-12-16,http://mata.com/
24-Nov-2020,Purchase,00.00,"559,622.44","1,678,867.31",F5304868DcBEa92,3604,Willie,Gibbs,Bautista-Boyer,Tonihaven,Turkmenistan,(408)981-0356,885-981-2022x3865,salasomar@hutchinson-shaffer.com,2021-08-04,http://www.mack.net/
24-Nov-2020,Debit Card,00.00,"839,433.66","839,433.66",aF79d768eecCDeF,9799,Beth,Chandler,"Lin, Jefferson and Cunningham",East Evanmouth,United Kingdom,(826)644-4597x3318,(300)646-7455x598,gcarr@blanchard.org,2021-10-21,http://huynh.biz/
24-Nov-2020,NEFT,03.94,00.00,"839,437.60",cCaA6F74E60d8aC,3738,Seth,Jackson,Barker-Ortega,South Cynthiachester,Kuwait,568.567.7495x073,(550)197-2715,holdenerik@luna-george.com,2021-04-12,http://www.powell-hensley.com/
24-Nov-2020,IMPS,07.00,00.00,"839,444.60",Ff4174BCF03a8d0,6148,Marisa,Torres,"Ritter, Kramer and Chang",Kirbyport,Saint Barthelemy,001-739-621-9488x03901,5642514544,cameronruth@ellison.info,2021-09-04,https://foster-dunn.com/
24-Nov-2020,Cash,00.00,"839,444.60",00.00,CeA1CDF1b2e5da9,1208,Glen,Castro,Douglas Group,Emilyburgh,Albania,158-765-0651x582,907.907.5759,lhatfield@dawson.info,2021-09-01,https://www.schroeder.net/
24-Nov-2020,Tax,"17,214.00",00.00,"17,214.00",3DcCaBb218383a6,321,Kristopher,Bailey,"Estrada, Hendrix and Molina",Joyceburgh,United States Minor Outlying Islands,879-651-6578,565-294-1559x715,marco90@friedman-franco.net,2021-06-16,http://romero.biz/
24-Nov-2020,Debit Card,00.00,"2,459.14","14,754.86",aeA1De2cFBC364C,7247,Angelica,Beck,Velazquez-Lawson,West Whitneyfort,Sao Tome and Principe,001-560-395-1863x3749,0883733493,raymonddestiny@banks-benitez.com,2020-12-09,http://benitez.com/
24-Nov-2020,NEFT,00.00,"1,844.36","12,910.50",f20Cac39a9bB582,6727,Kristi,Mitchell,"Carr, Parsons and Weaver",West Sheena,British Indian Ocean Territory (Chagos Archipelago),053.650.9093,001-407-106-2390x5626,agilbert@abbott-patrick.org,2021-03-23,http://rogers.com/
24-Nov-2020,IMPS,"19,147.00",00.00,"32,057.50",5CB0De5F9dCCDff,7008,Madeline,Barnes,Orozco Inc,New Kerry,Gambia,006.539.0727,(438)553-6489,emilyschwartz@levy.com,2021-10-14,http://www.hernandez-rose.com/
24-Nov-2020,Cash,00.00,"4,007.19","28,050.31",dd509eaBA3F8089,260,Patrick,Barnett,"Riley, Phelps and Castro",Gabrielleland,Saudi Arabia,486-945-7392x76409,907-200-5367x69663,cassie94@booth.biz,2021-08-12,https://melton.com/
24-Nov-2020,Bill,00.00,"3,506.29","24,544.02",0dF4C59eB1DDd03,1553,Bobby,Riddle,Knapp Ltd,Hesterhaven,Gibraltar,903.584.2655x7147,341-669-7893,reginald04@conner.net,2021-11-15,http://www.lozano.com/
24-Nov-2020,Cheque,"25,076.80",00.00,"49,620.82",4244D72Ab6a5c2D,988,Lynn,Booth,Morton-Petty,Geraldtown,Peru,(111)338-4918,3474514709,david48@everett.info,2021-08-29,http://kirk-zhang.com/
24-Nov-2020,Tax,46.30,00.00,"49,667.12",FA05E9A4d17F6fc,7213,Meredith,Hall,Mckay Inc,Lucerofurt,Cote d'Ivoire,001-509-371-7918x55768,(827)315-2597,fstuart@clarke-rios.com,2020-02-10,http://www.glenn.biz/
24-Nov-2020,Debit Card,55.60,00.00,"49,722.72",87adbD94A9Da358,5808,Caitlyn,Baker,Crawford and Sons,South Emmaport,Egypt,929-420-4261x96336,863.059.2922x60640,hlin@espinoza.com,2021-05-09,http://solomon.net/
24-Nov-2020,Miscellaneous,260.65,00.00,"49,983.37",6ffFD3b28812EB5,507,Johnathan,Howard,Zuniga Group,West Wanda,Kyrgyz Republic,+1-525-473-4159x4761,001-821-438-5165,xfriedman@aguilar.biz,2021-04-28,https://christian.info/
24-Nov-2020,Bill,00.00,"4,998.34","44,985.03",F868E46890dbDAE,4880,Ariel,Warren,Stewart PLC,Mercerview,Hungary,(910)280-9133x6508,+1-938-290-0071x5902,deannicholas@gibbs.com,2020-10-09,http://fletcher.com/
24-Nov-2020,Tax,00.00,"4,998.34","39,986.69",0aB3b979af2d6D0,1904,Mckenzie,Jackson,"Mcgrath, Escobar and Cuevas",Henrymouth,Burkina Faso,299.348.8964x6462,(402)661-4214x6322,brosario@mercer.com,2021-11-30,http://foster.info/
24-Nov-2020,ATM,00.00,"19,993.35","19,993.34",aDb6bf2f615CD1A,9175,Shawna,Moyer,Guerrero LLC,Lake Erika,British Indian Ocean Territory (Chagos Archipelago),001-767-297-3745x36977,001-781-157-8949x27421,mfernandez@norris.com,2021-11-29,https://www.hancock-petersen.com/
24-Nov-2020,ATM,00.00,"6,664.45","13,328.89",DFD4d99FfC122ad,3932,Jaime,Hurst,Ball and Sons,New Leonborough,Philippines,(268)578-0555x993,(838)161-6287x15543,lreeves@sutton.com,2020-08-20,https://www.myers-gaines.com/
24-Nov-2020,Commission,"657,739.50",00.00,"671,068.39",E8fBb3e4F89AFf9,7891,Monica,Small,"Bailey, Roth and Mcneil",Morrisfort,Kiribati,135-079-5003x9160,(878)470-5543,knelson@cortez.com,2020-06-04,https://www.bauer.org/
24-Nov-2020,Reversal,02.73,00.00,"671,071.12",2E6d2cAB099f6fa,540,Darlene,Valdez,Fowler LLC,North Belindaborough,Aruba,531-069-9570x038,(805)677-0408,kbutler@mosley.biz,2022-04-08,https://www.booth.biz/
24-Nov-2020,IMPS,"242,634.60",00.00,"913,705.72",AF302C6b37e6dBd,404,Adrienne,White,Tyler-Riley,Mariohaven,Malaysia,+1-224-818-9716,011.984.0601,leroy07@becker-winters.com,2022-01-10,https://mullins.net/
24-Nov-2020,NEFT,00.00,"913,705.72",00.00,f7F909A8143F0D5,7112,Tiffany,Bass,Brewer-Obrien,Wiseville,Myanmar,331-716-9416x957,+1-111-306-0496,preston28@simon.net,2020-05-21,https://rubio-haynes.com/
24-Nov-2020,Miscellaneous,421.00,00.00,421.00,bFdD0b5D6Be5Ee4,2270,Priscilla,Levy,"Esparza, Andersen and Lawson",Laceyfurt,Armenia,352.638.6484,426.158.8556x8280,rbentley@spears.com,2021-02-24,https://dunlap.com/
24-Nov-2020,Interest,"8,447.72",00.00,"8,868.72",a7FD18Fe79C2C19,8192,Elijah,Roach,Chung-Boyer,Billtown,Portugal,001-768-490-3295x621,167.755.7818x49362,leroyrivas@rose.net,2020-04-18,https://bruce.com/
24-Nov-2020,Tax,00.00,886.87,"7,981.85",1ffFe2FE453b087,5599,Jaclyn,Bautista,Barron-Horn,New Herbert,Sierra Leone,(598)095-7950,274-773-2172x9716,hunterraymond@nunez-reid.com,2021-09-02,http://www.bullock.biz/
24-Nov-2020,Miscellaneous,06.10,00.00,"7,987.95",AbA0f3b2f1D74Fd,687,Brady,Rice,"Butler, Mora and Mcdowell",Gibbsberg,Lithuania,001-724-141-7988x582,(273)136-7307x3915,sbonilla@potts-fitzpatrick.net,2020-09-08,https://zimmerman.com/
24-Nov-2020,NEFT,00.00,"1,597.59","6,390.36",20528c1E4f82f2b,9233,Mia,Mullins,Lutz-Knapp,Port Levi,Suriname,(515)713-6631x27102,+1-343-726-0174x06706,finleysandra@porter.com,2021-12-31,http://www.mays-benitez.com/
24-Nov-2020,Reversal,00.00,912.91,"5,477.45",0862b8DfEEb3aCB,4194,Luis,Cunningham,Reeves-Burns,Perkinstown,Congo,153-300-0875x64055,264.707.1434,pamela03@barr.info,2021-03-20,https://www.jefferson.com/
24-Nov-2020,Transfer,00.00,547.75,"4,929.70",fD001b81A13b6Ed,2679,Darryl,Stanton,"Branch, Moran and Hoover",North Lorettaborough,Namibia,585.189.5943,+1-972-499-2171x6795,ckrause@warner.com,2021-05-05,https://www.potter.com/
24-Nov-2020,Interest,00.00,616.21,"4,313.49",B45A83DbB9895BA,3978,Ashlee,Kim,Duarte-Yates,North Doris,Suriname,394-872-1061,+1-992-239-0586,stevenmorris@whitaker.com,2021-08-06,https://fowler-mcfarland.com/
24-Nov-2020,RTGS,00.00,"4,313.49",00.00,Dbb64130fbBBa33,1042,Sally,Ortiz,Santos PLC,Flemingstad,Niger,(994)781-4921x11768,+1-940-520-4900x6520,jo57@carroll-bruce.com,2021-01-31,https://www.mcdaniel.org/
24-Nov-2020,Miscellaneous,15.80,00.00,15.80,4dc8DdF4D0DfecA,8929,Doris,Waller,Yates Group,Port Lonniestad,Indonesia,(110)520-4824,001-670-961-3900x54843,ramseyleah@coleman.info,2021-08-17,https://lowery.org/
24-Nov-2020,IMPS,81.91,00.00,97.71,cc8ca6FDE8bc4db,1322,Darius,Hanson,Huber Ltd,Chenbury,Sweden,+1-545-118-1153x151,062.302.3458x310,bkaiser@mccall.com,2020-12-22,https://www.mcconnell-guerrero.com/
24-Nov-2020,ATM,00.00,19.54,78.17,Fb24617FaC12275,596,Dakota,Daugherty,Baird and Sons,Alvaradoside,Gambia,001-390-044-6327x0751,544-297-6387x43350,davidmcconnell@wood.info,2022-01-22,http://www.wood-willis.info/
25-Nov-2020,Debit Card,"2,158.00",00.00,"2,236.17",2ef7898c342EBe6,9316,Patty,Morrow,Hale PLC,New Dontown,Djibouti,000.618.2439x599,026.568.7836x8860,nchaney@gill-galloway.com,2021-03-11,https://williamson.com/
25-Nov-2020,Interest,00.00,279.52,"1,956.65",dE4CbFD230e480c,4239,Valerie,Aguilar,Browning and Sons,Saundersport,Finland,001-736-558-6154x1927,9383830090,mackenziegrant@sharp.com,2021-11-26,https://haley.com/
25-Nov-2020,Cash,00.00,279.52,"1,677.13",5f2Cc4aeE7Cb0DF,3892,Riley,Palmer,Shannon PLC,East Yolanda,Israel,4415836670,001-830-389-8672x1663,terrellrichard@juarez.org,2020-07-31,https://fisher-reynolds.biz/
25-Nov-2020,IMPS,"16,171.07",00.00,"17,848.20",DfB1240Ee8Feb3E,5516,Douglas,Guerrero,Nguyen-Archer,Townsendmouth,Jersey,+1-996-645-6021x01612,001-183-946-5528x972,kyliejames@oneill-cooper.com,2022-03-07,https://valdez-brewer.org/
25-Nov-2020,Purchase,33.00,00.00,"17,881.20",934fff74a9Fc9Cf,5265,Virginia,Butler,Raymond-Joyce,South Kelseyton,Northern Mariana Islands,+1-978-836-1494,508-407-7726x064,hodgeroberta@mcdonald.com,2020-02-19,https://kaiser.biz/
25-Nov-2020,Cheque,00.00,"3,576.24","14,304.96",D9e3c6dCE0D1d4c,2744,Jeanne,Farrell,"Martin, Mcclure and Conley",East Ellen,Korea,622-847-6153x2911,345-137-0848x42951,kristine34@rivas-suarez.net,2020-07-15,https://boyer.com/
25-Nov-2020,Transfer,"233,905.50",00.00,"248,210.46",AdF14cE45b4fd08,2520,Cesar,Chambers,Maxwell-Murillo,South Christinamouth,Heard Island and McDonald Islands,(238)370-8734,001-639-899-3305x98066,warren68@harris-barnes.com,2020-07-12,http://steele.com/
25-Nov-2020,Cash,00.00,"35,458.64","212,751.82",A3aff892cFb6AC1,5337,Brittany,Ewing,Jennings PLC,New Chasetown,Nicaragua,001-907-271-7657x79526,907-747-5709,uboyd@burton.com,2020-07-06,http://www.downs.com/
25-Nov-2020,Purchase,462.30,00.00,"213,214.12",db8898e3cd81D61,9611,Mary,Norman,"Nunez, Underwood and Stein",North Eugene,Singapore,001-605-227-6433x65363,(144)381-2796x249,hannah82@chen.net,2020-01-29,http://payne-stanley.info/
25-Nov-2020,Interest,"202,420.00",00.00,"415,634.12",0F85AaD9bd7fDaD,5004,Laura,Manning,Reed-Knight,Pittsview,Indonesia,1923538674,001-401-676-6373x5593,ocordova@huff.com,2022-05-16,https://huynh-faulkner.com/
25-Nov-2020,Commission,00.00,"69,272.35","346,361.77",e4bfFBecC356aB3,3871,Autumn,Andrews,"Morales, Lynch and Duarte",New Kellyton,Singapore,(671)768-1449x860,001-291-456-1297x0744,vburke@gibbs.com,2020-02-10,http://reynolds.info/
25-Nov-2020,Debit Card,00.00,"86,590.44","259,771.33",2Da917d5DEBe80b,4713,Ronnie,Stevenson,"Shaffer, Sanders and Kaufman",Dawsonborough,Djibouti,592.945.9027,151.534.2700,thomasfox@irwin.com,2020-12-10,http://www.blevins.com/
26-Nov-2020,Commission,00.00,"86,590.44","173,180.89",45f41DDBec36DA5,5842,Tony,Roberson,Roberts-Sparks,Lake Alyssa,French Southern Territories,+1-052-316-4407x4450,077-729-9272,bholmes@richard-stone.com,2021-04-26,http://www.stanton.com/
27-Nov-2020,Miscellaneous,00.00,"21,647.61","151,533.28",7Cb95D11c747Ae3,6832,Crystal,English,"Hooper, Wilson and Peterson",New Natashafort,Bulgaria,001-160-047-9031x494,001-171-205-4733x169,robertaduke@case.com,2021-07-16,https://www.woods.com/
27-Nov-2020,Purchase,00.00,"25,255.55","126,277.73",bc10ba4Cab8b40b,6936,Jasmin,Murray,Oconnell and Sons,Vasquezshire,Cook Islands,477-615-4596x99764,4941157139,scottdawn@acevedo.biz,2021-12-30,http://knox.info/
27-Nov-2020,IMPS,00.00,"21,046.29","105,231.44",0dd16A135Bcfd3D,9334,Makayla,Jordan,Johnson and Sons,Lake Suzanneside,Kyrgyz Republic,001-592-096-3097,868-608-8988,ryancortez@reed.com,2020-03-13,http://moody.org/
27-Nov-2020,Interest,00.00,"26,307.86","78,923.58",7BDAD5d04a7fabB,8692,Corey,Collier,Yates PLC,Port Saramouth,France,646.517.5105x383,835.144.4520,allison49@schwartz-ortega.com,2021-11-20,https://robinson.com/
28-Nov-2020,Purchase,"82,760.40",00.00,"161,683.98",A81492Ad5F9AcdF,2205,Jody,Fitzpatrick,Richmond PLC,Milesfurt,Morocco,+1-291-825-2658x78214,(457)143-3602x9186,brucemary@hayden.com,2022-05-15,http://watson-bautista.org/
28-Nov-2020,Commission,00.00,"17,964.89","143,719.09",ED27Cf17C8eEA96,6138,Emily,Ferrell,"Vaughn, Hays and Gross",Audreyport,Saint Vincent and the Grenadines,001-077-665-7570x108,771-112-5156,jshelton@barajas.com,2021-12-11,https://osborne-edwards.com/
28-Nov-2020,RTGS,371.80,00.00,"144,090.89",Eedaa2Cf4efa503,2297,Sarah,Alvarado,"Crosby, Bates and Conrad",Lake Beverly,Denmark,530-197-5883x65749,1876708892,jim59@townsend.info,2020-07-06,http://www.harrell-murray.com/
28-Nov-2020,NEFT,"21,388.00",00.00,"165,478.89",aec5CeDc949143F,295,Kristy,Paul,Ortiz and Sons,Brentside,United States Minor Outlying Islands,001-028-436-4997,(590)746-8290x729,kirsten26@chaney-stephens.com,2020-02-17,http://acevedo-baker.com/
28-Nov-2020,Reversal,00.00,"55,159.63","110,319.26",FE5f21364d6B7a5,8616,Jonathan,Mejia,Bowers-Franklin,Port Susanburgh,Solomon Islands,(538)530-3326x6113,4133893541,tsanford@richmond.com,2021-12-28,http://monroe-pacheco.net/
28-Nov-2020,ATM,459.94,00.00,"110,779.20",b82cDFA96Cf8353,2396,Karla,Huffman,Wong-Kemp,Lake Patty,British Virgin Islands,4623703037,7620407960,fmartin@hanna.com,2021-11-06,http://www.clark-robbins.com/
28-Nov-2020,Cheque,00.00,"11,077.92","99,701.28",d9eEd560d72F0d8,7903,Jessica,Hancock,Shelton LLC,Arianaport,Romania,001-053-911-8687x078,5613109242,andrestate@velez-foster.com,2022-01-10,http://horn.com/
28-Nov-2020,NEFT,54.12,00.00,"99,755.40",AFb3dA721E03F48,2811,Karina,Charles,Lamb-Parks,North Gwendolyn,Ecuador,711-331-4378,(680)264-3276,ehaley@hampton.com,2021-02-20,https://phillips-summers.biz/
28-Nov-2020,Miscellaneous,492.71,00.00,"100,248.11",bD044a72175bE0a,7919,Angie,Compton,"Trujillo, Rodgers and Cherry",West Isabellaville,Rwanda,652-020-8449x7850,474.605.7291,petercortez@kent-lynn.com,2021-11-22,http://www.barron-blanchard.com/
28-Nov-2020,NEFT,00.00,"10,024.81","90,223.30",469B3Cc69dAd2BA,5469,Kim,Blair,"Valenzuela, Curtis and Norman",Noahport,Estonia,(655)232-3065,001-684-966-8635x00018,mirandasimon@landry.biz,2020-09-29,https://weaver.net/
28-Nov-2020,Debit Card,"2,886.00",00.00,"93,109.30",EAb90cc4a23D5d1,5021,Troy,Melendez,Norman-Malone,East Daisy,India,898-747-4280x64816,001-224-413-0553x6502,jasminpatel@callahan.com,2022-05-26,https://mosley.com/
28-Nov-2020,Transfer,00.00,"23,277.33","69,831.98",dA81e3aDdF5c52B,7859,Lydia,Valentine,Cain and Sons,West Dylan,Ukraine,320-007-3120x834,+1-252-823-2553x06873,hrogers@washington.com,2021-12-14,http://mills.biz/
28-Nov-2020,ATM,"1,332.50",00.00,"71,164.48",83Fe5bde1eCd27a,2328,Johnny,Mcdonald,Estrada-Haas,Erikastad,Svalbard & Jan Mayen Islands,+1-287-107-8024x9488,001-689-634-1207x15185,imorrison@mcconnell-bauer.com,2022-03-19,http://roth.info/
28-Nov-2020,Purchase,388.00,00.00,"71,552.48",DA8bBeAEf08Ca22,1199,Donald,Powers,Willis-Clarke,East Devin,Senegal,(315)017-2011x553,6737668705,mckenziecristian@pollard.com,2020-09-29,http://sellers-robertson.biz/
28-Nov-2020,Commission,"53,661.22",00.00,"125,213.70",CD9CFBb7D42f172,5695,Bryan,Hood,"Brewer, Gould and Brewer",Terrancemouth,Trinidad and Tobago,358-535-8467x62670,(085)287-6392,igarrison@carpenter.com,2020-12-31,https://wilkinson.com/
28-Nov-2020,Reversal,00.00,"17,887.67","107,326.03",41cCfC6fA3FdA2d,9189,Charlene,Alvarado,Burke-Gamble,Shepardburgh,India,380-688-1730x322,951.042.5696x446,jessica73@orozco.com,2021-10-05,https://www.wheeler.org/
28-Nov-2020,Miscellaneous,00.00,"53,663.02","53,663.02",EA89DCCebBEefB2,6065,Yvette,Contreras,"Arnold, Rhodes and Chase",New Alexis,Czech Republic,(277)614-8658x68137,731-194-3588,ucallahan@whitehead.biz,2020-04-13,https://good.net/
28-Nov-2020,NEFT,82.44,00.00,"53,745.46",0Df13a2dCeCF9CF,8411,Kristopher,Mcgee,"Green, Cardenas and Mayo",Moraburgh,Sao Tome and Principe,(551)640-3344,7312767380,stefaniegray@cowan.biz,2020-12-20,http://valentine.com/
28-Nov-2020,Reversal,02.37,00.00,"53,747.83",421Ff8b2C09801E,8926,Marvin,Andersen,"Bowers, Lynn and Hudson",Port Bobbymouth,France,(689)775-3077,174.018.5481x783,nbarry@watson.biz,2022-05-15,http://ibarra-carrillo.biz/
28-Nov-2020,Purchase,40.00,00.00,"53,787.83",aeac9CC0978C8ce,4570,Wayne,Jacobs,Cobb PLC,South Wendy,Norway,+1-894-918-7667x61718,373.397.5516,phillipsanford@good.com,2020-03-15,http://pruitt-hurst.com/
28-Nov-2020,Interest,"1,434,578.20",00.00,"1,488,366.03",407cfdB94Eb54Ee,2435,Gina,Strickland,"Charles, Lin and Mcintyre",Schroedershire,New Caledonia,001-883-795-6687,298-393-6220x937,reillykaylee@dickson.biz,2021-11-22,http://mosley.net/
28-Nov-2020,Debit Card,00.00,"372,091.51","1,116,274.52",A61A72AdEfFa1d0,5574,Julie,Villarreal,Estrada Group,South Samantha,Croatia,223-335-9416x9790,117-026-6029,christina49@holder.net,2021-07-19,http://www.delacruz-hooper.com/
28-Nov-2020,Cheque,"2,705.00",00.00,"1,118,979.52",1dEfb2faBF0b536,8789,Kyle,Osborn,Sampson-Ramos,Glennchester,Lao People's Democratic Republic,(548)649-8725x330,3714820295,ekrause@carroll-montoya.com,2021-01-10,http://osborn-roach.com/
28-Nov-2020,Tax,00.00,"559,489.76","559,489.76",98d145000afe632,9263,Jean,Bishop,Dennis-Foster,North Austin,Iraq,001-559-490-1606x0571,876.928.1131,lamariel@reed.com,2020-09-04,http://www.dennis-mata.com/
28-Nov-2020,Miscellaneous,00.00,"62,165.53","497,324.23",E25D3b1D7f8a7A0,8656,Clifford,Willis,Mcintyre-Beck,North Phyllisberg,Japan,(435)197-0242x668,001-691-006-3890x1613,connievalencia@trujillo.com,2020-08-23,https://www.flowers.info/
28-Nov-2020,NEFT,26.68,00.00,"497,350.91",E14a4c782E21d11,4694,Dillon,Hogan,Rivers LLC,West Sydneychester,Zimbabwe,529-516-8667,001-868-273-6214x29101,monica18@brennan.com,2022-02-21,https://www.andersen.org/
28-Nov-2020,Commission,00.00,"99,470.18","397,880.73",8B395e4dDfD45EF,5730,Heather,Harrison,Walton PLC,Claudiaton,Madagascar,001-545-336-9892x066,001-862-983-6538x466,connie18@sandoval-pope.com,2021-09-03,https://nunez-brennan.com/
28-Nov-2020,RTGS,00.00,"397,880.73",00.00,bB8502cdEFFc5f8,9574,Jeanne,Salas,"Hurley, Lang and Wells",Peggybury,Tunisia,113-204-6400,774.855.5950x11404,hutchinsonwendy@kelley.com,2020-01-11,http://hahn.com/
28-Nov-2020,IMPS,"46,375.03",00.00,"46,375.03",1cE2C6FDDBbaD50,4951,Melody,Huff,"Paul, Mckinney and Macdonald",West Rogerhaven,Morocco,742.901.7887,584-662-0098x4681,grhodes@salas.com,2021-06-08,http://www.jensen.com/
28-Nov-2020,Debit Card,00.00,"46,375.03",00.00,4ed105Ed3E2eE2E,6264,Cory,Bright,Solis-Kemp,Lake Kerry,Jamaica,+1-089-887-5391,377-365-4340x626,zfitzgerald@ortega.com,2021-03-10,https://mcknight-casey.com/
28-Nov-2020,Bill,"88,181.80",00.00,"88,181.80",F93A13ffcacE5D4,560,Jordan,Kline,Lam and Sons,South Baileytown,Sweden,(546)366-2270,545-150-3142,catherine18@gordon.com,2020-05-27,http://hoffman.com/
28-Nov-2020,Miscellaneous,"6,352.00",00.00,"94,533.80",b9072cb30eCd8F4,4565,Ryan,Carter,"Marsh, Phelps and Landry",Hudsontown,Georgia,406-002-1444,904-259-6390x5643,tonifrey@moses-price.com,2020-08-23,http://williams.net/
28-Nov-2020,Purchase,"15,319.40",00.00,"109,853.20",0dd16A135Bcfd3D,9334,Makayla,Jordan,Johnson and Sons,Lake Suzanneside,Kyrgyz Republic,001-592-096-3097,868-608-8988,ryancortez@reed.com,2020-03-13,http://moody.org/
28-Nov-2020,Commission,00.00,"13,731.65","96,121.55",bd175dabc90C9FE,9226,Jordan,Faulkner,Giles-Eaton,Farmerhaven,Malta,754.747.8995,(098)888-4164,kristinkane@dorsey.com,2021-06-20,http://www.mcmillan.info/
28-Nov-2020,RTGS,00.00,"12,015.19","84,106.36",BA6999E80DCC1EF,3146,Faith,Collier,Lopez Inc,Chaneybury,Congo,001-745-796-6726x8851,8755039492,kyates@lane.net,2020-10-27,http://george-hebert.com/
28-Nov-2020,Tax,40.70,00.00,"84,147.06",Aaa65bcDf93aeDd,9335,Jackie,Decker,Holt Group,South Shellybury,Congo,001-010-385-8318x20864,724-293-1020x117,gritter@whitaker-benton.com,2021-12-21,https://www.kennedy.com/
28-Nov-2020,IMPS,00.00,"8,414.71","75,732.35",CC2AFFbA268acbd,5587,Misty,Thornton,"Black, Schmidt and Hooper",New Yolandamouth,Cape Verde,+1-780-084-0887x985,001-702-180-1507x32876,geraldsullivan@mcdaniel.net,2020-09-07,https://scott.net/
28-Nov-2020,Tax,"2,168.00",00.00,"77,900.35",5F3C0aCea85Df69,9905,Shari,Snyder,"Hodges, Dean and Landry",Trevorland,Argentina,8872680637,001-757-793-5791x3038,erik68@barry-rowland.info,2020-07-13,https://wise-sanders.com/
28-Nov-2020,RTGS,00.00,"25,966.78","51,933.57",B14E7ED4dC4CBBf,280,Deborah,Atkins,Wagner-Ayala,North Mindyview,Cook Islands,(698)435-4856,106.482.9107x4369,brettmorrison@bernard-knapp.com,2020-06-21,https://www.weiss-foley.net/
28-Nov-2020,ATM,00.00,"7,419.08","44,514.49",1d128b7216A56AB,2908,Tami,Vazquez,Bonilla-Frazier,New Jackiebury,Tajikistan,750-484-9201x1981,957-187-4552,shaffertristan@swanson.org,2020-11-16,http://www.spence.com/
28-Nov-2020,RTGS,00.00,"4,451.45","40,063.04",67DAB15Ebe4BE4a,3,Briana,Andersen,Irwin-Oneal,East Jordan,Nepal,8352752061,(567)135-1918,haleybraun@blevins-sexton.com,2022-03-22,https://www.mack-bell.net/
28-Nov-2020,Interest,"12,909.00",00.00,"52,972.04",3c2b39F1CF1b0bB,9759,Jaime,Levine,"Hess, Welch and Bender",Coltonchester,Turkey,+1-933-083-4847,7130127981,glenkeller@rosales.com,2020-07-03,http://herman.biz/
28-Nov-2020,Cash,00.00,"5,297.20","47,674.84",0f130cBD5FdE13B,3805,Michael,Hawkins,Compton-Vaughan,Armstrongland,Moldova,(417)280-3680x1082,0764842813,annafriedman@jones.org,2022-03-12,http://www.meza.com/
28-Nov-2020,RTGS,00.00,"11,918.71","35,756.13",df1d9e4BDC126d1,889,Sydney,Singh,Maxwell Inc,Eileenmouth,France,009-677-5689x250,+1-541-183-2145x803,dominique06@raymond.biz,2021-09-13,http://walsh-dennis.org/
28-Nov-2020,Transfer,"11,854.07",00.00,"47,610.20",31CbaDAbc189B20,979,Mindy,Sutton,"Carey, Clay and Bryan",Port Randallmouth,Uruguay,903.642.6066x5869,+1-414-232-6722x943,averyjeffery@webb.info,2020-07-31,http://malone.com/
28-Nov-2020,NEFT,"3,046.14",00.00,"50,656.34",43CBf9ff825E10f,3308,Kari,Mercer,"Dodson, Baxter and Raymond",Hodgesshire,Montenegro,+1-788-058-7303,288.830.4455,annawu@vasquez.net,2020-12-30,http://vargas.info/
28-Nov-2020,Miscellaneous,322.88,00.00,"50,979.22",4D8Bbc3f79e2cB1,6337,Lonnie,Marquez,"Ferguson, Brock and Patel",Chungberg,Comoros,001-355-443-3539x157,067.171.4242,kaylacallahan@oconnell.com,2021-03-19,http://www.hammond.com/
28-Nov-2020,NEFT,"237,045.00",00.00,"288,024.22",0a7DC6BbB6E3F3e,2896,Virginia,Wiley,Jimenez PLC,Steveburgh,Pitcairn Islands,001-864-785-3008x5622,(806)150-0981x6264,sanforddevon@gill.biz,2020-04-02,https://www.stark.com/
28-Nov-2020,Reversal,897.33,00.00,"288,921.55",4EE4cd7bfeA4Bc6,898,Preston,Rodriguez,Cantrell Group,South Leetown,Micronesia,(360)745-6810,(665)384-1044,brandyholloway@padilla.com,2020-04-21,http://beltran-wallace.com/
28-Nov-2020,ATM,486.93,00.00,"289,408.48",6dc7EFb1dAe7FFe,9710,Harry,Harrell,Morales and Sons,New Beth,South Georgia and the South Sandwich Islands,001-915-276-9165x3636,001-218-858-7497x4051,hinesgwendolyn@combs.org,2021-01-30,http://www.villanueva-duncan.net/
28-Nov-2020,RTGS,420.93,00.00,"289,829.41",3dd1bf00A232145,8700,Tammy,Wall,"Grant, Hughes and Whitney",Port Misty,Austria,+1-307-128-8264x4296,(166)109-5517,gmclean@mccann.com,2020-10-28,https://wall.net/
28-Nov-2020,Cheque,"44,404.00",00.00,"334,233.41",1FF8c39d5cEAC08,8933,Frank,Navarro,Guerra-Holland,Lake Joyce,Uruguay,001-874-168-4505,+1-727-172-1438x927,janice95@bonilla.info,2020-02-05,http://adams-harris.com/
28-Nov-2020,Debit Card,"2,530.00",00.00,"336,763.41",BC9C5A7def88f2a,8449,Javier,Singh,"Buchanan, Riggs and Bates",Annport,Djibouti,763.802.1279,929-594-8082x9111,sheryl81@stevenson.net,2020-07-22,https://dean.com/
28-Nov-2020,Bill,00.00,"37,418.16","299,345.25",25BC6Fc50f31a48,4199,Sydney,Yates,Sharp-Ball,Port Kyliebury,Hong Kong,(114)723-7389x4250,470-066-6279,sawyercarl@gibson.com,2021-10-11,http://chan.com/
29-Nov-2020,Cash,00.00,"59,869.05","239,476.20",ebaAa48B8e9F6Eb,5696,Jesus,Juarez,Blanchard Inc,Port Christina,Kenya,001-292-275-0778x5391,(398)760-6403x088,briggsnichole@alvarado.net,2021-05-22,https://www.ferrell.org/
29-Nov-2020,ATM,151.00,00.00,"239,627.20",DAFE4aEB6c2eD69,4876,Kaitlyn,May,"Guerra, Washington and Mcfarland",Port Sheliaberg,Benin,(121)530-1014x978,451-217-2296x76566,jimmyanderson@casey-liu.com,2020-09-01,http://www.terrell.biz/
29-Nov-2020,Transfer,00.00,"39,937.87","199,689.33",Feab72ebad6BEC9,386,Jeffrey,Hunt,Hensley PLC,Nolanmouth,Guadeloupe,909-364-8280,001-152-985-4300x9420,qreid@mckay.org,2020-04-02,https://www.graham.com/
29-Nov-2020,RTGS,"50,981.00",00.00,"250,670.33",7a45D52E0cD8Bc5,6605,Katrina,Rojas,Harper PLC,Wandaland,Svalbard & Jan Mayen Islands,990-240-7538x299,001-125-960-9981,rpennington@gross-norman.info,2022-03-29,http://www.fitzpatrick-paul.org/
30-Nov-2020,Commission,00.00,"62,667.58","188,002.75",A7D6E4EBB69e0fB,6274,Jeffrey,Johns,"Hester, Best and Short",Glenton,Lesotho,(308)569-6779x589,+1-351-504-3031,kanegary@malone-horne.net,2020-07-16,http://www.meyer.info/
30-Nov-2020,IMPS,00.00,"188,002.75",00.00,Fcf8da8eCA6B825,1255,Karl,Barron,Fisher-Chapman,Kimside,Morocco,1986634320,144.099.5421,figueroacarmen@cardenas.com,2021-01-12,http://www.villanueva.com/
30-Nov-2020,Interest,08.00,00.00,08.00,941BFAeCb22a6AF,1776,Bryce,Conway,Willis-Rodgers,Wandaport,San Marino,+1-653-700-0067x5431,(346)349-2161,uosborne@hayes-chen.com,2020-05-03,http://strong.org/
30-Nov-2020,Interest,00.00,02.67,05.33,cC690FA1B62ae1a,3365,Shari,Massey,Greer LLC,Kathleenmouth,Paraguay,(576)737-5923x7310,(063)948-1729x637,ssteele@henderson.org,2021-07-17,http://www.holloway-smith.com/
30-Nov-2020,Interest,00.00,00.89,04.44,0341cC68a6965BB,1726,Shawn,Ramsey,"Copeland, Travis and Bartlett",Allenmouth,Sweden,562-023-1622x351,001-458-958-1052x32001,vanessa27@guerrero.org,2020-04-05,http://sweeney-terry.com/
30-Nov-2020,ATM,00.00,00.74,03.70,23a5F7fBcB5D4A3,1065,Betty,Diaz,Rasmussen PLC,Hernandezstad,Palau,663-672-8987x372,(703)715-5580x447,sergiobartlett@mcgrath.com,2021-09-01,https://daugherty.com/
30-Nov-2020,Purchase,"17,893.80",00.00,"17,897.50",E2fEF1bA17A5A4B,2454,Drew,Rubio,Daugherty-Cruz,New Melaniefurt,Somalia,0394431738,001-865-775-3311,barrybrittney@ramsey-villegas.com,2020-02-14,http://sandoval.com/
30-Nov-2020,ATM,"43,835.62",00.00,"61,733.12",cC244d59b1fcBB1,2374,Blake,Church,Meadows-Barajas,Clarencefort,Brazil,001-272-259-7835x15109,2886885297,espinozachloe@whitehead-watkins.info,2021-11-24,http://www.nixon.com/
30-Nov-2020,Reversal,00.00,"6,173.31","55,559.81",2C7eF6a798DdBCd,5519,Pedro,Montes,Ibarra Ltd,Washingtonview,Bhutan,670-415-5101x1057,001-384-880-7808,hhammond@stafford.biz,2021-02-06,http://johnson.com/
30-Nov-2020,Transfer,"136,953.80",00.00,"192,513.61",C19143aD05acEbC,7477,Christie,Ponce,"Archer, Potter and Everett",Mcclureport,United Kingdom,423-360-5534x871,608.480.8638x3592,karimann@blake.com,2021-04-29,https://www.lee.net/
30-Nov-2020,Reversal,00.00,"96,256.81","96,256.80",5eDb72a05b2A31b,9071,Yvonne,Collins,"Paul, Shah and Pierce",New Dustin,Netherlands,001-077-852-5731x82409,548-977-5738x29621,allison03@herring.com,2021-06-16,https://www.sweeney.biz/
30-Nov-2020,Commission,00.00,"13,750.97","82,505.83",9fb7A55B76aAaEd,1733,Anthony,Mendoza,"Moon, Benitez and Hanna",Mccoytown,Barbados,471.344.9899x828,(182)765-1091,brewerannette@costa-winters.com,2020-03-17,https://www.estes-chapman.com/
30-Nov-2020,Miscellaneous,"213,538.50",00.00,"296,044.33",ff711516CaC705b,1910,Terrence,Delacruz,Lang-Branch,West Jasmine,Kuwait,492-738-6070x1443,138.909.7471,robertacoffey@fry.info,2020-10-02,https://munoz.com/
30-Nov-2020,Miscellaneous,"1,670,633.50",00.00,"1,966,677.83",5F4CEFce9bF1EdB,3171,Michele,Salinas,Roberts-Ortega,Weberberg,Austria,0920319570,045-397-0580,aguilarmark@fields.com,2020-01-05,https://www.massey-mora.com/
30-Nov-2020,ATM,441.00,00.00,"1,967,118.83",7DD3AdeEEE19C79,3260,Shawna,Bryan,"Collins, Warner and Knapp",Susanhaven,Tokelau,725.963.4056x99480,001-838-772-1348x2877,krystalmeyer@mcdonald.com,2021-09-14,http://daniel.com/
30-Nov-2020,NEFT,01.30,00.00,"1,967,120.13",A4c3f8CF4aD3A99,9430,Jaime,Powell,Stark-Lucas,Marisaview,Kenya,001-608-418-8616x5028,001-269-511-2001,merceryvonne@riddle.biz,2021-09-16,http://rush.net/
30-Nov-2020,NEFT,00.00,"983,560.07","983,560.06",9CaC155Dfd9edAa,9906,Chris,Howe,"Calderon, Shaffer and Logan",Bennettburgh,China,+1-679-816-0313,001-104-265-5525x21314,moonaustin@suarez.com,2020-02-15,https://walsh-galvan.net/
30-Nov-2020,Cash,00.00,"983,560.06",00.00,C53E64B938B4943,4893,Stephanie,Pugh,Cortez-Lara,Mitchellfurt,United States Minor Outlying Islands,813.253.8152x471,660-590-0725x414,gateschelsey@palmer.com,2020-05-02,https://savage.com/
30-Nov-2020,Debit Card,00.85,00.00,00.85,AeCEd2b0b9CD25A,6885,Reginald,Juarez,Proctor LLC,Henryfurt,Solomon Islands,001-466-247-8049,5503619284,allenkent@gregory.com,2021-05-26,http://orozco-klein.net/
30-Nov-2020,Cash,"28,412.47",00.00,"28,413.32",DEBCf7eED3fe621,7412,Nicole,Paul,Wilkinson-Oconnor,Huangmouth,San Marino,008-548-7862x4363,699.115.3385,bryanjordan@schmidt-browning.com,2021-11-02,https://higgins.org/
30-Nov-2020,NEFT,"1,788.00",00.00,"30,201.32",17e73834584b140,2011,Kristina,Mcclure,Cortez-Moss,Port Ethanmouth,Sudan,+1-514-612-7215x379,103-815-0846,collinduffy@christensen.biz,2021-07-20,https://www.raymond-meyers.biz/
30-Nov-2020,Cheque,00.00,"15,100.66","15,100.66",9eFAc686b5feCdF,6970,Sherry,Cunningham,Robinson-Santiago,West Raymondtown,Saint Vincent and the Grenadines,697-331-8771x135,001-159-050-8984,fwall@hancock.org,2021-06-24,http://www.richardson.org/
30-Nov-2020,Debit Card,"1,137,215.25",00.00,"1,152,315.91",cb20DD3eB62AdDE,7039,Loretta,Padilla,Holland-Lane,Holmesville,Maldives,161.166.0330,994-835-2868x78892,kathryn44@vaughan.com,2021-05-04,http://holt.com/
01-Dec-2020,Interest,00.00,"144,039.49","1,008,276.42",1aD2deA0fde50BA,355,Joan,Gregory,Hartman Inc,Port Kylieville,Korea,305.639.5002,453.485.8642,xvang@schmidt.com,2020-11-01,http://blanchard.biz/
01-Dec-2020,Reversal,00.00,"112,030.71","896,245.71",b1C2DeC04cd6Ce3,2852,Penny,Jacobs,Matthews-Friedman,South Reginamouth,Fiji,970.889.0330,(733)773-6457x871,hahncharlotte@macias.com,2022-01-27,http://pittman.org/
01-Dec-2020,Reversal,00.00,"149,374.29","746,871.42",cB6bAeb78dfac1f,2776,Damon,Rosario,Valencia-Moran,Coreychester,Myanmar,5287278408,001-977-243-3119x0987,jeffrey24@mccoy.com,2020-06-25,http://www.rosales.com/
01-Dec-2020,Debit Card,"11,988.00",00.00,"758,859.42",5Dcfa64CE65C8aD,115,Ralph,Merritt,Rosales-Hayden,Sarafurt,Saint Martin,(652)849-4605,424.685.1314x331,moneal@hudson.biz,2021-04-10,http://carpenter-estes.net/
01-Dec-2020,Debit Card,00.00,"379,429.71","379,429.71",Dfb02CB8A5cc89f,8185,Aaron,Tucker,"Trujillo, Kemp and Perkins",Port Sheri,Honduras,774-817-3017,+1-799-404-4553x5122,sherri62@everett-sellers.com,2020-10-01,http://kennedy-mathis.com/
01-Dec-2020,ATM,00.00,"42,158.86","337,270.85",977DEacE80FEbb4,8263,Derrick,Hurst,Ho PLC,Rodneychester,Bermuda,7531749308,863.688.5049,sherriroth@padilla-wilkins.com,2021-06-15,https://www.cook-fischer.com/
01-Dec-2020,Interest,00.00,"337,270.85",00.00,16e8f82E1BdD8bd,279,Tiffany,Bruce,Joseph-Lyons,East Alishaport,China,451-922-4817x107,+1-720-469-0819x964,latashaburch@woodward.com,2021-10-24,https://levy.org/
01-Dec-2020,Tax,436.15,00.00,436.15,Aca0c2e237942ea,9717,Darryl,Spence,"Herring, Barton and Odom",Port Clarence,Botswana,001-847-073-8680x7398,001-753-814-8525x60732,osbornebarbara@conley.com,2020-09-23,https://www.salinas.com/
01-Dec-2020,Transfer,00.00,62.31,373.84,Db2f1dD4D11363a,8393,Stefanie,Soto,"Morales, Grant and Holder",Dorseyview,Montenegro,001-229-828-3310,001-061-498-8457x07281,samanthalloyd@jenkins-mccarthy.info,2020-08-19,http://stephenson.com/
01-Dec-2020,Commission,00.00,37.38,336.46,eAf3CAFB8b901e9,1437,Ivan,Richard,"Goodman, Byrd and Kelley",Brianbury,United States Minor Outlying Islands,589-709-3105x981,(420)477-4657,strongmicheal@padilla.com,2021-07-23,http://www.bartlett.net/
01-Dec-2020,Debit Card,00.00,336.46,00.00,CFc2E3fBb2cc695,8042,Katherine,Weaver,Barnett-Blackburn,Kathleenville,Saint Pierre and Miquelon,024.864.8424x80179,+1-112-847-0042x73388,poolekerri@johnston.com,2022-03-18,http://www.gilbert.com/
01-Dec-2020,Commission,"223,693.03",00.00,"223,693.03",C8eAE8D58C71CAE,248,Jay,Rosales,"Morales, Carpenter and Yoder",Hodgeburgh,American Samoa,6427544692,(806)799-8306,joanna47@davidson.org,2020-05-07,https://www.cochran-cook.com/
01-Dec-2020,Cheque,00.00,"22,369.30","201,323.73",5f89eA882De2A2F,4378,Shelby,Davies,"Yates, Haynes and Owens",New Marie,Belize,(148)971-7249,001-849-022-3880,rubenwatson@berry.biz,2022-01-12,https://www.howard.com/
01-Dec-2020,Purchase,53.83,00.00,"201,377.56",2a4AEDf4ddDBEFD,4471,Kirk,Travis,"Watson, Tucker and Flowers",Henryside,Papua New Guinea,001-151-733-7625x84072,001-566-309-0195x7049,butlersean@hurley.net,2021-03-21,http://www.cuevas.com/
01-Dec-2020,NEFT,00.00,"50,344.39","151,033.17",1Ba4e2F45c2AeE9,9245,Trevor,Anderson,Luna LLC,New Eduardotown,Thailand,790.986.0064,151-233-4390x5188,wyatt09@bender.com,2021-08-11,https://www.benton.com/
01-Dec-2020,IMPS,00.00,"37,758.29","113,274.88",84d3FaE8D176217,32,Danny,Mayer,"Serrano, Carr and Hurst",West Bernardbury,Niger,+1-232-090-7002x568,(764)539-0967x909,mindy15@fuentes.org,2020-07-15,http://perkins.com/
01-Dec-2020,Tax,"251,831.00",00.00,"365,105.88",c1507112b25cEc2,6287,Andre,Patrick,Bullock LLC,New Dianeville,Myanmar,(632)073-9601x757,316-199-1863,sergio85@webster.com,2022-03-05,http://rodgers.com/
01-Dec-2020,Purchase,00.00,"36,510.59","328,595.29",5820deAdCF23EFe,5,Kathleen,Mccormick,Carson-Burch,Andresmouth,Macao,001-184-153-9683x1497,552.051.2979x342,alvaradojesse@rangel-shields.com,2021-01-17,https://welch.info/
01-Dec-2020,Transfer,00.50,00.00,"328,595.79",3528964CdbccfB6,714,Mary,Harrison,"Cunningham, Harrison and Collins",Cliffordburgh,Turks and Caicos Islands,905.198.6186x539,+1-459-522-1470x687,ahancock@buck.info,2021-08-04,https://cobb.com/
01-Dec-2020,Cash,00.00,"41,074.47","287,521.32",DA9161Ab3eeD2Da,7925,Briana,Salas,Waller-Mora,Derekhaven,Haiti,182.189.1811,100.790.1768,dorothybates@chan-valdez.net,2021-05-08,http://www.huber.com/
01-Dec-2020,Cash,57.07,00.00,"287,578.39",e9B8C0b9195D7e6,7651,Shawn,Carr,"Holden, Price and Kramer",East Alexandria,New Zealand,637-666-5935,947-467-2095,kdorsey@solis.com,2022-01-19,https://good-odonnell.com/
01-Dec-2020,ATM,17.44,00.00,"287,595.83",Af068c5BACEc77a,7093,Anita,Gaines,Jacobs Group,Luceromouth,Saint Lucia,302.435.8829,493-570-2613,claytonstephenson@gates.com,2022-03-03,https://www.jennings.info/
01-Dec-2020,Cheque,00.00,"31,955.09","255,640.74",35d2eA95BC498F8,5287,Joel,Rose,Ayala-Fischer,Port Christy,Saudi Arabia,001-368-075-3960x297,038.342.8349x18242,uwalton@kidd.biz,2020-08-12,http://castro.com/
01-Dec-2020,Miscellaneous,00.00,"36,520.11","219,120.63",2E9C41E8Fca20f1,5856,Bianca,Payne,Galloway LLC,Lake Kevinville,Paraguay,001-705-659-9976x1354,589-785-1340,baxtergabriella@richmond.com,2020-09-06,http://pena.biz/
01-Dec-2020,Bill,00.00,"21,912.06","197,208.57",8759A65B1E17F23,6372,Sierra,Villanueva,Kline-Duke,New Veronicaburgh,Estonia,+1-787-508-8115x41048,759.250.4432x28133,mallory14@lang.biz,2020-06-19,http://mcmillan.com/
01-Dec-2020,Bill,202.90,00.00,"197,411.47",DbaaFc709FCDf43,3215,Raymond,Hutchinson,Gay Group,Bethanyside,Hong Kong,+1-891-838-0062x993,910.796.9035x5042,cherylgomez@espinoza-good.com,2020-06-30,http://www.mccann.com/
01-Dec-2020,Interest,00.00,"197,411.47",00.00,27BA6ccF0BD9233,5355,Geoffrey,Vang,Bonilla and Sons,Patelborough,Swaziland,001-922-835-4371x63464,(117)307-4642,sergio33@hicks-cantrell.com,2020-07-23,https://peters.com/
01-Dec-2020,IMPS,"80,918.53",00.00,"80,918.53",BAbDAcfeFa4ECc3,3448,Sheila,Guerra,Gibbs-Whitaker,New Dwayne,Jersey,(641)720-6713,845-865-8193,jodi12@powell.net,2020-08-03,http://www.mcgrath.com/
01-Dec-2020,Tax,00.00,"8,990.95","71,927.58",f9e8aeAcd5c0fbC,2573,Jermaine,Bruce,Hardy-Stevenson,East Emily,Kiribati,001-983-651-2469x51535,893-343-2826,shieldsderrick@thomas.org,2022-04-12,http://www.bennett.org/
01-Dec-2020,Bill,"780,337.80",00.00,"852,265.38",eCEEDF8c49bac82,8676,Julie,Neal,Andrews-Kidd,Simmonsport,Belize,541-899-8390x29996,7822165687,mortonkristie@snow-kirk.com,2021-03-31,http://bass-beard.net/
01-Dec-2020,Cheque,649.00,00.00,"852,914.38",a6a6CE2C38eB0Db,7560,Karen,Blake,Bridges-Roth,Port Jennashire,Afghanistan,811.587.6618x186,868.637.0116x92008,clarkmario@rosario.com,2020-03-06,https://villa.com/
01-Dec-2020,Bill,00.00,"85,291.44","767,622.94",73B9332DFa56A53,5802,Joyce,Gillespie,"House, Cherry and Villarreal",East Beverly,Central African Republic,057.025.8945x209,589-302-6922x0375,nicholsmarc@anthony-anderson.com,2021-11-13,https://www.tucker-case.com/
01-Dec-2020,Commission,"472,737.00",00.00,"1,240,359.94",9DAde3E31ef84A1,5905,Tracy,Manning,Miles LLC,South Jason,Chad,257.154.4479x1851,+1-956-736-8308,mckenzie01@wiggins.com,2021-07-06,https://www.frye.com/
01-Dec-2020,Reversal,23.20,00.00,"1,240,383.14",3C9A07DC726AB57,8389,Juan,Miller,Mclaughlin-Waller,East Maxwell,Sri Lanka,+1-346-829-5392x612,335.407.3749,charlesjoan@burke-santos.org,2021-02-10,https://huber-callahan.com/
01-Dec-2020,Tax,00.00,"124,038.31","1,116,344.83",fbb8E90054AEFD4,2772,Cristina,Cox,"Kemp, Morgan and Harrell",Paulhaven,Guatemala,001-599-628-5603x5791,001-176-453-7030x67208,batessavannah@roberts.com,2022-04-30,http://www.beltran-caldwell.com/
01-Dec-2020,IMPS,"629,146.20",00.00,"1,745,491.03",C02c1CDeaC7f3ba,8594,Brent,Vaughn,"Stafford, Collins and Salas",Shanetown,Saint Pierre and Miquelon,7032053923,960.723.3542,tomholt@mcmillan-randolph.com,2020-12-16,http://collins-velazquez.com/
01-Dec-2020,RTGS,"192,748.00",00.00,"1,938,239.03",7dAE66D8A754Ab7,6398,Mitchell,Stout,Martinez and Sons,Phelpsshire,Falkland Islands (Malvinas),(321)544-1130x529,001-492-879-6613x3719,wcannon@cameron.com,2022-04-25,https://www.larson.org/
01-Dec-2020,Debit Card,"2,413.00",00.00,"1,940,652.03",6a43066D6a73E8C,9217,Marcia,Michael,Schroeder Inc,Mejiaberg,Iran,(768)336-2169x4540,(606)531-7508x91174,huffdaisy@crane-barber.com,2020-06-02,https://www.davidson.org/
01-Dec-2020,ATM,"45,629.70",00.00,"1,986,281.73",DDDBFdFaC16F2cA,1573,Theodore,Drake,"Lin, Ellison and Page",Ortiztown,Christmas Island,625.398.7611x74667,909.476.3690x3835,bolsen@carpenter.com,2021-03-13,https://www.moss.org/
01-Dec-2020,Tax,"93,567.70",00.00,"2,079,849.43",0B1c55CFB19DC55,4450,Martin,Francis,Howe PLC,Laurenhaven,Cyprus,(307)041-3028x6971,(972)830-9299x061,sheaalyssa@huber-hart.biz,2021-02-22,https://www.lawson.com/
01-Dec-2020,Interest,00.00,"346,641.57","1,733,207.86",6DcEF52b5015c13,5237,Darryl,Ashley,Lester Group,Onealburgh,Jersey,+1-777-751-7723,001-900-137-7816x441,arodgers@hurst.com,2021-10-18,http://levine.com/
01-Dec-2020,Bill,"10,986.75",00.00,"1,744,194.61",bA34810aC7B7aE7,1796,Destiny,York,Juarez PLC,Mezaborough,Kazakhstan,937.545.7338x134,006-948-3832,lucasconway@hardin.net,2020-08-02,https://www.webb.info/
01-Dec-2020,Bill,00.00,"193,799.40","1,550,395.21",aDb6bf2f615CD1A,9175,Shawna,Moyer,Guerrero LLC,Lake Erika,British Indian Ocean Territory (Chagos Archipelago),001-767-297-3745x36977,001-781-157-8949x27421,mfernandez@norris.com,2021-11-29,https://www.hancock-petersen.com/
01-Dec-2020,NEFT,00.00,"258,399.20","1,291,996.01",A0cf16C18cB09ff,2609,Angel,Stewart,Reeves-Davila,Janetchester,Angola,(089)100-2089x21844,+1-158-194-8314x240,stevenmcguire@weiss-meza.com,2020-06-03,http://fox.com/
01-Dec-2020,Miscellaneous,00.00,"129,199.60","1,162,796.41",2DcCde9EE476aA1,5103,Doris,Montgomery,Anthony Group,West Anna,Saint Helena,020-823-7753,+1-650-194-6286x13509,gail36@baldwin.com,2021-06-02,http://wheeler.com/
01-Dec-2020,Bill,00.00,"166,113.77","996,682.64",8A9eAF9fce144E3,812,Stacie,Romero,"Moss, Elliott and Carter",New Becky,Marshall Islands,001-131-330-7009x10351,165-145-4965x4203,mcclaintyler@clark-hendrix.com,2020-05-04,http://stewart-delgado.com/
01-Dec-2020,Reversal,01.00,00.00,"996,683.64",2cfcd179EeEa0C1,4774,Shannon,Cannon,Pena-Ochoa,Zoetown,Maldives,+1-405-422-9837x45721,+1-488-101-7330x9210,marcus31@mejia.net,2021-07-20,https://www.miles-evans.org/
01-Dec-2020,Tax,00.00,"199,336.73","797,346.91",F6B7eaFAf32cD00,7734,Heather,Cannon,Mcmahon-Levy,South Markfurt,United States of America,302-815-0543x937,(959)859-7400x94366,bmorgan@pratt-acevedo.com,2021-06-21,http://www.garner.net/
01-Dec-2020,Transfer,00.00,"88,594.10","708,752.81",9eBD2acaCEb7b96,5772,Tami,Zuniga,Small-Lucero,West Bryceport,Lebanon,977-920-0578,590-505-3466x53710,wrightkaitlyn@blanchard.info,2021-08-15,https://www.andrade.com/
01-Dec-2020,Debit Card,"1,258,801.00",00.00,"1,967,553.81",BD54bAb8092a043,2779,Beth,Schmidt,Reynolds-Chase,Austinberg,Vanuatu,924-010-9732x93574,775.476.3705,frances15@frank.biz,2022-05-27,https://gilmore.com/
01-Dec-2020,IMPS,00.00,"1,967,553.81",00.00,8ac02a294D99bBB,1980,Kristina,Hensley,"Jacobson, Webb and Snyder",Billland,Senegal,933-631-6414x06702,(397)771-1728x130,shawnchung@porter.com,2020-04-12,http://www.jennings.info/
01-Dec-2020,RTGS,"510,694.00",00.00,"510,694.00",e50f0b9BB9Bea59,6152,Christie,Hubbard,"Freeman, Hancock and Hendricks",North Lorraine,Cayman Islands,(539)402-1934x9360,594-622-2104x513,ebrewer@valencia.info,2020-04-16,https://www.gordon.com/
01-Dec-2020,ATM,00.00,"255,347.00","255,347.00",9bF48C9e6a3f09D,919,Marcus,Petty,Guerrero and Sons,West Caleb,Mongolia,+1-880-702-9167x002,9553307016,holdenraven@carpenter.com,2022-05-10,https://www.roman.com/
01-Dec-2020,Cheque,"886,595.75",00.00,"1,141,942.75",B44ec66f4D70d47,8510,Meagan,Whitney,Hunt-Stein,Mccoymouth,Serbia,741.671.9809x6696,001-945-267-5583,dparker@hurley.com,2022-04-06,https://sweeney-barr.biz/
01-Dec-2020,RTGS,"192,915.19",00.00,"1,334,857.94",b9bcC70EAcaFBBA,9165,Kerry,Richard,Sellers-Walters,Sheliamouth,Madagascar,001-876-896-5760,(587)460-6025x3641,xavierhenry@liu.biz,2021-11-27,http://irwin.com/
01-Dec-2020,Cash,00.00,"1,334,857.94",00.00,da83EB51FaCBC8B,6506,Sheryl,Christensen,"Ayers, Zuniga and Lee",Rowlandside,French Polynesia,860.813.2730x9964,022.001.0617x272,nicholasbradley@lutz-roman.net,2021-05-18,http://costa.com/
01-Dec-2020,Cash,"152,216.38",00.00,"152,216.38",6ADbBf35FBb6ebc,47,Tyler,Richard,Cline Inc,Serranoland,San Marino,(030)748-4061,(518)939-6401,alfredbradford@perry.com,2022-04-17,https://www.delacruz.com/
01-Dec-2020,Transfer,00.00,"30,443.28","121,773.10",2D0594c3bBe028B,7158,Abigail,Cannon,"Wheeler, Roy and Dillon",East Julie,Cape Verde,998-838-1558x1043,001-208-865-0866,kbarnes@mccarty.com,2020-01-26,http://www.hanson.com/
01-Dec-2020,Cheque,00.00,"60,886.55","60,886.55",dafD9b63FCD6BBA,398,Tanner,Nguyen,Peck-Boyle,Emmabury,Turks and Caicos Islands,020-790-3668x2455,+1-514-616-2997x6779,grossstuart@cooke.com,2020-04-24,http://gamble.info/
01-Dec-2020,IMPS,368.21,00.00,"61,254.76",F6d0c75E3701EFa,1407,Isabella,Stanley,"Ali, Carroll and Carson",Kristineton,Burkina Faso,605.169.5443,001-616-953-7751,morsehelen@fox-serrano.com,2021-06-10,https://sandoval.com/
01-Dec-2020,Interest,00.00,"10,209.13","51,045.63",F1823AE000d4327,8299,Whitney,Garner,Hahn PLC,Port Sydneyton,Chile,(629)996-1907x87802,(158)438-0169,russell53@pope-hood.biz,2021-04-20,https://www.becker-freeman.info/
01-Dec-2020,Tax,768.60,00.00,"51,814.23",Ff4174BCF03a8d0,6148,Marisa,Torres,"Ritter, Kramer and Chang",Kirbyport,Saint Barthelemy,001-739-621-9488x03901,5642514544,cameronruth@ellison.info,2021-09-04,https://foster-dunn.com/
01-Dec-2020,Miscellaneous,"1,452.00",00.00,"53,266.23",8cb0eB43F26Fc91,1631,Belinda,Pham,West-French,Port Jacobside,Sri Lanka,059-774-6888x7522,(146)793-0310x40832,sherryburch@hawkins.com,2021-04-10,https://www.hudson-mata.com/
01-Dec-2020,Transfer,00.00,"53,266.23",00.00,8f1BFD7BDE69fDb,2029,Lacey,Osborne,"Moody, Greer and Middleton",New Kristiside,Montserrat,8590442075,002.717.9314,brightcarla@hood-castro.com,2021-07-21,https://www.liu-arias.com/
01-Dec-2020,Cheque,02.00,00.00,02.00,0340141d7efB54c,8139,Jean,Harrison,Rocha-Young,Lake Angelicaport,Malawi,386.303.0497x8712,5428550390,gbautista@mckay.com,2022-01-22,http://www.stuart.com/
01-Dec-2020,NEFT,124.10,00.00,126.10,EeDBd0A9dcD303b,4150,Veronica,Carter,"Holmes, Landry and Riggs",South Kristie,Portugal,001-234-732-1654x6834,887-882-4107x57220,frhodes@doyle.com,2021-12-03,http://www.flowers.org/
02-Dec-2020,NEFT,07.21,00.00,133.31,8AEEFFe1729CAd3,7724,Sarah,Jackson,"Banks, Luna and Ross",Saundersfort,Saudi Arabia,(050)474-7217,758-512-5475x1027,sophia83@mcneil.com,2020-11-27,https://www.sanford-stokes.com/
02-Dec-2020,Purchase,"1,320,498.25",00.00,"1,320,631.56",cF2EC9B31659FFf,9248,Rhonda,Douglas,"Bishop, Stephens and Rios",Bobmouth,Libyan Arab Jamahiriya,860.426.1890x577,463-632-2063,rcortez@cardenas.net,2021-01-17,http://marks.net/
02-Dec-2020,Cash,03.00,00.00,"1,320,634.56",cF8c6f8D074CaCa,7500,Jeremy,Marsh,Lyons LLC,Lake Leahfurt,Portugal,431.664.0930,437.992.9240x53705,terry65@ferguson.com,2020-09-24,http://www.mcmillan.org/
02-Dec-2020,Transfer,00.00,"330,158.64","990,475.92",bcDB1d4303a311d,2781,Jody,Cruz,Mccall-Archer,Port Ethanton,Spain,525-363-7987x4146,372-711-8059x0022,kim62@mercer.com,2022-04-16,http://hogan.biz/
02-Dec-2020,NEFT,00.00,"198,095.18","792,380.74",aB883abf8BFD23b,7421,Ross,Valentine,"Dunlap, Hicks and Rogers",Stewartville,Sri Lanka,001-074-691-9670x179,658-806-7782x0931,rhonda66@green.com,2020-05-07,http://www.franco.com/
02-Dec-2020,Interest,00.00,"88,042.30","704,338.44",d3EECDB9281CB5D,1582,Lawrence,Best,Massey PLC,Tannerfort,Svalbard & Jan Mayen Islands,1249409857,+1-745-683-3946x7509,ilambert@zuniga-huffman.com,2020-01-27,http://berger-meza.com/
02-Dec-2020,Cash,"2,215.00",00.00,"706,553.44",FecA437C8e5496d,6654,Fred,Woodward,Taylor-Peterson,Rivashaven,Kiribati,001-846-622-6902x84539,892-284-9892,ian13@wolfe-livingston.net,2020-10-22,https://barry.com/
02-Dec-2020,Miscellaneous,00.00,"353,276.72","353,276.72",CA416877BCc63B5,4614,Francisco,Mckee,Daniel Inc,West Rickymouth,Cambodia,+1-664-418-6315x95083,5463161505,staceyhamilton@villa.com,2020-06-19,https://key.net/
02-Dec-2020,Purchase,"255,728.00",00.00,"609,004.72",DEeB660E2e47C36,2603,Charlotte,Trevino,Guerrero-Parrish,East Margaretville,American Samoa,+1-291-842-8280x99257,(040)725-6579,kraymond@ashley-mckee.com,2020-01-09,https://barton.com/
02-Dec-2020,Transfer,00.00,"67,667.19","541,337.53",A335cB00aDecAEA,5461,Patrick,Flynn,"Dickerson, Mahoney and Rocha",North Evelyn,Mali,+1-281-158-0010,193-803-1603x747,shaunadams@brewer.biz,2021-10-13,http://www.barajas.com/
02-Dec-2020,Transfer,00.00,"54,133.75","487,203.78",9147889b361D6BB,4584,Shelby,Burton,"Perkins, Blevins and Miles",Pooleshire,Northern Mariana Islands,(749)657-7812x8832,001-613-241-7444x4533,odomteresa@byrd.net,2022-04-02,http://www.calderon.info/
02-Dec-2020,Reversal,00.00,"69,600.54","417,603.24",bD6157314Fe60FF,5414,Ariel,Shah,"Leach, Cross and Douglas",East Leemouth,Sweden,7651722701,633-226-5643x4922,shelbypennington@holt-winters.com,2020-12-22,https://tate.com/
02-Dec-2020,Interest,00.00,"59,657.61","357,945.63",DbeCbaAbc1ccc41,4956,Dalton,Hood,Serrano Ltd,South Eileen,Thailand,(537)043-0512x140,285.154.3692x24639,ochoameagan@tyler-ortiz.com,2020-03-20,http://cisneros.com/
02-Dec-2020,NEFT,00.00,"39,771.74","318,173.89",E96e3Db4d1c2cEE,3755,Jason,Hayes,"Skinner, Livingston and Reyes",West Eduardo,Reunion,2413584734,200-182-9540,robin91@byrd.com,2021-11-25,https://www.barber.net/
02-Dec-2020,Miscellaneous,00.00,"45,453.41","272,720.48",4B27EC39Ab83D9E,2384,Pedro,Ayers,"Dunn, Conley and Elliott",Port Vincentberg,Albania,6480940275,(747)434-7961x512,alejandro04@riggs.org,2020-08-05,https://www.wells.com/
02-Dec-2020,Cash,00.00,"45,453.41","227,267.07",cBedbED08A6FC58,8900,Howard,Chambers,Mcknight-Griffith,North Mikeville,Saudi Arabia,(316)964-2745x663,(394)317-8206x86349,mckeebreanna@hoover-olson.com,2020-01-30,https://www.rivera.com/
02-Dec-2020,Reversal,00.80,00.00,"227,267.87",a9BF395CFf4A6Aa,4041,Betty,Ritter,"Davenport, Navarro and Wilson",Ronaldton,Sri Lanka,001-116-709-9901x9440,001-419-351-4572x784,parkpreston@brooks.com,2021-02-02,https://wood.info/
02-Dec-2020,Miscellaneous,00.00,"37,877.98","189,389.89",fcC8D0ea0ace725,58,Kurt,Tapia,Adkins-Dixon,Hoodchester,Tokelau,+1-102-370-7901x263,(677)168-7134,valerie35@olsen.com,2020-10-11,http://www.fernandez-fisher.com/
02-Dec-2020,Reversal,00.00,"189,389.89",00.00,5EBEAeEAB39Fec1,6798,Gloria,Garza,"Snyder, Johnston and Long",Dudleyton,Mauritius,445-982-7269x8280,720-548-5799,hrojas@moreno.net,2020-08-02,http://www.gamble.com/
02-Dec-2020,ATM,07.90,00.00,07.90,c513D89c6edef91,7852,Malik,Mathis,Stevenson-Lawson,Port Vanessafurt,United Arab Emirates,943.061.0276,(033)345-5530x2128,katelynroberson@chung.com,2020-04-21,https://www.good.org/
02-Dec-2020,Reversal,"2,495.77",00.00,"2,503.67",9aAA56f50da169D,110,Yvette,Short,Pugh-Green,Erinfurt,Namibia,190.807.9974,001-076-509-0536x0863,garymelton@petersen-lam.org,2020-01-03,http://www.lawrence.biz/
02-Dec-2020,IMPS,00.00,278.19,"2,225.48",7ee8cCFceE7BE18,1952,Roger,Maddox,Baldwin-Wagner,Suttonburgh,Peru,001-151-266-7565x87681,+1-070-661-1556x48988,yarcher@noble-valencia.com,2020-10-14,https://daugherty.info/
02-Dec-2020,Purchase,00.00,278.19,"1,947.30",4b8BfCd1cf834F2,5254,Raven,Walters,"Nunez, Weeks and Ingram",New Jorge,Bouvet Island (Bouvetoya),001-958-462-0151x591,475-847-5692x4151,rasmussenjeremiah@huber-mccullough.org,2020-01-31,http://richmond-good.org/
02-Dec-2020,Cash,"31,096.00",00.00,"33,043.30",CDa47E8374AaAB4,1117,Holly,Reyes,Lynn-Joyce,Johnstonville,Turkey,(135)011-9753,(759)761-5910x49231,swansonkristie@alexander.com,2020-11-29,https://callahan-hall.com/
02-Dec-2020,IMPS,398.34,00.00,"33,441.64",9F02A428C922af8,3027,Roberto,Gregory,Mcconnell-Wang,New Toddland,Zambia,+1-845-707-3456x5968,894.653.5052,cheryl07@aguirre.com,2021-02-12,https://www.powers.biz/
02-Dec-2020,Reversal,00.00,"33,441.64",00.00,BeF1FaE12160D0c,4566,Angie,Bailey,Wagner LLC,Port Louisfort,Portugal,+1-012-076-1115x39761,273-288-5527x188,briannamontes@barnes.info,2022-05-10,http://www.riggs-calderon.com/
02-Dec-2020,Purchase,04.50,00.00,04.50,Fb445762eAfFCec,2305,Mikayla,Carter,Harper-Holt,Dustinburgh,Micronesia,3290552810,001-214-252-9140,manngregg@blankenship.com,2020-12-28,https://www.avila.com/
02-Dec-2020,NEFT,00.00,00.64,03.86,23C14E030BDCE52,2310,Denise,Crawford,Harding-Logan,Melodyhaven,Qatar,(513)927-6251,539-655-0516,tammie24@jones-pruitt.com,2022-01-28,http://clayton.com/
02-Dec-2020,Purchase,447.00,00.00,450.86,6BfB1CdA8DBF6dd,1563,Tony,Fuller,Hendricks-Dominguez,Frazierside,Barbados,001-482-957-9722,236.887.3293x61516,steve28@everett.com,2020-09-16,http://www.cain-colon.com/
02-Dec-2020,Transfer,"215,584.91",00.00,"216,035.77",cDd5168abF1daAf,9532,Angelica,Gibson,Higgins-Esparza,South Kristi,Ecuador,(656)882-9526x965,200.551.5784x2458,ctravis@jimenez.com,2021-11-01,http://www.mckenzie-wilcox.com/
02-Dec-2020,IMPS,00.00,"43,207.15","172,828.62",E6d1aaB73cfE97C,4729,Evan,Romero,Valenzuela-Velez,Jaimefort,Heard Island and McDonald Islands,+1-729-867-9013x565,(248)307-1537x9557,sandracummings@blair.com,2021-11-14,http://www.harper.info/
02-Dec-2020,Tax,10.43,00.00,"172,839.05",d002cD8C638f2AD,4734,Darrell,Benjamin,Santos Ltd,South Garrettville,Ethiopia,338-087-7522x4410,7333956127,holdengavin@sharp.com,2022-04-17,http://www.escobar.info/
02-Dec-2020,Cash,"26,772.04",00.00,"199,611.09",8Ee9bdeC8A1E3AD,609,Sydney,Davidson,"Mendez, Whitney and Mooney",Ferrellberg,Malawi,736.279.3232x66035,+1-429-493-5414x7234,hatfieldcynthia@calhoun.info,2022-05-15,https://www.ford.com/
02-Dec-2020,RTGS,00.00,"99,805.55","99,805.54",D91ADf42fC62B5D,7632,Jonathan,Coffey,"Gaines, Waters and Davidson",West Daisyhaven,Wallis and Futuna,+1-517-452-5092,7686237419,plamb@goodman.com,2020-12-21,https://www.hodge.com/
02-Dec-2020,Bill,"168,531.50",00.00,"268,337.04",F5BCbC9AFfAcb6a,5179,Leon,Norton,Roberson Ltd,West Douglasfort,Mali,920-392-8668,787-990-8685,jonathonellis@shaffer.biz,2020-12-17,https://www.rangel.com/
02-Dec-2020,Bill,00.00,"26,833.70","241,503.34",31BcB6AF4D35d4D,8893,Clinton,Short,"Yang, Braun and Zuniga",Caseystad,Kazakhstan,001-913-507-5286x01477,680-205-4429x2515,allen93@salas.biz,2021-02-15,https://barker.com/
02-Dec-2020,Tax,00.00,"40,250.56","201,252.78",427eC087b8aD8De,7774,Sheena,Knox,Herman LLC,North Regina,Anguilla,026.263.3719,544.904.1188x37868,mccalleric@castro.info,2020-01-22,https://peterson.com/
02-Dec-2020,Interest,05.40,00.00,"201,258.18",87A2cCA5453e8B5,6559,Ross,Farmer,Ayala-Solomon,Mossborough,Faroe Islands,+1-715-129-3040x18155,715.465.8079x47766,fkidd@medina.org,2021-10-30,https://hoover.com/
02-Dec-2020,Tax,04.00,00.00,"201,262.18",e99DcfDaDac8a06,20,Hannah,Ramsey,Hicks-Duran,Port Adrianport,Singapore,(822)795-8754x29384,(769)638-7026x967,amy99@booker.com,2020-12-30,http://www.larsen-floyd.biz/
02-Dec-2020,RTGS,00.00,"67,087.39","134,174.79",CE6effBbEeaeDF8,2785,Betty,Haney,"Peck, Macias and Chase",East Haileyside,Pakistan,(661)267-9544x56648,(229)533-6301,garneraustin@everett.com,2020-10-06,http://summers.com/
02-Dec-2020,Tax,00.00,"33,543.70","100,631.09",3eeEafAaE0E89Dc,2320,Kristen,Pacheco,Stephenson Inc,Lozanoland,Guyana,604.649.1724x21371,764-287-8916x0203,gmora@mcgrath.net,2021-02-12,http://barrett-larson.biz/
02-Dec-2020,Bill,00.00,"20,126.22","80,504.87",0c1cbAC211DA8CA,9121,Nancy,Cline,Joyce-Sheppard,Ashleyton,United States Minor Outlying Islands,791-865-2383x90000,001-613-701-4329,paulacortez@case.com,2021-08-25,http://andersen.com/
02-Dec-2020,Debit Card,"23,312.30",00.00,"103,817.17",BFb82fe21bf98AF,9555,Steve,Hardin,"Kemp, Forbes and Brandt",Rasmussenbury,India,948.416.8840x68135,2117978314,lchung@miller.info,2022-05-02,http://cherry.com/
02-Dec-2020,Miscellaneous,00.00,"12,977.15","90,840.02",bBc670d8404F8ba,6959,Trevor,Alvarado,Joseph-Ashley,Marciafort,United Kingdom,834-628-0048x119,001-564-259-3387x098,nicolas81@maddox.com,2020-09-26,http://www.ward.biz/
02-Dec-2020,Tax,52.00,00.00,"90,892.02",26E1F7196e2Ce0c,9448,Jeremy,Chan,"Sanchez, Haynes and Crawford",Lamchester,Luxembourg,+1-325-394-4233,4038675913,jrollins@becker.biz,2021-08-29,https://carter.com/
02-Dec-2020,Miscellaneous,"4,191.30",00.00,"95,083.32",c3928aAEf93beA7,2584,Perry,Zuniga,Lawrence-Gay,West Valerieland,Belgium,829-415-0057x08290,(574)431-5896x462,brettruiz@rivera-moss.com,2020-06-15,http://novak.com/
02-Dec-2020,Debit Card,"2,054,461.00",00.00,"2,149,544.32",431CF7E64CEE346,887,Earl,Wells,"Guerrero, Hinton and Nicholson",East Latasha,Sudan,804.524.5403x52164,+1-686-273-5209x429,valdezshelley@jarvis-buchanan.info,2021-05-15,http://www.mahoney-wiley.com/
02-Dec-2020,Debit Card,00.00,"307,077.76","1,842,466.56",47875Cdfb9cE5Bc,4122,Fernando,Terry,Lawson PLC,Dorseyside,Antigua and Barbuda,(465)394-3799x41119,(214)335-0824x066,makaylaward@steele.org,2020-04-28,https://castro-garcia.net/
02-Dec-2020,ATM,00.00,"921,233.28","921,233.28",52a2CAFAad429eF,4988,Mark,Stein,"Bailey, Hanna and Webster",Angelicamouth,Botswana,830-169-0995,(591)263-3077x7940,barberelijah@cameron-harvey.biz,2021-01-22,https://nixon.com/
02-Dec-2020,Bill,24.00,00.00,"921,257.28",b2e575b007336bD,728,Jaime,Wu,Eaton and Sons,East Mikayla,Moldova,+1-928-064-3005x39854,741.330.3523x555,luceroivan@mcdowell-macias.biz,2020-09-07,https://www.vazquez.com/
02-Dec-2020,NEFT,00.00,"184,251.46","737,005.82",4FbFAFDfF28d6b4,6893,Caroline,Blackwell,Rangel-Curry,East Diane,Haiti,592-549-0967x51402,223-260-1311,bondapril@richardson.com,2021-09-24,http://www.montoya.com/
02-Dec-2020,IMPS,"3,278.73",00.00,"740,284.55",4DaAFFadFeEe2cd,829,Jacqueline,Beltran,Morales-Kidd,Port Anneborough,Burundi,825.269.7428x56605,+1-828-852-6150x451,ustafford@rush-barr.com,2020-11-23,http://www.page.com/
02-Dec-2020,Transfer,"21,741.10",00.00,"762,025.65",f9CA62fCff320F8,7540,Mike,Rubio,Brock Group,Darrenchester,Ukraine,(835)564-3503x832,533.859.6985x3851,jodylopez@arroyo.com,2020-08-18,https://www.zamora.com/
02-Dec-2020,RTGS,00.00,"95,253.21","666,772.44",2dcb34Dcf3290dA,2988,Ruben,Horn,Weaver Inc,Bushmouth,Algeria,1661391606,994-852-9369,zunderwood@odom.com,2020-11-20,https://sweeney.com/
02-Dec-2020,Tax,00.00,"333,386.22","333,386.22",8aafDad024ae6b4,4287,Meagan,Mckay,Pitts-Soto,East Tara,Bahrain,+1-896-373-2746x4963,870-848-0252,nlutz@clarke-kane.info,2020-08-30,https://www.rhodes-mejia.com/
02-Dec-2020,IMPS,00.00,"41,673.28","291,712.94",8484EBAd0518576,3454,Stacie,Hutchinson,"Mullen, Bolton and Hunt",Lake Joshua,Anguilla,(179)680-4981,+1-491-436-2507x11551,lynnchurch@horne.net,2022-02-08,http://www.finley-wong.biz/
02-Dec-2020,Cheque,"20,564.07",00.00,"312,277.01",acBD5ffeF8edB7b,1218,Lorraine,Johns,Hopkins-Maldonado,Nortonland,Turkey,+1-606-535-2981,(093)713-9688x48279,mackenziewade@khan.com,2022-01-04,http://www.petersen.net/
02-Dec-2020,Commission,672.00,00.00,"312,949.01",75Ee35Fc1CbAdB6,5159,Cory,Garrett,Golden Ltd,West Kathleen,Lebanon,9959534365,+1-915-770-9843x6268,ayersnorma@hardin-terry.biz,2020-11-27,https://www.singleton.org/
02-Dec-2020,Bill,00.00,"39,118.63","273,830.38",8FBbaF601F4EDbE,2635,Rachel,Yates,Short-Kim,Jeromefort,Bangladesh,(774)021-4092x105,(977)929-3235,vcurtis@rollins-dodson.com,2020-10-28,https://www.wilkins-brown.net/
02-Dec-2020,Cheque,"15,022.00",00.00,"288,852.38",E487E76fa55e7a0,4536,Deborah,Buck,"Gonzales, Kline and Moore",Aguirreburgh,Senegal,+1-354-196-1458x54828,(660)752-6621x11121,pettysean@golden.org,2020-01-16,https://cisneros.net/
02-Dec-2020,RTGS,"686,688.00",00.00,"975,540.38",5546c08f8E23d8c,5806,Zoe,Hanna,Lam-Lin,West Stacie,Oman,(926)764-9929,(509)727-4215x375,bkerr@barry-bender.org,2021-10-11,https://www.watts.org/
02-Dec-2020,RTGS,00.00,"108,393.38","867,147.00",6817CCe5488bbee,7226,Nathaniel,Sloan,Wang-Spencer,North Sandra,Ethiopia,001-524-670-3579x564,001-913-268-5077x851,brent21@koch.org,2020-11-20,http://www.herring.com/
02-Dec-2020,NEFT,"1,306,153.00",00.00,"2,173,300.00",DD97BFFdfcDbd91,2688,Stanley,Spencer,Bird-Hanson,Sergiochester,Sierra Leone,001-610-011-9428x067,001-018-779-8367x6114,dodsonaimee@kirk.com,2021-10-29,https://rosario-warren.com/
02-Dec-2020,Miscellaneous,"2,282.70",00.00,"2,175,582.70",85cF0BA71aE67Ec,9313,Dustin,Weeks,Malone-Gallegos,New Chelseybury,Taiwan,+1-707-832-8459,(595)866-7925x94944,crodgers@griffith-barnett.com,2021-04-13,http://hanson.com/
02-Dec-2020,Interest,00.00,"271,947.84","1,903,634.86",92C1cF3cbfDC634,9241,Andrew,Hatfield,"Peterson, Krueger and Lawson",Farrellbury,Netherlands,105.841.3640x49271,246.343.5528x195,wrandolph@duffy-moore.com,2021-05-23,http://petty.com/
02-Dec-2020,Miscellaneous,"15,581.50",00.00,"1,919,216.36",20Ed3D3d2AA7dc1,6206,Reginald,Arias,Barrera Group,Tomburgh,Chad,946.871.2756,4359002644,melissabrewer@wolf-rice.com,2021-07-18,http://www.long.com/
02-Dec-2020,Reversal,"1,638,260.00",00.00,"3,557,476.36",C1e2f27674cB9e3,6233,Lindsey,Ramos,Cowan-Rivera,Aliceville,Martinique,001-186-311-9296x6384,274.441.2656x53685,hollowaydrew@mora-morrow.info,2022-05-21,http://www.travis.info/
02-Dec-2020,Bill,07.97,00.00,"3,557,484.33",Eee44fD22E0B7D0,1362,Cathy,Ellison,"Wilkins, Gross and Goodman",West Perry,Svalbard & Jan Mayen Islands,001-646-827-0664,370.890.2424,mike23@merritt.com,2020-11-14,http://www.lara.com/
02-Dec-2020,ATM,00.00,"1,185,828.11","2,371,656.22",B7b6EffBEbA2C4d,6404,Brendan,Rice,"Glenn, Rasmussen and Franklin",Port Kerri,Burundi,369-983-8007,001-839-864-7710x333,reneedecker@calhoun-kaufman.com,2021-11-18,http://www.erickson.com/
02-Dec-2020,NEFT,00.00,"263,517.36","2,108,138.86",00267CCcC317c9e,7598,Francisco,Morales,Barnett-Sharp,Lake Sharonfurt,Vanuatu,550.140.3873x31060,4011295824,lschultz@palmer.org,2020-12-05,http://www.little.net/
02-Dec-2020,IMPS,00.00,"1,054,069.43","1,054,069.43",40AEe659A3629aF,4983,Ivan,Butler,"Summers, House and Adams",Bobton,Italy,+1-378-049-9570,001-364-671-4220x644,castrocheyenne@hudson-ortega.net,2021-09-05,https://www.jacobson.com/
02-Dec-2020,Cheque,18.70,00.00,"1,054,088.13",Ec6254ac556A463,5740,Vernon,Frederick,"Miranda, Moody and White",Arielfort,Moldova,394-459-6809x044,(300)919-9925,joanmeyers@dickerson.com,2021-01-01,http://abbott.com/
02-Dec-2020,Commission,00.00,"131,761.02","922,327.11",CDae9E7C2dA5E96,443,Dave,Jensen,"Macias, Pham and Mcdowell",South Adriennechester,Bhutan,483-621-7937x55917,805-927-3101x4470,howard17@hickman.com,2020-10-27,http://harvey.com/
02-Dec-2020,Miscellaneous,12.90,00.00,"922,340.01",32C4705dB9b1CAD,9300,Isaiah,Mcdowell,Mckinney and Sons,Phillipsfurt,Uganda,202-935-0807x587,2518924316,joananthony@franklin.com,2021-05-16,http://saunders-andrade.com/
02-Dec-2020,Miscellaneous,00.00,"92,234.00","830,106.01",c9CcAF9FC94Dc07,5464,Terrence,Collins,Larson and Sons,New Donaldberg,Cyprus,001-056-906-5658x514,881.517.8397x852,alexwong@castro.com,2021-04-07,http://rollins.com/
02-Dec-2020,Tax,"130,529.00",00.00,"960,635.01",5dd4BC870E1eFac,1419,Andre,Rocha,Bryant Group,Phamfort,Malaysia,+1-611-784-9310x19582,+1-440-354-1631x5535,heidi30@holmes.com,2020-11-21,http://conner.info/
02-Dec-2020,Cash,16.91,00.00,"960,651.92",2F93cB2Fe98c5CC,2824,Jackie,Larsen,"Zhang, Wiley and Reeves",Brettfurt,Sweden,715-018-8464,493.903.8174x313,leroy10@riggs.biz,2020-07-28,https://www.wang.com/
02-Dec-2020,IMPS,"189,291.25",00.00,"1,149,943.17",AA8127Eb6Cb62Cb,2514,Brandy,Whitaker,Lutz-Delacruz,New Candice,Maldives,+1-933-906-0894x14649,(857)903-8074,mayerjustin@kelley.com,2020-04-12,http://www.christensen.com/
02-Dec-2020,RTGS,00.00,"164,277.60","985,665.57",148D7C9ca46571d,3773,Shaun,Wood,"Christian, Peck and Levy",West Bethland,Faroe Islands,001-289-404-7981,+1-363-405-6198x38860,barrettanthony@hendricks-singh.com,2021-09-23,https://www.kramer.com/
02-Dec-2020,Debit Card,"17,741.90",00.00,"1,003,407.47",89a142DB15f63E0,9761,Mitchell,Valentine,Morris PLC,Lake Neilbury,Palau,788-060-7606x1272,+1-565-327-1463x0309,vreynolds@alexander-taylor.com,2020-09-18,https://briggs-kennedy.com/
02-Dec-2020,ATM,00.00,"125,425.93","877,981.54",FC3C16DACd5e3EC,7374,Norman,Larsen,"Powell, Rios and Bass",South Theresa,Hungary,(360)866-0179x944,855-525-9308x63682,gregorykristi@kline-scott.com,2020-04-26,http://www.cordova-tucker.com/
02-Dec-2020,Cheque,00.00,"175,596.31","702,385.23",b07424e5EeC73cD,1693,Cole,Rollins,"Wiley, Wiley and Townsend",West Daniel,Vietnam,322.131.5486x62409,+1-479-787-8360,barnettkristin@livingston.com,2022-03-21,http://www.pollard.net/
02-Dec-2020,Debit Card,627.50,00.00,"703,012.73",0aB3b979af2d6D0,1904,Mckenzie,Jackson,"Mcgrath, Escobar and Cuevas",Henrymouth,Burkina Faso,299.348.8964x6462,(402)661-4214x6322,brosario@mercer.com,2021-11-30,http://foster.info/
02-Dec-2020,IMPS,"1,107,083.80",00.00,"1,810,096.53",3923f0621eFeCd0,5025,Gregory,Lara,Griffin-Morgan,Lake Tiffanyfurt,Cyprus,498-188-6423x06357,2285154098,kristina38@bryant-briggs.net,2021-10-14,https://www.castillo.info/
02-Dec-2020,Bill,"8,122.50",00.00,"1,818,219.03",EAa24E17c1796a1,2670,Austin,Choi,"Mays, Chandler and Mccullough",Port Latoya,Pakistan,+1-374-615-2025x0776,582-087-7990,isaacschroeder@arellano.com,2022-04-21,http://www.frederick-snow.net/
03-Dec-2020,Bill,03.70,00.00,"1,818,222.73",dA13cA63cCFB8A5,8998,Sara,Costa,Buck-Chapman,Katrinahaven,Afghanistan,001-542-320-5321,500-274-4271x000,guerrakenneth@villarreal.biz,2022-05-11,http://www.chapman-whitehead.com/
04-Dec-2020,Bill,00.00,"259,746.10","1,558,476.63",F3D4b4B8fEa3ad4,5988,Jade,Daniels,Blanchard Group,South Destinymouth,Belize,464-311-4296,001-775-052-5536,leonardbrady@hawkins-hill.com,2020-10-12,https://hess.biz/
04-Dec-2020,Interest,00.00,"222,639.52","1,335,837.11",6cBFcA8D33C5ae7,8930,Xavier,Cuevas,Macdonald-Weaver,Lake Damonburgh,Mayotte,4544952912,464-661-0858,isabel33@adkins.com,2021-12-14,https://bautista.com/
04-Dec-2020,ATM,00.00,"267,167.42","1,068,669.69",05E54aB466A8Fb1,5750,Joshua,Quinn,"Stewart, Middleton and Ramos",Tracymouth,Malaysia,001-581-991-8739x200,(444)046-2441,mary83@escobar.com,2021-05-29,http://johns-heath.com/
05-Dec-2020,Interest,00.00,"152,667.10","916,002.59",b5e45B5BfCBCE6b,7483,Haley,Livingston,Jennings-Duffy,Orozcobury,Slovenia,001-174-100-4853x135,(342)597-2442x727,lvillegas@pope.com,2020-03-31,https://www.walter.com/
05-Dec-2020,Reversal,00.00,"114,500.32","801,502.27",dDFe4C14d8FBfb8,9977,Chloe,White,Mcguire LLC,Kerryhaven,Guinea-Bissau,001-604-216-0584x442,9222541215,claire16@tapia-mcclain.com,2022-01-20,https://ferrell.com/
05-Dec-2020,Reversal,00.00,"160,300.45","641,201.82",5082266cCafB7EE,9424,Stacy,Guzman,"Skinner, Colon and Schmidt",Browningfort,Sudan,001-072-746-0708x22611,748.240.6277,alvin61@king.com,2021-07-31,https://www.levy-lowery.info/
05-Dec-2020,Tax,"122,102.90",00.00,"763,304.72",31ab71788D43Adc,5708,Cole,Lam,Schaefer-Barnes,West Shaun,Cape Verde,001-548-541-5116x4452,+1-919-821-4524x0064,chooper@huffman-braun.com,2020-10-28,http://riddle-cuevas.com/
05-Dec-2020,Cheque,478.51,00.00,"763,783.23",1C990dbadbfD3e9,8071,Susan,Strickland,Barrett-Beltran,Beverlyhaven,Mongolia,386-413-2051,+1-035-889-5524x2382,rushsheena@brady-luna.com,2021-08-13,https://www.peck-medina.info/
05-Dec-2020,Tax,00.00,"127,297.21","636,486.02",B2DC6ad9e8bFff9,8557,Dan,Ortiz,"Mcpherson, Montgomery and Khan",Lake Dariustown,Togo,(937)468-6840,159-618-8218,villanuevadakota@bowers-lopez.com,2022-01-25,http://www.morse.com/
05-Dec-2020,Commission,00.00,"318,243.01","318,243.01",7ffdc6cfcB8bEf6,2259,Julian,Walsh,Gross Inc,Greerside,Guernsey,001-099-171-6423x5891,001-828-288-8801x73174,qrobles@robbins.info,2020-05-04,https://www.mullins-hodges.net/
05-Dec-2020,Cheque,00.00,"35,360.33","282,882.68",4846e02E3b55C29,6291,Traci,Mckenzie,"Yoder, Kemp and Price",Port Rickeyborough,Gabon,451-032-3491,(744)437-8613,natashahaney@armstrong.info,2022-01-25,https://nash.com/
05-Dec-2020,Tax,00.00,"56,576.54","226,306.14",fe5fAbBDD1D2eFD,4930,Christie,Sandoval,"Harvey, Bauer and Weaver",East Roberto,Cyprus,892.912.7067,(178)155-2534x49676,emoran@shields.biz,2021-06-30,http://www.beard.biz/
05-Dec-2020,Miscellaneous,253.00,00.00,"226,559.14",6DdADca2C7744fD,224,Max,Gates,Solis-Olson,West Rubenburgh,Micronesia,001-401-710-2797x2407,4420602669,xrollins@mcfarland.com,2020-02-11,https://www.hood-decker.com/
05-Dec-2020,Interest,00.00,"32,365.59","194,193.55",9a68f7Eb239E8Fd,8805,Terry,Grant,"Rivers, Pratt and Frederick",West Danielhaven,Tuvalu,958-595-0813,5326283451,eatkinson@barr.biz,2021-07-31,https://valentine.com/
05-Dec-2020,Purchase,00.00,"48,548.39","145,645.16",9dfd0C879cEb5Aa,9449,Leonard,Sellers,Cooley-Hartman,South Donna,Namibia,(850)702-4678x5669,001-462-140-8382x29289,dickersonstuart@li.com,2022-05-04,http://shannon.com/
05-Dec-2020,Debit Card,06.00,00.00,"145,651.16",fA2Ac4C6a1e9cEd,9529,Terri,Knapp,Peterson-Hoffman,Pattonmouth,San Marino,(000)575-1644,001-919-710-8180,bradymora@esparza-gill.net,2020-01-02,http://www.pena.info/
05-Dec-2020,ATM,80.80,00.00,"145,731.96",1adECd8c5B45eD5,9672,Molly,Lopez,Rose-Esparza,East Lydiahaven,Cote d'Ivoire,181-107-0798x19738,014.330.2867,caseybowman@liu.com,2022-04-15,https://clarke.com/
05-Dec-2020,RTGS,00.00,"48,577.32","97,154.64",25CFb6d4DF3aA87,375,Carla,Wolfe,Becker-Howard,Alishaborough,Kazakhstan,520.277.0142x65524,+1-017-185-1301x606,aaron28@arellano-lang.net,2021-01-12,https://www.ayala.com/
05-Dec-2020,Bill,00.00,"12,144.33","85,010.31",050D39F575fbd1A,603,Loretta,Haas,Carter-Hurst,Starkchester,Nepal,879-463-5649x211,001-849-362-7175x880,lovemelissa@baldwin.com,2020-03-20,http://www.sawyer.com/
05-Dec-2020,Interest,00.00,"10,626.29","74,384.02",0Caf9BCC43e6Aff,6069,Kyle,Chapman,"Gross, Burnett and Weiss",Lake Gordon,India,867-833-1410,+1-698-773-6880x37480,tuckerjoanna@schmitt.biz,2020-09-01,http://burch.com/
05-Dec-2020,NEFT,33.45,00.00,"74,417.47",2Cc95CEB154eFDC,6300,Priscilla,Foley,"Solis, Gentry and Cobb",Josefort,Tajikistan,+1-647-651-2281x43900,+1-335-023-5874x0556,alvin68@trujillo-goodwin.com,2021-05-28,http://williams.com/
05-Dec-2020,Interest,00.00,"9,302.18","65,115.29",9D41e5C65BbD2E0,6528,Glenn,Buckley,Daniel Group,Whitneytown,Wallis and Futuna,913-793-8266x34203,001-851-525-4757x293,joanhurst@morgan.info,2021-06-10,http://deleon.info/
05-Dec-2020,Tax,00.00,"8,139.41","56,975.88",8ECaBEA66C97EA3,6009,Lee,Scott,Henry-Cisneros,Lake Joseph,Turks and Caicos Islands,197.216.0576,+1-491-786-5035x49641,carolynrice@maynard.com,2020-12-04,https://floyd.org/
05-Dec-2020,IMPS,00.00,"11,395.18","45,580.70",af7F8FFfC17014E,1511,Grace,Thompson,Barajas-Houston,New Adrian,Taiwan,626-451-6922,(590)461-8969x099,salinasolivia@kane-hubbard.com,2021-07-23,http://arnold.info/
05-Dec-2020,Tax,00.00,"7,596.78","37,983.92",559373cB858Db92,4159,David,Francis,"Hughes, Townsend and Bailey",North Shelly,Trinidad and Tobago,+1-152-422-2850x04770,001-492-354-0441x4618,darrylbradley@bruce.info,2021-07-04,http://jacobson.com/
05-Dec-2020,Cheque,00.00,"37,983.92",00.00,Ec20Ac6f8c97AFb,2873,Raymond,Powell,"Robbins, Ali and Love",Nicholsonville,Eritrea,+1-558-697-6202x7739,001-538-862-4679x280,fkaiser@fernandez.com,2020-12-15,https://benton-gibbs.com/
05-Dec-2020,Tax,"212,667.80",00.00,"212,667.80",c80FE6FfBAfDc6b,7996,Karla,Huang,Daugherty LLC,North Xaviermouth,Andorra,220-457-7567x55730,(160)483-6452,catherinerocha@frederick-cannon.com,2021-10-15,https://ramsey-duncan.com/
05-Dec-2020,ATM,"2,462.64",00.00,"215,130.44",54E6Cc6c49A086e,7837,Katelyn,Santiago,Rose LLC,South Andre,Bosnia and Herzegovina,362-544-5667x931,001-022-028-9159x2172,huffmanashley@cole.com,2021-10-22,http://hodges.org/
05-Dec-2020,Debit Card,00.00,"35,855.07","179,275.37",d5BbcEE7E4da8ae,7343,Cheryl,Meza,Thomas-Perry,East Feliciaview,Guadeloupe,(971)398-3742,(918)085-6470x6678,alexamiddleton@golden.org,2020-07-24,https://weiss.info/
05-Dec-2020,Reversal,00.00,"17,927.54","161,347.83",a9F3D3EBEb7abCD,8581,Meghan,Chang,"Galvan, Ramos and Cowan",Hartburgh,Tunisia,(290)168-2422x2169,741-244-1244x3007,doris96@warren-peters.com,2022-05-08,http://baird.com/
05-Dec-2020,Cash,00.00,"26,891.31","134,456.52",a17Fc98B86Db6F5,5946,Kim,Perkins,Bray PLC,Bryanchester,Malawi,(946)071-0993x860,(422)580-9394,schwartzjessica@quinn-mayo.com,2020-04-09,https://terry.net/
05-Dec-2020,RTGS,"1,730,089.00",00.00,"1,864,545.52",aBAfDAF3CA90EC2,2192,Jacob,Perez,Roach-Anthony,Chamberston,Palestinian Territory,+1-098-965-7583x4101,(317)606-3649,katie06@greene-pham.com,2021-06-21,https://mcgee.com/
05-Dec-2020,Transfer,07.56,00.00,"1,864,553.08",e02c3911E7d7cD2,6754,Terri,Fleming,"Pugh, Simon and Hatfield",South Mauriceton,Iran,789.408.7831x6551,694-766-1815,adkinsdana@abbott.com,2021-08-10,https://www.jensen.com/
05-Dec-2020,NEFT,00.00,"621,517.69","1,243,035.39",6E8b320EdeD15Ed,2522,Alexa,Weaver,Hartman-Abbott,South Leah,Marshall Islands,818.003.0753,+1-668-388-5306x3347,mileslori@clarke.com,2020-08-19,https://bruce.com/
05-Dec-2020,Cash,29.48,00.00,"1,243,064.87",e87b3FC63CB7173,6993,Emily,Salas,Duncan and Sons,South Catherineview,Macedonia,457.779.8231,(260)267-6179x514,petersonnichole@travis-morrison.biz,2020-11-26,http://diaz.com/
05-Dec-2020,Purchase,00.00,"248,612.97","994,451.90",d7Be5F1F08B6ba4,1643,Adrian,Moon,Carr LLC,East Jodistad,Croatia,(037)354-6401x54229,+1-891-301-6165x9327,stricklandmargaret@johnston-ayers.com,2021-03-09,https://price-eaton.biz/
05-Dec-2020,Transfer,00.00,"198,890.38","795,561.52",BD2Be3DFA9ff3Cf,8251,Krista,Mayer,"Barton, Christian and Ramos",North Sonyaville,Armenia,3274819405,001-663-088-7251x214,gvillanueva@cowan.com,2020-10-24,http://costa.com/
05-Dec-2020,Cash,00.00,"265,187.17","530,374.35",0EEd0FAbc4fbBeB,8631,William,Greer,Powell-Floyd,Port Laurabury,Niue,541.506.7432x6879,(324)443-7606x0558,lauriereilly@stokes-hoffman.com,2021-02-18,https://thomas.com/
05-Dec-2020,Interest,00.00,"530,374.35",00.00,FB857e7Ead761Cd,551,Hector,Sloan,Hoffman Group,West Joy,Croatia,001-748-784-1312x97719,050-795-0298x2325,lwhitehead@suarez.com,2020-04-29,http://www.owens.info/
05-Dec-2020,Bill,"1,716,175.25",00.00,"1,716,175.25",F97B9cdFF3edaeD,3863,Beverly,Wheeler,Cameron-Salinas,New Paul,Monaco,(404)361-6049x07973,001-829-991-9399x3736,michelenewton@conway.com,2020-08-28,https://www.fuller-dominguez.com/
05-Dec-2020,IMPS,00.00,"171,617.53","1,544,557.72",AadCEfAA52EAfdc,5558,Marilyn,Chan,"Day, Arias and Washington",Lake Laurie,Seychelles,+1-910-900-7825x08202,001-063-900-7836x6641,eduardo28@villegas.info,2022-05-27,https://williamson.com/
06-Dec-2020,Transfer,00.00,"193,069.72","1,351,488.00",Cc37EF9858bddA5,7481,Charles,Carr,Hodges Ltd,Port Gilbertmouth,Burundi,481-014-2165,722.287.8733,donovantony@steele.info,2022-05-29,https://cortez.com/
06-Dec-2020,ATM,00.00,"193,069.71","1,158,418.29",EaD5472E5B3ffd8,9714,Christina,Luna,Pierce-Greene,Kathleenchester,United Arab Emirates,637.554.5988,984-335-1384,schmidtbryce@lang.com,2021-07-01,http://wade.com/
06-Dec-2020,IMPS,00.00,"115,841.83","1,042,576.46",DfB38A4b6C09Cd2,9295,Gavin,Wang,Andrews-May,West Alyssa,Albania,2692595332,719.526.0999x0974,samuelhines@wheeler-carter.com,2020-11-01,https://www.zimmerman-hines.com/
06-Dec-2020,Purchase,"2,185.00",00.00,"1,044,761.46",C0D9cBcB2A4c5Ad,5940,Ricardo,Holder,Hansen-Kirk,Robertsfort,Cambodia,891-644-7342,277.690.7769x232,murillochristian@butler.net,2021-09-26,https://www.peters.com/
06-Dec-2020,Commission,09.70,00.00,"1,044,771.16",3BD7AD41d2EDAbb,8649,Dominic,Simon,"Odom, Key and Terry",Soniashire,Equatorial Guinea,331-675-5980x7820,(938)204-1317,tfuentes@benson-mack.com,2021-08-05,http://www.blair.com/
06-Dec-2020,Purchase,00.00,"149,253.02","895,518.14",e7070A3300c507F,2651,Brad,Campos,Lozano-Sanchez,Aaronview,Turkey,051.149.1403,595-729-3774,rachelmosley@holden-ware.com,2020-09-21,http://www.macdonald-marks.com/
06-Dec-2020,Debit Card,00.00,"111,939.77","783,578.37",ba9a40bb85e441b,5610,Alfred,Lopez,Huff Inc,Connorstad,Holy See (Vatican City State),+1-133-745-3620x865,+1-100-695-6345x17893,fullerbrandy@petersen-mcmillan.biz,2020-07-26,https://www.noble.com/
06-Dec-2020,Miscellaneous,"12,056.23",00.00,"795,634.60",C86cf319070c8C0,4990,Katrina,Dunn,Noble PLC,Frankborough,British Indian Ocean Territory (Chagos Archipelago),(977)185-6031x9439,+1-362-403-2775,medinaregina@pittman.com,2020-10-24,http://pruitt.com/
06-Dec-2020,IMPS,271.21,00.00,"795,905.81",EBeFbAC64966dBD,4510,Nichole,Shaw,"Dickson, Leblanc and Curry",South Andreside,Sudan,001-528-246-9147,045-769-8443,glen76@hoover-coffey.biz,2020-08-19,http://www.mcconnell.com/
06-Dec-2020,Reversal,00.00,"198,976.45","596,929.36",6AFE9e8b5dCEbA0,114,George,Wiley,"Dillon, Bonilla and Spears",Soniaborough,Venezuela,001-058-121-9076x80580,001-841-168-9150x72755,preston76@house.com,2020-08-07,https://valencia.com/
06-Dec-2020,Tax,00.00,"66,325.48","530,603.88",8e1eEA85bbCac14,7393,Mindy,Mcintyre,Soto-Boone,Lake Sergiofurt,Saint Pierre and Miquelon,391-218-3785,001-546-367-4824x164,lauriequinn@schneider-byrd.com,2021-06-15,http://greer-singh.com/
06-Dec-2020,Reversal,"2,370.41",00.00,"532,974.29",c58Ae51282CB929,9366,Alejandro,Orozco,Carlson and Sons,Joseville,Korea,056.536.4448,001-864-337-6510x9043,donovanjaime@farmer-cochran.com,2022-02-12,http://www.brock-lozano.com/
06-Dec-2020,Miscellaneous,00.00,"133,243.57","399,730.72",ACe423C3Ba715dD,1963,Neil,Morris,"Rice, Mcclain and Anthony",South Seanview,Serbia,1733386399,+1-750-790-1198x697,isaiah50@jenkins.com,2021-02-27,https://www.medina.com/
06-Dec-2020,ATM,00.00,"399,730.72",00.00,f7F909A8143F0D5,7112,Tiffany,Bass,Brewer-Obrien,Wiseville,Myanmar,331-716-9416x957,+1-111-306-0496,preston28@simon.net,2020-05-21,https://rubio-haynes.com/
06-Dec-2020,Bill,"11,859.40",00.00,"11,859.40",dD4be1A5bef3FA2,9716,Diamond,Gaines,Webster-Schaefer,East Gina,Maldives,215-788-0180x4567,(791)687-8276,ernestluna@hays-ford.com,2020-02-14,https://www.hess.org/
06-Dec-2020,RTGS,00.00,"3,953.13","7,906.27",FefddFAd7a6AfD1,4806,Geoffrey,Hammond,Oneill-Lawson,Bridgetton,Nepal,(653)031-5183x20332,+1-975-216-7757x950,shari49@mason-floyd.com,2021-04-05,http://www.black-mercado.com/
06-Dec-2020,Tax,"239,093.10",00.00,"246,999.37",9903e8fF4D8Ff0F,10000,Melissa,Montgomery,Burns-Holden,Sparkstown,Tunisia,+1-889-682-9490x65400,423.632.2539x98740,ngallagher@martinez.com,2020-06-27,http://nixon.net/
06-Dec-2020,ATM,688.90,00.00,"247,688.27",aC3d6e0FE026091,8433,Omar,Snyder,Shea-Branch,Ninaburgh,Slovenia,412-928-1618x1283,+1-526-190-7368x298,chelsey22@lane-weiss.com,2020-01-01,https://ayala.com/
06-Dec-2020,Interest,"1,031,646.25",00.00,"1,279,334.52",5FfDcedF910Ae6c,5236,Alex,Herring,"Zhang, Vargas and Perez",Caitlynshire,Costa Rica,001-766-671-5068x90199,816-105-2005x47291,judithhuffman@johnson.info,2021-05-14,https://www.velez-bennett.org/
06-Dec-2020,Cheque,00.00,"159,916.82","1,119,417.70",073E46f4aea94E3,5309,Julia,Kelly,"Mcguire, Stuart and Mccann",Shahview,El Salvador,709.940.8025x638,606.505.9740x805,igarrison@bennett-gomez.net,2021-03-19,http://mcbride-oneal.net/
06-Dec-2020,Interest,00.00,"124,379.74","995,037.96",EB838Cb6FcBB2F2,1902,Joseph,Shaw,Hudson Inc,Port Prestontown,Gambia,(745)768-8584,001-628-116-5211x2210,omorgan@meadows.com,2022-02-05,http://soto.com/
06-Dec-2020,NEFT,00.00,"199,007.59","796,030.37",4fa5Bb004EC00bF,2642,Rachael,Sharp,Osborne LLC,East Mirandaview,Jordan,2290417859,(143)781-1376,zimmermanlauren@peterson.org,2020-09-08,http://www.coffey.biz/
06-Dec-2020,Commission,04.42,00.00,"796,034.79",17f1B041b0bc58B,2388,Albert,Mcfarland,Mathis PLC,South Mariah,Afghanistan,001-774-583-0062x287,001-607-235-1597x718,qburke@alvarado.com,2020-10-22,https://www.stanton.com/
07-Dec-2020,Interest,00.00,"99,504.35","696,530.44",6fA35a6AC521fA4,9708,Rachel,Joyce,Wade PLC,West Brendan,Western Sahara,001-130-468-9523x0039,001-422-222-2402x3379,emilydougherty@knox.com,2020-10-26,https://barnes.com/
07-Dec-2020,Tax,03.90,00.00,"696,534.34",EdC595c710f313f,1909,Caitlin,Boyd,"Frazier, Li and Landry",Wandaville,Austria,496-245-3496x550,366-275-4738x261,javierconner@saunders.com,2021-07-30,https://www.harper.com/
07-Dec-2020,Cash,16.90,00.00,"696,551.24",FB9bF1c3ed2bd1D,9835,William,Callahan,"Gill, Ayers and George",Lake Joannbury,Holy See (Vatican City State),(375)325-8218,(157)180-8947x345,andrecastaneda@cook-sweeney.biz,2021-09-06,https://www.cowan-ramirez.org/
07-Dec-2020,Reversal,"4,641.07",00.00,"701,192.31",DABb9bD3CE75FF3,8388,Peggy,Holt,Fitzpatrick Ltd,Mortonside,France,434.173.9632x9161,(660)264-1581x0816,rfuller@torres.com,2020-04-09,https://www.marks.info/
07-Dec-2020,Interest,00.00,"116,865.39","584,326.93",FecefB34FC8FB3a,2866,Savannah,Webb,Barr-Guerra,Port Samuelchester,Zimbabwe,001-709-761-8776x432,+1-540-676-4045,sheliazavala@tapia.com,2020-04-08,http://www.ford-odom.com/
07-Dec-2020,Cash,00.00,"73,040.87","511,286.06",17570F9C8DEFf10,4251,Henry,Bradshaw,Ward-Fleming,New Vernonview,Western Sahara,+1-701-837-8006x62643,695.641.5556x727,zavalakirsten@chase.com,2020-03-21,http://www.burch.com/
07-Dec-2020,RTGS,06.37,00.00,"511,292.43",F32c88af72E729D,8051,Karl,Braun,Benson-Everett,Gravesbury,Eritrea,552.080.6560,001-722-132-5633x52949,zchurch@schmidt.net,2021-03-07,https://www.burch-bender.com/
07-Dec-2020,Commission,00.00,"170,430.81","340,861.62",BEdE88bA1E0Eb0F,3078,Dan,Johns,Wilkerson-Dalton,Priscillaland,Monaco,4228043676,+1-598-056-6914x8330,vhayden@cantrell.info,2021-05-17,https://robbins-estes.biz/
07-Dec-2020,Miscellaneous,"158,134.10",00.00,"498,995.72",5DAf7f2CEA6B73F,5211,Bradley,Allison,Anthony-Zimmerman,Port Benjamin,Algeria,+1-474-683-3733,+1-932-110-1490x65685,ewingtyler@proctor-gill.com,2022-01-19,https://www.white.biz/
07-Dec-2020,NEFT,00.00,"498,995.72",00.00,16F0421Dd94C4fD,1428,Cameron,Meza,Gardner-Bridges,Sawyerside,Brunei Darussalam,659-260-1914x196,+1-598-815-1270x26682,gordonandersen@duarte.com,2022-02-20,http://www.soto.biz/
07-Dec-2020,Reversal,07.00,00.00,07.00,dAfC3DdDf2CdFa3,4727,Gabriel,Pierce,Beard Inc,South Ralph,Israel,(053)912-0408x297,(889)147-2000,zachary49@burnett-dominguez.com,2021-04-14,http://frost.com/
07-Dec-2020,Reversal,"1,886.60",00.00,"1,893.60",137Bd9E1Ad1c174,8382,Jeffrey,Dillon,Allen and Sons,Port Terrence,Vanuatu,(405)030-2982,+1-224-043-5731x434,robertenglish@bean.com,2021-03-29,https://fleming-hickman.org/
07-Dec-2020,Purchase,00.00,270.51,"1,623.09",E81AADA7AFFD3a0,5354,Kristopher,Savage,"Webster, Ross and Cherry",Noblestad,Zimbabwe,744-219-9442,583-288-0000,tamiunderwood@rios.com,2021-07-09,http://www.wiley.com/
07-Dec-2020,Bill,"1,082,696.00",00.00,"1,084,319.09",a0b56AfaCba8CE5,1575,Clayton,Duran,Burns-Acosta,New Wendy,Tonga,001-152-308-6862,(814)468-4190x867,rfoster@curry.biz,2021-09-25,https://quinn-hardin.com/
07-Dec-2020,Reversal,00.00,"135,539.89","948,779.20",2bF7C186fb685d4,646,Jeff,Ellison,"Odom, Valentine and Costa",Bartlettchester,Moldova,283.164.2717,(787)216-7465,roy81@townsend.info,2021-09-20,https://www.matthews.info/
07-Dec-2020,Transfer,211.00,00.00,"948,990.20",2c8F7FF1ECe7267,8816,Anthony,Morris,"Gutierrez, Gilmore and Bowen",Riversland,Korea,388.333.0006,(581)370-9157x113,ustokes@duncan-navarro.net,2020-02-24,https://reed-valencia.com/
07-Dec-2020,IMPS,03.98,00.00,"948,994.18",aB41dba4eFFe03A,2916,Aimee,Wall,Melendez-Tyler,Whitneytown,Angola,520-829-3466x8250,2652638031,cantukirsten@bond-goodman.biz,2020-11-01,https://www.zimmerman.biz/
07-Dec-2020,RTGS,00.00,"118,624.27","830,369.91",C6b62Ed169d0f4F,6748,Mark,Stephenson,"Greene, Moon and Allen",Duartemouth,Finland,427-519-7457x27731,072-969-4884x707,alexandermorgan@conley-fischer.org,2020-07-18,https://www.austin.com/
07-Dec-2020,NEFT,00.00,"830,369.91",00.00,db3F7Bd8eA85106,6721,Jackson,Ho,Huerta-Dillon,North Greggbury,Palestinian Territory,+1-159-746-3842x53553,(984)783-1446x956,sherrygolden@beck.com,2020-04-05,https://www.cameron.org/
07-Dec-2020,Bill,"10,994.30",00.00,"10,994.30",c14e74C2AFcc2DB,661,Gabriel,Day,Mccarty PLC,South Kristie,Lithuania,(661)314-0847,676-142-0275,tamiwilkerson@schneider-howard.com,2020-02-08,https://www.short.net/
07-Dec-2020,Cash,00.00,"2,748.58","8,245.72",bB60D35a77Ce07F,8780,Sydney,Mcclure,"Dennis, Mueller and Ponce",Port Frankshire,Cameroon,347.959.3820,001-982-921-1877x51003,sophiacantu@mckee.com,2022-05-04,http://holland.com/
07-Dec-2020,Transfer,"240,329.70",00.00,"248,575.42",3E02f6ACbbDd8A6,2008,Joanna,Anderson,Short LLC,Lake Yvetteborough,Tanzania,098-221-5161,077-540-0604x8590,jonathon01@nielsen.com,2020-10-08,https://mays.com/
07-Dec-2020,Commission,07.83,00.00,"248,583.25",8A8BcAfeafff70D,320,Melanie,Ingram,Andersen Inc,Hensleyside,Bangladesh,066-212-1907x57334,+1-089-218-4643x612,michaelcheyenne@ewing.info,2022-05-16,http://www.kaufman-callahan.com/
07-Dec-2020,Reversal,00.00,"41,430.54","207,152.71",8ba4F40EFB7e5C6,8093,Xavier,Lawson,Weaver-Odom,Holtfort,Japan,(846)504-6020x33164,303-132-5298x252,april17@marshall.com,2020-09-09,http://salazar-york.com/
07-Dec-2020,Purchase,00.00,"41,430.54","165,722.17",dCb7b9aFdfe2C7A,4056,Guy,Sellers,Kennedy PLC,New James,Georgia,(281)516-7945x6852,(020)569-0163x71834,normanchristina@kirby.biz,2021-12-13,http://www.riley.com/
07-Dec-2020,Commission,445.61,00.00,"166,167.78",7De1dceEe0c1cD9,5316,Cesar,Pennington,Norris-Mahoney,South Jermaine,San Marino,(040)344-6446,+1-056-181-1156x86162,whitneyclifford@costa-black.info,2021-09-15,https://hoffman-briggs.com/
07-Dec-2020,Bill,00.00,"83,083.89","83,083.89",cAa7CE7bCFfD5C9,920,Pamela,Mckee,Barr-Brennan,Brightstad,Canada,(871)449-1034,+1-753-308-5468x6684,idennis@acosta.com,2021-09-04,https://www.short-orr.net/
07-Dec-2020,IMPS,"236,751.00",00.00,"319,834.89",C6CeBBaDFf5ED10,3204,Kaitlin,Livingston,Proctor Group,Aguilarfurt,Honduras,593-529-7909x683,(289)643-9861,horncollin@downs.com,2020-07-15,https://cervantes.com/
07-Dec-2020,Interest,238.96,00.00,"320,073.85",64AeEDDA6883DDA,3824,Kelli,Wu,Mcdowell and Sons,Brucefurt,Saudi Arabia,+1-369-430-6558x69496,1593076970,alfredhaas@cowan.com,2021-11-01,https://www.holloway-johnson.com/
07-Dec-2020,Bill,"1,812,947.75",00.00,"2,133,021.60",CB31FdfAbFb64DE,5876,Thomas,Moyer,Coleman PLC,Sparksborough,Latvia,(799)996-0165x434,001-590-001-8568x9115,hoodryan@brewer.com,2022-04-27,http://hart-pruitt.org/
07-Dec-2020,Commission,00.00,"426,604.32","1,706,417.28",f6EA2cAC3FaDdbA,7397,Wanda,Booth,"Campos, Roth and Braun",Darylville,Angola,597.460.9569x518,001-546-167-2353x16077,elaine01@williams-wood.com,2021-07-17,https://mcguire.info/
07-Dec-2020,IMPS,25.20,00.00,"1,706,442.48",544F80dFf8E8fd8,2401,Dominic,Rivera,"Horton, Atkins and Blankenship",Port Lauren,United States Minor Outlying Islands,520-713-8469x53261,709-244-8586x756,chenjulia@mason.com,2020-12-11,http://page-meadows.com/
07-Dec-2020,Purchase,"29,183.30",00.00,"1,735,625.78",dE1Ae4fea53eaC2,1890,Sarah,Leblanc,Ashley-Melton,Daltonville,Sudan,317.783.1164x385,2227393195,jimbailey@hays.org,2020-02-07,http://www.acevedo-allison.biz/
07-Dec-2020,Commission,"2,019,974.80",00.00,"3,755,600.58",83daF1d42D41a2b,4628,Margaret,Farrell,Daugherty PLC,Port Marilyn,Burundi,001-696-199-1152x73155,991.526.6317x95241,wallskristy@brooks-barton.biz,2020-09-08,https://duffy.com/
07-Dec-2020,Miscellaneous,00.00,"536,514.37","3,219,086.21",49c2e2b7aFdd0A7,8359,Joshua,Webster,Beard LLC,Brittanystad,Palestinian Territory,559.874.0611x19715,895.404.1717,lutzmathew@parks.info,2021-03-02,http://madden.net/
07-Dec-2020,Purchase,00.00,"536,514.37","2,682,571.84",AC7Eaf9cAb2E66A,7259,Sue,Blackburn,"Ballard, Holden and Wang",Lake Sydneyborough,Jamaica,001-537-462-7135,321.549.1452x4002,saunderssue@montoya.com,2021-02-25,https://jensen.com/
07-Dec-2020,Commission,00.00,"298,063.54","2,384,508.30",4bddEc9ab37Eaea,1498,Cristian,Ritter,Preston-Quinn,New Kayla,Cote d'Ivoire,001-686-477-2816,704-894-8000x2217,colemandebra@waller.com,2020-02-07,http://www.sanchez-daniels.org/
08-Dec-2020,Tax,00.00,"397,418.05","1,987,090.25",cff7B1a7DfAfe2B,1171,Taylor,Griffin,Schaefer-Goodman,Mcclainbury,Seychelles,916-871-3245,0726009129,maddoxmonica@hoover-hayes.info,2021-06-20,http://www.douglas-alvarado.com/
08-Dec-2020,Bill,"127,992.00",00.00,"2,115,082.25",8EF648703AB9197,8230,Nicholas,Heath,Ellison-Wiggins,Bestfort,Turks and Caicos Islands,400-955-2761x993,+1-782-812-1245x5902,leroy33@yoder.com,2021-10-30,http://moore.net/
08-Dec-2020,Cash,00.00,"211,508.23","1,903,574.02",9c1Dbb91cbe3D2f,7276,Erika,Horn,"Barry, Robles and Mcdonald",New Mariahmouth,Slovenia,145-215-2886,001-736-959-2242,april97@sloan-fuller.com,2020-11-26,https://santos.info/
08-Dec-2020,NEFT,"59,313.00",00.00,"1,962,887.02",6b86dEADBadfEb1,2346,Tyrone,Beck,Fry-Chung,New Tanyaton,Singapore,857-043-4246x917,287.864.3414x71217,darin53@tucker-meyers.net,2020-11-07,http://torres.com/
08-Dec-2020,IMPS,06.97,00.00,"1,962,893.99",9E667AC7abfA2eE,4599,Edwin,Barrera,Stout-Shelton,Mccluremouth,India,666.626.7424x7912,(393)780-3445,curtisnicholson@yates-howard.biz,2020-10-09,http://www.vaughan.com/
08-Dec-2020,Interest,00.00,"327,149.00","1,635,744.99",56e8e7f106005d7,3861,Dominique,Hess,Hall Inc,New Bill,Cuba,001-215-218-1707x707,535.253.6039x44010,justin89@mcneil.com,2022-03-22,http://www.merritt.com/
08-Dec-2020,Commission,00.00,"163,574.50","1,472,170.49",Cbf5CfccF97Cac8,1777,Dean,Stone,Patel-Mercer,Caitlinland,Saint Kitts and Nevis,3237621468,(348)743-8731x95608,wesley97@keller-walters.com,2022-04-18,https://www.bell-murphy.com/
08-Dec-2020,Purchase,00.00,"245,361.75","1,226,808.74",cF69E415A7aACea,5937,Faith,Nixon,"Knight, Mora and Barrera",New Victoriaport,Palau,645-039-5402x265,(995)935-8539x1007,kentward@hooper-wong.com,2022-03-05,https://www.jordan-rubio.biz/
08-Dec-2020,Commission,00.00,"245,361.75","981,446.99",660DF2Bc128c66e,4143,Jason,Roberson,Sullivan LLC,New Kerry,Philippines,(023)709-6994x3354,(317)472-3422x700,devinwolfe@garrison.info,2020-07-08,http://www.coleman.com/
08-Dec-2020,IMPS,30.29,00.00,"981,477.28",FD6a3C5052c10D7,7086,Denise,Ramsey,Baker-Young,Nataliechester,French Guiana,+1-078-262-9641,201-434-8511x58626,marcturner@harper-sampson.com,2022-05-02,http://paul.com/
08-Dec-2020,Cash,"155,109.00",00.00,"1,136,586.28",B4eFdBA1FdCba01,2754,Bailey,Taylor,Cannon LLC,Bassmouth,Pakistan,(372)542-3749x02429,(614)501-3894x922,chasemeredith@grimes.biz,2020-08-23,https://mann-martinez.com/
08-Dec-2020,Debit Card,"77,367.90",00.00,"1,213,954.18",Ed1eDdeecefEEa4,8279,Anne,Frank,"Nash, Bowen and Daniel",Port Virginiafort,Kuwait,(998)800-8203x486,(737)446-0048,starkjeremiah@michael.com,2020-12-01,https://tran-marquez.com/
08-Dec-2020,Tax,05.34,00.00,"1,213,959.52",9159EdB73DCC05C,3963,Jimmy,Landry,Bentley-Camacho,Whitneyborough,Australia,001-727-460-7620x45344,550-243-3433x75677,cliffordhuff@ferrell-flores.com,2021-10-31,http://chaney.com/
08-Dec-2020,Tax,"1,698,192.50",00.00,"2,912,152.02",be4f53D0ed6aa57,2301,Cameron,Le,Collins-Obrien,Lake Sherritown,San Marino,(667)691-9385,780.923.4808x0592,herbertphelps@reid.com,2020-11-16,https://lester.com/
08-Dec-2020,ATM,00.00,"323,572.45","2,588,579.57",2aAf378Ec3bEa70,7509,Cory,Acevedo,"Meyers, Walters and Santiago",Elaineland,British Indian Ocean Territory (Chagos Archipelago),(099)740-5194x1244,051.282.9585x122,jermaine72@hoffman.net,2022-03-14,http://hoffman-stanley.com/
08-Dec-2020,Interest,00.00,"862,859.86","1,725,719.71",4effbb015B8BD82,2217,Edwin,Pennington,Roberts PLC,Hardinburgh,Guadeloupe,+1-075-245-2014x4298,2304548172,caseysydney@clark.com,2021-05-09,http://foster-burnett.com/
08-Dec-2020,Tax,00.00,"575,239.90","1,150,479.81",61513B2BedFEccD,1447,Latasha,Riley,Carr Ltd,Porterburgh,British Virgin Islands,546-000-6861x02901,093-450-2714x06322,anna60@barnes.org,2022-01-23,https://www.ryan-merritt.net/
08-Dec-2020,ATM,"44,333.00",00.00,"1,194,812.81",9faEb6110a8Ee4a,7627,Cassidy,Cole,"Stevens, Harrison and Hurst",North Cheryl,Finland,671.590.7446,270-560-2602x3653,andrefrancis@romero.com,2021-06-07,https://www.mcmahon.biz/
08-Dec-2020,Miscellaneous,"185,401.40",00.00,"1,380,214.21",c9Fc82D2C249a05,2960,Carolyn,Fields,Bird Group,Port Tommy,Central African Republic,+1-219-184-8925x2231,001-579-750-7399x692,jimenezshannon@miller-mendoza.com,2022-04-08,http://www.white.com/
08-Dec-2020,Commission,00.00,"690,107.11","690,107.10",6FE085Fa4358e72,8438,Michael,Hodges,Fuentes PLC,Marissaland,Ireland,687-929-6903,284.586.3693x000,avilachris@blanchard-parrish.com,2021-02-12,https://www.mcclain.net/
08-Dec-2020,Cheque,"2,773.92",00.00,"692,881.02",D2d355a67bF2AB8,7995,Scott,Pugh,Craig Inc,Katieville,Myanmar,112-112-4640,+1-513-043-4018x331,jli@boyer.com,2020-06-20,https://www.wiggins.com/
08-Dec-2020,Tax,00.00,"69,288.10","623,592.92",8da8cCd2Ba6aEd8,8641,Rickey,Middleton,"Ellis, Chapman and Bryan",Hammondview,Albania,(631)574-6810x315,001-082-726-0128x9828,thomas51@stone.info,2021-10-30,https://www.mendoza.com/
08-Dec-2020,Reversal,00.00,"103,932.15","519,660.77",7fD6b78E5647793,3708,Sophia,Parker,"Johnston, Moss and Chase",North Valeriemouth,Estonia,423.574.3684x703,001-678-159-8315,annettebailey@sanders.com,2022-04-19,https://contreras.com/
08-Dec-2020,Commission,00.00,"129,915.19","389,745.58",5fD07a2a2c7aFf1,3915,Daisy,Kennedy,Paul-Snyder,Mcneilmouth,Svalbard & Jan Mayen Islands,001-054-825-3040,351-255-0443,robyn25@cortez.com,2022-03-28,https://martin.com/
08-Dec-2020,NEFT,55.10,00.00,"389,800.68",adda0c4d56eEd0F,286,Kari,Morton,Michael-Sparks,West Greg,Malta,608.128.5858x862,887-141-3625x6271,jaredchase@solis.net,2020-06-27,http://www.mccann.biz/
08-Dec-2020,Commission,"1,166,337.50",00.00,"1,556,138.18",9AeCD098c3C0352,4957,Melvin,Owens,"Little, Mcmillan and Kaufman",New Jeremiahtown,Pakistan,(725)497-4098x7544,285.736.6967,ariel49@adams.net,2022-05-07,https://www.bishop.com/
08-Dec-2020,Reversal,"208,625.00",00.00,"1,764,763.18",4A2D6cCff4aCCb6,3065,Eric,Mccarty,Raymond and Sons,Parksland,Korea,+1-127-839-0306x827,392.283.1094,aaron46@sutton.com,2022-05-07,https://www.schwartz.com/
08-Dec-2020,Transfer,"114,091.00",00.00,"1,878,854.18",31F497BFEdea708,2550,Caroline,Marshall,Pruitt Group,Nathanborough,Afghanistan,272-843-8202,9161091588,tuckerjohn@haley.com,2021-10-18,http://www.conley-hawkins.info/
08-Dec-2020,NEFT,30.36,00.00,"1,878,884.54",8B6ED5b3Aca7fCD,2024,Glenn,Petty,Gamble Inc,South Virginiamouth,Senegal,908.253.3077,+1-514-525-4825x578,cwalter@francis.info,2021-05-05,https://www.harrington.com/
08-Dec-2020,Reversal,00.00,"469,721.14","1,409,163.40",0F22271c8046fc3,1311,Gloria,Kidd,Mack Ltd,New Carol,Tonga,2223600964,+1-049-985-5194x4283,rebecca56@taylor-acosta.info,2020-04-23,http://castro.net/
08-Dec-2020,NEFT,00.00,"281,832.68","1,127,330.72",4BF9D44f6bCEb86,7656,Chelsey,Turner,"Proctor, Burch and Ibarra",New Lawrenceton,Morocco,(558)608-0093,152-880-5105x72025,rollinskathryn@holmes.com,2020-03-28,http://www.chapman.com/
08-Dec-2020,Cheque,07.40,00.00,"1,127,338.12",FA2a4070A8815DA,7854,Jeffrey,Yang,Nielsen Inc,West Chadtown,Vietnam,149.093.9278x194,001-447-592-2602,nstark@boyer-dunn.com,2020-09-04,http://dixon-adkins.org/
08-Dec-2020,Miscellaneous,04.00,00.00,"1,127,342.12",Acba2F1393E296C,3364,Kaitlin,Crane,Frye Ltd,Bryanstad,Zimbabwe,+1-756-464-2317x1860,487.625.7110x7924,willissavannah@stevens.com,2021-06-30,http://www.pearson.com/
08-Dec-2020,Miscellaneous,"1,813,784.00",00.00,"2,941,126.12",C7cecB4891C117B,1349,Marilyn,Reynolds,Keller-Dawson,Townsendland,Hungary,(688)439-8804x1225,012.065.5147x3211,muelleradriana@clements-colon.com,2021-08-08,http://leblanc.com/
08-Dec-2020,Debit Card,00.00,"367,640.77","2,573,485.36",AF08FA01A7fdeFf,7788,Raven,Frederick,Leonard-Guzman,New Shane,Uruguay,(371)234-4316x873,074-025-9321,jamiemaynard@velazquez-mcclure.net,2020-04-02,http://strickland-friedman.com/
08-Dec-2020,Transfer,00.00,"428,914.23","2,144,571.13",f6f2E7A65eC393d,8003,Melissa,Avila,"Meadows, Phelps and Santos",Parrishfurt,Montenegro,480-033-7870x035,001-109-560-6319x082,seth34@cline-odonnell.com,2020-11-29,http://www.garrison.com/
08-Dec-2020,Transfer,56.50,00.00,"2,144,627.63",97a4e7D22E1dA2c,9018,Carlos,Marshall,Rocha-Ritter,Curtisport,Macedonia,+1-096-697-9648x71558,+1-346-521-2288x015,bullockariel@butler.com,2022-01-13,https://www.macias-nolan.com/
08-Dec-2020,Tax,"4,524.00",00.00,"2,149,151.63",b6A81E7b5e1c90c,3504,Christie,Logan,Marsh Ltd,Lake Catherinehaven,Congo,935.974.6105x772,638.692.4489,nathan96@ortiz-hendricks.com,2020-11-25,https://www.brewer.com/
08-Dec-2020,Cheque,00.00,"2,149,151.63",00.00,B2EeC18aF7d7D7B,2506,Phyllis,Johnston,Blanchard-Ellison,Mahoneyfurt,Mauritania,(507)702-2108x4365,001-227-749-1620x501,williswendy@lindsey.net,2022-01-20,https://www.york-mann.org/
08-Dec-2020,IMPS,"210,860.00",00.00,"210,860.00",fEC7be95D19Dff1,6116,Anthony,Rosario,"Casey, Chen and Cohen",Sanfordbury,Kuwait,+1-880-918-2856,970.717.1234,conniewu@erickson.org,2021-11-25,http://www.frost.biz/
08-Dec-2020,Debit Card,"22,861.90",00.00,"233,721.90",9BDca2Fca26EDf0,5798,Brandi,Mathews,"Rhodes, Howell and Perkins",North Dianatown,Sierra Leone,533.952.7323,1684097267,kchristian@hamilton.com,2020-11-09,https://herman.com/
08-Dec-2020,Bill,"1,207,470.00",00.00,"1,441,191.90",e8C814720B065b3,5040,Jon,Bradshaw,Mathis-Houston,Alexisstad,Zambia,001-543-454-8025x287,(462)648-9874,zhouse@carter-vaughn.biz,2020-09-16,http://www.kline-buchanan.biz/
08-Dec-2020,ATM,"2,839.66",00.00,"1,444,031.56",BECFDf0ed8C2e16,8547,Bonnie,Cain,"Bowen, Pena and Harper",Sharpburgh,Senegal,503.985.6193x3266,(921)324-3415x57107,cowankatrina@webster-jensen.com,2020-05-24,https://www.bates-meyers.com/
08-Dec-2020,Cheque,00.00,"240,671.93","1,203,359.63",2E0426557Ac4817,695,Latasha,Arnold,Keith Inc,New Jill,Thailand,172.345.7181x51172,805-142-6870x89496,bernardmelinda@huerta.biz,2021-10-17,https://forbes.com/
08-Dec-2020,Bill,00.00,"120,335.96","1,083,023.67",eB2d1F0Ad43BE9C,1312,Alexis,Hudson,Weiss-Bishop,Connieborough,Saudi Arabia,083-799-8295,7019741888,donovanruben@shields-bartlett.biz,2021-07-27,https://www.warren.org/
08-Dec-2020,Commission,00.00,"361,007.89","722,015.78",AbA8dd430553bF1,1669,Derek,French,Fritz Group,Lake Raymondborough,Botswana,+1-562-498-9218x0652,(125)614-1450x972,williamcline@rowe-bishop.com,2021-10-21,http://www.kirby.com/
08-Dec-2020,NEFT,00.00,"240,671.93","481,343.85",c9766eAfa9900F0,3694,Hailey,Fischer,"Bullock, Rowland and May",Ashleyland,Morocco,(385)520-8598,9108721944,kristopher60@choi.com,2021-12-07,http://www.garner-welch.net/
08-Dec-2020,Bill,00.00,"160,447.95","320,895.90",Bc6EB534Fb61B39,1189,Mallory,Decker,Pham-Arnold,Pearsonville,Norfolk Island,+1-152-922-5386x4525,(064)347-1005,ogilmore@long.com,2020-09-23,http://tapia.com/
08-Dec-2020,Tax,00.00,"320,895.90",00.00,a5CDBd03Ded3E8f,9513,Laurie,Church,Manning PLC,Jeanmouth,Congo,6582542616,0378709451,jessesantos@harrison-joseph.org,2020-08-04,https://vang.com/
08-Dec-2020,Debit Card,"879,299.50",00.00,"879,299.50",1c79391B0ADfBF5,6118,Tyrone,Boone,"Lawson, Murillo and Cain",Tapiaburgh,Kyrgyz Republic,+1-482-899-4477x102,+1-856-410-8104x92060,melinda81@goodman.com,2020-11-17,http://brandt-doyle.com/
08-Dec-2020,Bill,00.00,"219,824.88","659,474.62",Acd12b7aD21dFFc,9830,Stacey,Zavala,Mccall Group,Johnathanburgh,Cayman Islands,(052)462-7647,001-074-194-7170,knorton@leach.com,2022-05-21,https://www.lowe.com/
09-Dec-2020,Commission,"1,869,901.00",00.00,"2,529,375.62",F0E4715A5EFFe79,8046,Tony,Sosa,Lane-Raymond,Davidberg,Denmark,001-518-908-4787x57097,(158)055-3997x5594,benjaminariana@farmer.com,2022-03-29,https://www.hooper-charles.com/
09-Dec-2020,IMPS,00.00,"2,529,375.62",00.00,F2Df24e6C6e8f3D,4703,Beth,Sharp,"Zhang, Gardner and Ramos",Lake Ravenland,Kazakhstan,441-782-4311x5993,+1-858-563-4071,gibbsjon@fletcher-mccann.com,2022-04-16,http://randolph-pitts.biz/
09-Dec-2020,Debit Card,04.49,00.00,04.49,7BfDaE9BcB5d240,3693,Denise,David,Fischer-Baird,New Brianfurt,Sweden,741.992.7606x73915,240-426-2860x378,hughescassie@maxwell.com,2020-08-08,https://mendoza-porter.org/
09-Dec-2020,Transfer,"602,022.00",00.00,"602,026.49",Ea7A6ebbdaDAc53,5336,Rick,Lewis,"Good, Cantu and Cunningham",Sergiohaven,Lebanon,(225)258-2241,+1-274-496-3398x7470,wardjade@howell.com,2020-07-22,https://www.scott.com/
09-Dec-2020,Transfer,748.50,00.00,"602,774.99",FeCF8b0bEccaB9F,3455,Jackie,Schaefer,Cooke Ltd,East Bill,Slovenia,738-990-2176,211.765.2040x8507,mason17@rivers.org,2020-01-18,http://www.vasquez.com/
09-Dec-2020,Purchase,"18,048.10",00.00,"620,823.09",f9CA62fCff320F8,7540,Mike,Rubio,Brock Group,Darrenchester,Ukraine,(835)564-3503x832,533.859.6985x3851,jodylopez@arroyo.com,2020-08-18,https://www.zamora.com/
09-Dec-2020,Cheque,00.00,"155,205.77","465,617.32",d3dfc3043Cff7ac,3689,Collin,Hanson,Conley Inc,New Breannaton,Mozambique,589-097-7132x102,970-890-5797x26180,kara58@sullivan.biz,2022-03-23,https://www.evans.com/
09-Dec-2020,Cheque,27.00,00.00,"465,644.32",3d9fCDBeB3b2cBd,3772,Andrew,Stout,Rasmussen Inc,Port Robyntown,Northern Mariana Islands,066-678-6565x7554,028.432.7993,bedwards@lyons-ramsey.org,2021-02-23,https://pratt.com/
09-Dec-2020,Cheque,00.00,00.00,"465,644.32",Fd126e2a424Bbbc,349,Briana,Barnett,"Morgan, Horton and Martinez",Lake Dianachester,Israel,001-762-714-6896,463-501-5962,fryjeff@baxter.com,2020-12-10,https://watkins-webster.com/
09-Dec-2020,Reversal,"3,161.00",00.00,"468,805.32",cC690FA1B62ae1a,3365,Shari,Massey,Greer LLC,Kathleenmouth,Paraguay,(576)737-5923x7310,(063)948-1729x637,ssteele@henderson.org,2021-07-17,http://www.holloway-smith.com/
09-Dec-2020,Reversal,01.73,00.00,"468,807.05",EF853Ef4Bb0D531,3375,Suzanne,Forbes,Hensley Ltd,Port Bradytown,France,078.506.4033x332,484.467.5598,simonsophia@mcdonald-ayers.net,2021-09-28,http://pena-clayton.org/
09-Dec-2020,Commission,"128,769.50",00.00,"597,576.55",D69E92Fb5EB72A1,8126,Nicholas,Parrish,Silva-Valencia,West Jordanville,Qatar,892.819.0830,4954759403,prich@woods-french.com,2021-05-03,http://www.villegas.com/
09-Dec-2020,Debit Card,"1,414,030.00",00.00,"2,011,606.55",61AF4ED6e96fCF9,7369,Alexander,Whitehead,Miller-Wang,Stevensfurt,Jersey,052-679-2374x480,286.714.7919,ryanmosley@brewer.com,2021-09-18,https://www.donovan.com/
10-Dec-2020,Miscellaneous,"813,578.00",00.00,"2,825,184.55",A87C11D0ECe2f45,978,Mathew,Peterson,Mason Group,Garrettberg,Uruguay,974-942-6719,053-795-4514,anitaduran@hendricks-flowers.com,2021-07-15,https://www.webster-abbott.com/
10-Dec-2020,ATM,346.20,00.00,"2,825,530.75",55e6FCbf0ed876d,6653,Shannon,Cortez,Giles-Le,Yustad,Slovakia (Slovak Republic),(293)395-2865x2251,+1-909-743-3165x993,rhays@house.com,2021-04-04,https://www.melton.info/
10-Dec-2020,Commission,00.00,"706,382.69","2,119,148.06",CEaAfc1c3B5BBDE,2439,Neil,Orozco,"Holden, Key and Rocha",Marshallshire,Pitcairn Islands,(421)094-0310,250-645-1284x3667,jane85@wilcox.biz,2020-04-17,http://www.doyle.com/
10-Dec-2020,Transfer,00.00,"423,829.61","1,695,318.45",af52bdca6D4C2a1,7667,Caitlyn,Cordova,"Marsh, Mullen and Garner",Port Jackie,Djibouti,(183)870-5120x262,243-601-1311x06719,gfrederick@bray.net,2021-10-24,http://www.rogers.com/
10-Dec-2020,Cheque,00.00,"188,368.72","1,506,949.73",fe29c07f0fe9521,8138,Adriana,Chapman,Henson PLC,East Melissamouth,Ghana,001-906-602-8333x020,160.546.6326x827,leon80@casey.com,2020-10-28,http://coleman.net/
10-Dec-2020,IMPS,00.00,"251,158.29","1,255,791.44",8C338Ec7aFDD175,5675,Marie,Gallegos,Lucero Ltd,Daltonville,Suriname,001-636-041-5758x198,279.471.7278x445,jeromeestrada@ayers-mcclure.com,2021-09-19,https://pugh.com/
10-Dec-2020,NEFT,"16,555.80",00.00,"1,272,347.24",Cf5b3E6bDe2a93c,4693,Duane,Macdonald,Nolan PLC,Kaufmantown,Cyprus,(985)098-9066x2265,0718533231,yquinn@galloway-kelly.org,2022-05-09,http://www.singh-stark.info/
10-Dec-2020,Tax,60.16,00.00,"1,272,407.40",bB1CB8F5af3dAE4,3512,Whitney,Fleming,"Adkins, Mckinney and Hayden",Dickersonborough,French Guiana,001-624-082-1188,7696015538,iandouglas@acevedo-norman.com,2020-06-15,https://mercer.com/
10-Dec-2020,RTGS,00.00,"1,272,407.40",00.00,8d9fb9A677bCDfe,4354,Alex,Hayes,Douglas-Chandler,Jensenside,Egypt,246.761.7495x53654,8221010296,karl21@mccarty-willis.info,2020-05-31,https://mcgrath-mercado.biz/
10-Dec-2020,Purchase,51.22,00.00,51.22,5EC2d1C5dad0DeA,7139,Diana,Hunter,"Johnson, Cochran and Decker",New Andrestad,Holy See (Vatican City State),674.388.4963x2695,(994)861-5425x1371,mindy36@moss.com,2021-10-04,http://www.hubbard.info/
10-Dec-2020,Cheque,00.00,10.24,40.98,5785BB0441Afc71,716,Dillon,Dominguez,"Mcintyre, Petty and Grant",Lake Gavinborough,Holy See (Vatican City State),+1-095-183-1777x4445,188.101.3539,tsparks@levine.com,2020-02-25,http://acosta.com/
10-Dec-2020,Miscellaneous,"3,679.00",00.00,"3,719.98",bD5E2D0D8889B50,3933,Debbie,May,Ashley LLC,South Feliciaburgh,Maldives,(894)179-4342,001-436-132-2945x501,asalazar@cortez-cowan.com,2020-08-17,http://www.hurst.net/
10-Dec-2020,Cheque,"1,842.00",00.00,"5,561.98",6b6bBD73A8ec126,9173,Caitlyn,Harmon,Harvey-Rodriguez,East Jonport,Puerto Rico,+1-106-886-4454x90386,338.487.8673,barrycolton@zuniga.biz,2022-03-07,http://www.keller.com/
10-Dec-2020,IMPS,"4,841.00",00.00,"10,402.98",6470FEBfa979E28,9404,Gregg,French,"Walls, Woodward and Booth",Domingueztown,Kyrgyz Republic,094-537-0976,834-278-1156,isabel62@patel.biz,2021-03-28,https://www.blanchard.info/
10-Dec-2020,RTGS,00.00,"3,467.66","6,935.32",EcFFB7a3fD13f5B,8846,Hayden,Prince,"Ward, Harper and Baker",Woodsfurt,Netherlands Antilles,(101)061-9484,9543589792,sburch@parrish-pierce.com,2021-02-18,http://www.jarvis.org/
10-Dec-2020,Tax,00.00,"1,733.83","5,201.49",BAf22D8FEFe1Cac,2389,Bryce,Cook,Meadows PLC,West Darius,Chad,+1-028-972-8580x0939,001-844-060-6445,klandry@sellers-fields.biz,2021-08-28,http://rivas.com/
10-Dec-2020,Commission,00.00,"2,600.75","2,600.74",1e36285cf46bC5f,5298,Maureen,Koch,Orozco-Miles,Natashaview,India,+1-983-996-0800x506,001-519-175-5166x55790,betty51@johns.com,2020-01-20,http://gilbert-vaughn.com/
10-Dec-2020,Cash,03.83,00.00,"2,604.57",3782d1AbCF86496,2519,Leonard,Cohen,Castro-Rodgers,West Grant,Tunisia,882.798.7207x43514,(535)121-4703x1879,emcdaniel@chung.org,2020-02-19,https://porter.com/
10-Dec-2020,RTGS,"159,995.25",00.00,"162,599.82",a7dC7cebCfA011e,1755,Joy,Cardenas,"Terrell, Davila and Bailey",Haneyhaven,Montserrat,+1-483-867-5023x43343,+1-913-721-9096x522,stacycooper@norman-love.com,2020-09-19,https://www.mcfarland.biz/
10-Dec-2020,RTGS,00.00,"32,519.96","130,079.86",A8D2b81F97dE3c8,9713,Diane,Erickson,Atkins Group,North Lee,Western Sahara,266-191-9457x900,6212884052,eileen61@callahan.com,2022-03-23,http://www.rose-kramer.org/
10-Dec-2020,NEFT,"27,424.10",00.00,"157,503.96",4a9A0ea1cE7e0ed,6346,Eugene,Hogan,"Cuevas, Mckee and Washington",North Lawrence,Belarus,5805170536,001-697-897-7082,phyllis65@cunningham.com,2020-11-08,http://www.carey.com/
10-Dec-2020,Interest,00.00,"39,375.99","118,127.97",fb568cef5BbEACE,4304,Jonathon,Kerr,Giles-Sanchez,Port Laurenfurt,Bhutan,0162155948,991-421-0953x87174,tcurry@mathis.biz,2020-07-20,http://lowery.info/
10-Dec-2020,Purchase,00.00,"14,766.00","103,361.97",a2BeCE5dFAc3F57,9141,Christopher,Horne,Carey Group,North Mariahport,New Zealand,+1-920-272-6012,(420)002-5532x85060,casebrady@giles.biz,2022-04-13,https://lawson.net/
10-Dec-2020,ATM,00.00,"12,920.25","90,441.72",EDeE6FcBe021AbF,8639,Kelsey,Medina,Odonnell Group,North Lisa,French Southern Territories,+1-410-692-7968x5464,+1-082-579-2667x503,portermackenzie@cline-dawson.net,2021-10-27,https://dodson.com/
10-Dec-2020,Cheque,05.00,00.00,"90,446.72",965f2BAd3BF213c,4362,Sarah,Mccall,Dominguez-Coleman,Sampsonberg,Nicaragua,643-972-5976x6490,(826)838-0085x82411,ericchase@hudson-schmidt.com,2020-07-09,https://www.fischer.net/
10-Dec-2020,IMPS,"1,452,721.50",00.00,"1,543,168.22",FBEBf1D6e9Bee98,4860,Antonio,Kirk,Gutierrez-Ferguson,West Erikfort,Panama,+1-708-514-8672x95048,001-891-340-1393x176,carmenstrong@landry.org,2021-02-26,http://www.rasmussen-love.com/
10-Dec-2020,Commission,00.00,"771,584.11","771,584.11",1cbFE9b26CB9dDE,7819,Leon,Hayes,Howe-Reilly,Doylehaven,Thailand,001-610-157-8212,424-355-3490x20151,townsendcole@olsen-daniels.com,2021-10-06,https://stafford-cisneros.com/
10-Dec-2020,Cash,00.00,"128,597.35","642,986.76",485cb41C4af792C,5892,Kylie,Martinez,Bautista Ltd,New Elijahport,Guinea-Bissau,800.903.0807,186-214-0822x915,wmiddleton@winters.com,2021-08-11,https://www.richards.com/
10-Dec-2020,IMPS,"19,835.20",00.00,"662,821.96",f1237Faf1CfaCfB,2052,Diamond,Mora,"Davila, Hawkins and Lynn",Sullivanville,Bhutan,082-771-9625x203,(757)511-9749x9834,ginalucas@romero.com,2022-04-24,https://hancock.biz/
10-Dec-2020,Tax,00.00,"73,646.88","589,175.08",Ab5A877dB5866bE,1326,Maria,Mullen,Heath-Merritt,Dustinfurt,Netherlands Antilles,001-000-547-8099x273,(389)800-5956x13252,ufrench@tate.net,2020-03-02,https://www.powell-jackson.com/
10-Dec-2020,Reversal,"2,145.30",00.00,"591,320.38",AB0Fd522ec876d2,7736,Tom,Dunlap,Shields LLC,Port Sue,Samoa,7208666214,001-031-488-4589x754,terrancewilliamson@arroyo.info,2021-09-25,https://www.lee.info/
10-Dec-2020,Reversal,00.00,"65,702.26","525,618.12",8aedA4145da6782,2840,Suzanne,Simmons,"Ayers, Austin and Castaneda",Barbaramouth,Haiti,368-461-6723,(092)929-3855x9656,isharp@hull.info,2020-02-21,http://www.pugh.com/
10-Dec-2020,Cash,"3,573.57",00.00,"529,191.69",a4D9e5Bbf7A9D9a,7840,Danny,Murillo,"Potter, Beck and Galloway",Aliciaport,Greece,645.615.0878x3449,645-479-8910x3215,yeseniawhitney@villanueva.org,2021-10-31,https://www.craig.com/
10-Dec-2020,Debit Card,00.00,"75,598.81","453,592.88",8ccEbAFDE85Ecd8,8865,Kristi,Gilbert,"Craig, Howard and Potts",Alexastad,Venezuela,(092)982-3942,426.754.5783,tammie24@chapman.com,2020-09-26,http://bailey.org/
10-Dec-2020,Debit Card,00.00,"75,598.81","377,994.07",AAaF6aaeed4D4CF,9285,Chelsey,Mooney,Norton-Kelley,Lorettafurt,United States Minor Outlying Islands,+1-317-733-5760x6858,(136)466-0566,glendawong@key-sherman.com,2021-08-18,http://crane-roberson.info/
10-Dec-2020,Transfer,00.00,"75,598.81","302,395.26",e7D570aE4Fc1ab7,8043,Cheyenne,Daniels,Cobb LLC,Wadebury,Korea,001-055-528-2814x366,051.986.8855,cunninghamgabrielle@scott-norman.biz,2022-05-20,http://www.kirk.com/
10-Dec-2020,Debit Card,37.00,00.00,"302,432.26",451792aCBF625ED,5092,Mariah,Osborn,Drake PLC,Powellside,Isle of Man,9404368037,+1-643-776-3179x6508,barrettkrista@waters.com,2021-10-03,https://pope.com/
10-Dec-2020,Purchase,"989,122.50",00.00,"1,291,554.76",f20a7dcbD2AF1F6,5305,Norman,Ortega,"Lindsey, Simmons and Ponce",Kerrburgh,Saint Martin,+1-764-805-7030,+1-379-526-5536x48893,bglover@mcdonald.org,2020-06-07,https://www.wise-lamb.biz/
10-Dec-2020,NEFT,09.25,00.00,"1,291,564.01",15CC35C2A5Ca7be,4076,Claudia,Bartlett,Leach-Jarvis,Port Stefanie,Cyprus,(430)400-6725x98865,(158)771-4135x0567,fsaunders@arellano.net,2020-10-02,https://www.hahn.com/
10-Dec-2020,Cash,00.00,"143,507.11","1,148,056.90",9d25749a97f74A8,303,Lauren,Allison,Finley Ltd,South Adrian,Mauritius,001-174-870-2513,5880973986,kristinwhitaker@bullock-wilkerson.com,2021-04-03,http://www.skinner-randolph.com/
10-Dec-2020,RTGS,09.50,00.00,"1,148,066.40",cE95fb2B1814EE0,5731,Alexandra,Boyd,Pitts-Pugh,Lanefort,Yemen,+1-321-078-4248,078.273.3618,rogerbullock@galloway.info,2021-01-09,http://mcmillan.org/
10-Dec-2020,Commission,00.00,"127,562.93","1,020,503.47",57Be6E2a32AccCB,5079,Tracy,Wilson,Hicks-Braun,West Spencerstad,Jamaica,779-478-0068,001-906-308-4112x3241,fjacobs@rivers.com,2021-01-19,https://www.finley.com/
10-Dec-2020,Reversal,00.00,"170,083.91","850,419.56",fFedD6BE1dB30ba,883,Kelli,Brock,Harrell-Salas,Lake Eric,Armenia,(702)481-0346,(298)179-3743x267,qwiggins@pope.com,2021-07-12,https://www.cruz.com/
10-Dec-2020,RTGS,00.00,"283,473.19","566,946.37",0c4597b8DC6A7CD,3280,Cory,Carr,Morris PLC,Paceside,Montenegro,7912045790,+1-686-883-2057x06271,sally15@hood-delgado.biz,2021-10-11,http://www.delgado.com/
11-Dec-2020,Commission,00.00,"62,994.04","503,952.33",98F44DaEDc6C9eD,4090,Jackie,Whitney,"Anderson, Hebert and Schaefer",Parksfurt,Poland,+1-719-109-8256x99650,+1-669-773-7708x170,morganmaldonado@paul.com,2021-01-17,https://allison.com/
11-Dec-2020,Cheque,00.00,"167,984.11","335,968.22",AD6b55Da5FB9Fd2,7779,Destiny,Welch,Vance PLC,Devonmouth,Lithuania,838-908-3531x533,001-064-356-2295x622,alejandrahurley@novak.com,2021-06-10,https://james.com/
11-Dec-2020,Tax,33.00,00.00,"336,001.22",9c2EECf9FBfBfd2,3018,Alan,Vasquez,Kennedy-Rice,Carrieville,Singapore,877-745-4981,001-387-985-6085x0761,ncastaneda@abbott-beasley.com,2020-01-10,https://rodgers-bender.net/
11-Dec-2020,Interest,02.09,00.00,"336,003.31",5bbB2caA615b33c,2250,Earl,Oconnor,Krueger and Sons,Port Donald,Iraq,001-048-723-5763x010,(676)301-3438x84807,arielschroeder@heath.com,2021-11-29,https://pennington-miller.com/
11-Dec-2020,Reversal,107.67,00.00,"336,110.98",e3C097Db36A10f0,1977,Selena,Mcmahon,Brewer-Becker,North Timothychester,Kazakhstan,880.788.3761x3456,+1-160-824-8836x4383,diamondphelps@lambert-bowman.com,2022-02-23,http://www.foley.biz/
11-Dec-2020,Tax,"206,195.50",00.00,"542,306.48",42CfACE21f9eb63,385,Damon,Daugherty,Galvan-Lloyd,Gabriellaborough,Macao,3153985378,2970579866,wbarton@orozco-banks.com,2021-08-27,https://harris-haynes.org/
11-Dec-2020,Cash,"25,426.30",00.00,"567,732.78",5fBDE5cDc5F4B96,3499,Angel,Kim,Fox-Conrad,Thomasshire,Oman,635.882.8193x809,001-406-615-9671x81681,tomhall@kline.com,2021-08-25,http://www.grant.com/
11-Dec-2020,Cash,365.00,00.00,"568,097.78",E1CFDa0B6f985d2,4844,Jeffery,Barker,Clements Ltd,Darylland,New Caledonia,172.538.0452x5438,(996)005-2380,adriannixon@pena.com,2022-01-15,http://arellano.net/
11-Dec-2020,Interest,353.13,00.00,"568,450.91",2e2ABfD8b82E5FC,8845,Traci,Hester,Norris-Bowers,South Gregory,Iran,752-942-8899x05926,178.170.9943x76610,mccallbeth@gentry.com,2020-05-03,http://robles-mosley.com/
11-Dec-2020,ATM,05.00,00.00,"568,455.91",de6128c5B23ca48,8013,Melvin,Payne,"Bridges, Holt and Mcdonald",Murphyview,Morocco,+1-116-179-2969x05408,001-648-331-0560x60402,martha05@larsen.com,2022-04-24,https://www.briggs-boone.info/
11-Dec-2020,ATM,06.02,00.00,"568,461.93",f0dA0bBc7b95923,9417,Heidi,Delgado,Blackburn-Macias,Port Brian,Saint Kitts and Nevis,001-068-238-9289,719.884.1318x864,eddiewilkins@ayers.net,2021-11-30,https://www.dorsey-ferrell.com/
11-Dec-2020,Cheque,"183,385.00",00.00,"751,846.93",FebD11a0a4f3BE1,340,Anita,Daniel,"Chapman, Rojas and Morgan",Richardfort,Angola,(258)690-1199x499,+1-033-650-2789,valentinecaitlyn@henry.com,2020-06-30,https://www.mcpherson.com/
11-Dec-2020,Tax,00.00,"751,846.93",00.00,BC867B2F1f6DFdA,990,Leonard,Bond,"Holder, Swanson and Mcdowell",South Jillian,Albania,001-421-988-2871x350,487.967.6230x9009,eroach@sloan.com,2021-04-09,http://www.browning.net/
11-Dec-2020,NEFT,02.00,00.00,02.00,8AFDf96d19dCd5d,6066,Mary,May,"Chaney, Mcfarland and Castillo",South Vanessa,Afghanistan,519-574-9729,721.359.0463x7028,shelly06@chavez-humphrey.info,2020-03-15,http://mann.com/
11-Dec-2020,Interest,00.00,00.20,01.80,b816EECEB9AEFF6,2173,Mariah,Hardy,Santiago-Baker,South Jasmineshire,American Samoa,343-761-4011,035-238-0649x4750,kayleerodgers@leblanc.org,2021-11-15,https://glenn.com/
11-Dec-2020,Commission,"1,267.60",00.00,"1,269.40",3A9eFaCe6efbaEd,1194,Cesar,Mcfarland,"Watkins, Ramirez and English",Reeseville,Eritrea,555.452.0608x620,152.543.4419,darrenespinoza@conner.info,2020-02-16,http://tucker-hull.com/
11-Dec-2020,Purchase,46.40,00.00,"1,315.80",72c2A14eC9d33a7,5367,Madeline,Shah,Cobb-Glover,Port Noahberg,Micronesia,807-926-0168x5420,357-847-1606x1374,stuarttyrone@knight.com,2021-05-06,http://cross-ortiz.com/
11-Dec-2020,Transfer,00.00,657.90,657.90,45fAcb9b399d894,663,Andres,Nash,Baldwin PLC,Leviborough,Norway,1787227957,0920114892,jon73@glenn.info,2020-08-25,http://www.morrow.info/
11-Dec-2020,IMPS,"69,287.50",00.00,"69,945.40",b3abd933bBBCb6B,2784,Maxwell,Keller,"Mclean, Bentley and David",New Spencer,Taiwan,001-868-593-8454,+1-915-043-4835x027,merrittlee@park.org,2022-05-20,https://www.santana.info/
11-Dec-2020,Transfer,00.00,"69,945.40",00.00,CadF3E4Af2ea92e,2168,Joy,Lynn,"Brennan, Fox and Horn",Lake Lynn,Burundi,800-401-8785x595,700-573-1916,scarney@maynard.com,2021-06-01,https://barrett-lozano.org/
11-Dec-2020,Debit Card,"24,144.90",00.00,"24,144.90",9Ce4818Bffd8FBA,5794,Eileen,Acevedo,Skinner-Mercado,Marilynburgh,French Guiana,+1-194-102-4160,+1-977-770-8479x42503,lmedina@bird.info,2021-12-14,https://farrell.org/
11-Dec-2020,RTGS,00.00,"3,449.27","20,695.63",5a5eed7ccFd7A0F,2971,Jasmine,Kim,Logan-Hayes,Bradfurt,Saint Pierre and Miquelon,817.159.6830x1206,517.367.3585x840,shirleyfitzgerald@levine-stanley.net,2020-11-10,https://moon.com/
11-Dec-2020,Reversal,61.00,00.00,"20,756.63",E99CF5c371F19d8,8884,Adam,Duran,Randall-Wells,Port Leslie,Mali,001-668-199-9173x60209,175.636.5824x287,hblake@mcgrath-gregory.com,2021-11-01,http://scott-greene.com/
11-Dec-2020,Tax,00.00,"3,459.44","17,297.19",f173fC284c3bB3f,2990,Christine,Anderson,Bright-Flores,West Kerri,Somalia,198-667-9682,584.494.9112x2408,fmoyer@warner.com,2021-08-16,https://www.zuniga.com/
11-Dec-2020,Cheque,"24,985.00",00.00,"42,282.19",6abaeFbdb212Ad1,1851,Gilbert,Hansen,Conner LLC,Lake Anabury,Mayotte,479.411.1690x2355,(004)893-7423x918,gordonisaac@gardner.com,2022-03-25,http://www.mcpherson.com/
11-Dec-2020,Transfer,"22,312.41",00.00,"64,594.60",2bD048ACaDca22c,5917,Tamara,Dean,Mccarty Ltd,Ramseybury,Russian Federation,023-642-4171x14971,122-875-7981x8960,alexandra32@austin.biz,2020-03-13,https://weber-kennedy.info/
11-Dec-2020,Commission,43.47,00.00,"64,638.07",FE5c66EBEb3bBF4,2220,Jocelyn,Cobb,"Jenkins, Lozano and Houston",South Anthony,Mozambique,028-735-7323,721.933.4036,alec26@proctor.com,2021-04-15,http://www.sanders-valencia.info/
11-Dec-2020,Debit Card,"2,435.10",00.00,"67,073.17",adbCFFfBF1eABF0,1988,Wesley,Keith,"Vang, Shaffer and Gilmore",Suemouth,Ghana,+1-687-922-6577,(676)161-8782,kdominguez@moore.info,2021-02-14,https://case.info/
11-Dec-2020,Reversal,"222,871.97",00.00,"289,945.14",C428Fc5eA9E871E,490,Hailey,Werner,"Guzman, Bauer and Keller",Bakerberg,Ghana,637-548-4284,(620)510-9042x817,edwardsmelissa@blackwell-riddle.com,2022-04-22,http://dillon-duarte.org/
11-Dec-2020,Debit Card,"161,366.70",00.00,"451,311.84",f2eE78D1A6DEe5e,1021,Rachael,Benitez,Hester Ltd,Lawsontown,Mauritania,(694)376-3296x032,+1-774-787-5087x50986,mwalls@salinas-robinson.com,2022-04-29,https://horton-rubio.com/
11-Dec-2020,ATM,00.00,"150,437.28","300,874.56",d20d428FA81a2Eb,447,Sydney,Burnett,"David, Reynolds and Deleon",West Steveborough,Rwanda,001-848-600-5959x841,524.429.0041x0400,makaylafrost@pham.com,2022-01-31,http://www.banks.org/
11-Dec-2020,IMPS,725.00,00.00,"301,599.56",02E3e35DAc3354B,6750,Antonio,Clarke,Bartlett-Howell,Sethhaven,Bouvet Island (Bouvetoya),(054)909-5403x54225,001-594-113-0858x8267,jeffcarter@molina.biz,2020-04-05,http://avery-kramer.com/
11-Dec-2020,Purchase,00.00,"33,511.06","268,088.50",5DC66d7c82fB027,89,Kevin,Chase,"Morris, Hurst and Mccarty",Bradstad,Heard Island and McDonald Islands,863-881-8404x487,+1-348-270-4520x9230,gravesgrace@molina.org,2020-06-23,http://wise-mendez.com/
11-Dec-2020,Commission,"731,888.50",00.00,"999,977.00",578B08Ff2feeE0e,5281,Brent,Sandoval,"Lowery, Bray and Adkins",Nicoleshire,Cape Verde,423.451.4105,563.848.0492x898,mcdonaldherbert@griffith-castillo.biz,2022-02-13,http://www.murray.com/
11-Dec-2020,Purchase,07.08,00.00,"999,984.08",e95c2e094B65Ad7,7470,Debbie,Ashley,"Summers, Serrano and Best",Dixonhaven,Myanmar,(159)127-5290,001-250-519-7716x89828,bianca48@davenport.com,2021-01-18,https://baxter-black.info/
11-Dec-2020,Purchase,00.00,"142,854.87","857,129.21",ff920ACDD2aA2BA,8339,Ivan,Moss,"Rios, Nguyen and Gibbs",Priscillamouth,Senegal,229-270-7895x53627,(341)435-8316x376,irhodes@mendoza-hatfield.com,2020-03-26,http://www.berger.net/
11-Dec-2020,RTGS,"12,024.70",00.00,"869,153.91",b233b3dF0bC98Dd,9286,Diane,Montgomery,"Heath, Duarte and Estrada",Ronniebury,Nauru,001-945-446-8566,(875)179-6581x740,frank64@santiago.com,2020-11-15,https://www.norman.net/
11-Dec-2020,Interest,111.00,00.00,"869,264.91",8BE4b27cc3C1a5b,6332,Jeremiah,Roth,Duke-Holder,Cartermouth,Moldova,428-195-4452x9681,281-287-0409,rickey03@alexander-tate.com,2021-12-20,http://rios.org/
11-Dec-2020,Debit Card,09.80,00.00,"869,274.71",CAcaAD99EF3c2D4,488,Tricia,Waller,Bradford-Bush,Rhondaborough,Uruguay,001-401-481-6270x0994,828.889.7561x52807,gilesjamie@hall.com,2020-09-01,http://www.vazquez.com/
11-Dec-2020,RTGS,00.00,"289,758.24","579,516.47",379c7bB7CDb3AC2,4437,Dustin,Velasquez,Pace-Melendez,South Elaineside,Taiwan,+1-371-857-0128,129-007-2393,smalone@greer.net,2020-06-23,http://navarro.com/
11-Dec-2020,IMPS,00.00,"144,879.12","434,637.35",DEeB660E2e47C36,2603,Charlotte,Trevino,Guerrero-Parrish,East Margaretville,American Samoa,+1-291-842-8280x99257,(040)725-6579,kraymond@ashley-mckee.com,2020-01-09,https://barton.com/
11-Dec-2020,IMPS,00.00,"86,927.47","347,709.88",5EbFF009b32311a,6362,Jake,Rhodes,"Daniel, George and Vargas",North Francis,Zambia,071-595-7224x328,(506)360-0270x1306,kgeorge@guerra.org,2020-08-22,https://www.cherry-yang.com/
11-Dec-2020,Interest,550.00,00.00,"348,259.88",E5Bc9CFdD7E8cCe,285,Sheena,Donaldson,"Villanueva, Li and Hurley",South Robynton,Brazil,+1-711-991-7360,+1-562-005-5140x18832,candace29@diaz.com,2021-04-12,http://www.scott-lutz.com/
11-Dec-2020,Cash,00.00,"38,695.54","309,564.34",Fdb37BfBBA1Fbd3,6956,Morgan,Cameron,Hardin Inc,Tracymouth,Guadeloupe,+1-700-989-5957x601,(637)303-8168x5555,jared62@pollard-grant.org,2021-09-21,http://www.simmons.biz/
11-Dec-2020,Cheque,17.00,00.00,"309,581.34",4d79D8B2a5f0B2B,3176,Bobby,Ortiz,Erickson PLC,Nixonberg,Fiji,276-550-5404,(038)167-4613,spenceellen@leon.net,2020-03-09,http://wise.com/
11-Dec-2020,Interest,00.00,"34,397.93","275,183.41",4ea4a84Cba53A63,8997,Desiree,Green,Molina Ltd,West Cathy,South Africa,(978)607-7249,8222738858,dylanfrazier@stevenson-watson.com,2022-01-10,https://mcdaniel-anthony.net/
11-Dec-2020,Tax,00.00,"45,863.90","229,319.51",080a1101E4D8908,6403,Michele,Richard,Nixon Ltd,Gordonfurt,Palau,347-801-4787x441,047-917-8490,jaimeortiz@curtis.info,2022-01-14,https://www.ayers.com/
11-Dec-2020,Miscellaneous,00.00,"114,659.76","114,659.76",6Cf9f9eBDBE0FE8,3563,Shannon,Knapp,"Hardy, Shepherd and Pierce",West Mckenzie,Slovakia (Slovak Republic),001-135-096-7619x4409,+1-254-056-8112x796,cbryant@rollins-anderson.net,2022-05-11,https://cardenas-horton.com/
11-Dec-2020,Cheque,56.37,00.00,"114,716.13",7baBEE7a9B959cA,4962,Corey,Rush,Carr LLC,Lake Terry,Mongolia,+1-991-035-1347x22446,(569)458-0860x905,brian28@trevino.com,2021-09-29,http://nielsen.net/
11-Dec-2020,Interest,378.00,00.00,"115,094.13",1FeFCc451dbbe0A,9743,Dakota,Patel,"Velazquez, Mccarty and Rowland",Pollardborough,Saint Vincent and the Grenadines,(158)651-1214x0595,8159860909,darrylmarks@hall.biz,2022-01-25,http://willis.biz/
11-Dec-2020,Commission,03.70,00.00,"115,097.83",5cFFde2c204F3dc,5627,Eileen,Meza,Mullen LLC,Zunigamouth,Grenada,878-972-3110x9952,001-891-826-5756x5881,blackaudrey@nash.org,2021-06-29,https://www.callahan.biz/
11-Dec-2020,ATM,"527,382.00",00.00,"642,479.83",d0ad5B7caCeb19b,3273,Tanner,Marshall,Fox Group,Phyllistown,Bahrain,+1-200-038-8570,198.688.9672,bonillagloria@gillespie.com,2020-08-09,https://www.pham.org/
11-Dec-2020,Reversal,06.00,00.00,"642,485.83",dA3669d0BaD459C,9377,Jade,Beasley,Stafford-Rosario,Bruceburgh,Venezuela,026-852-0074x943,+1-145-399-8308x6996,jprice@dunlap.biz,2021-03-06,https://arias-barry.org/
11-Dec-2020,Miscellaneous,00.00,"214,161.94","428,323.89",73787C533d8e3Ae,8733,Donald,Dougherty,"Mooney, Bullock and Potter",West Audreytown,Burundi,179-093-9425x56150,001-699-929-8100x7845,glenandrews@brandt.com,2020-02-07,https://villegas.org/
11-Dec-2020,Commission,00.00,"85,664.78","342,659.11",7BB5a237b72a048,3517,Chloe,Nielsen,Esparza-Pena,Vaughanbury,Mauritius,594-683-0828x21114,001-652-794-5116x6369,rickey48@burns.com,2022-03-10,http://hall.biz/
11-Dec-2020,Commission,"656,577.00",00.00,"999,236.11",B3fe1A7d6C6eb76,1607,Tabitha,Reyes,Sanchez LLC,Port Dwaynetown,Benin,001-074-842-1727x212,+1-377-839-2640x37415,kennethnolan@callahan-waller.com,2021-09-07,http://www.acosta.com/
11-Dec-2020,Bill,87.00,00.00,"999,323.11",4C9cb3097B2C1eD,3307,Rodney,Bishop,Mosley-Velez,East Alexandraville,Pakistan,001-468-012-9080,001-135-858-2653,mcfarlandbrady@crosby.com,2020-03-03,http://french.net/
11-Dec-2020,RTGS,"1,926,258.00",00.00,"2,925,581.11",f1AA1fdEb6eF9c4,8797,Vicki,Lloyd,Lynn-Marquez,Jordanbury,Aruba,791-822-6156,(511)594-7691,cristinaglenn@nash.org,2020-10-04,https://www.robertson.com/
11-Dec-2020,Purchase,440.00,00.00,"2,926,021.11",7D1BA693cCdB72C,939,Cassidy,Mueller,"Wright, Cooper and Branch",East Daniel,Congo,1036359279,873.072.1906x12239,alisonburch@kim-small.com,2020-04-22,http://www.lamb-bradshaw.com/
11-Dec-2020,Tax,"1,907,468.00",00.00,"4,833,489.11",b1773104b5F3Cd7,4406,Tony,Thompson,"Johns, Willis and Fischer",New Cheryl,Portugal,417.497.6699,197-295-2931x1876,wayne87@owens.com,2022-05-02,http://higgins.com/
11-Dec-2020,Cash,00.00,"537,054.35","4,296,434.76",03E38E0CC224EeF,6114,Allen,Castaneda,Clarke and Sons,North Josephchester,Puerto Rico,001-380-562-1235x79891,(902)871-2810,shari32@bryant-noble.com,2020-12-06,http://ryan-rich.com/
11-Dec-2020,Cash,00.00,"537,054.35","3,759,380.42",5456AECDdef8Bce,8002,Alvin,Weber,Becker Inc,New Dominic,Benin,(808)664-8690,620-264-9489x0475,ramosclifford@cummings-powers.com,2020-01-03,https://www.meza-medina.biz/
11-Dec-2020,Reversal,00.00,"3,759,380.42",00.00,A1abcB1233cdf32,4800,Gina,Brennan,Beard-Rowe,South Ryantown,Latvia,+1-291-999-4046x4683,+1-918-081-0949,emily89@sheppard.com,2021-09-01,http://noble.com/
11-Dec-2020,Cash,"1,194,743.00",00.00,"1,194,743.00",1dC6dEe91CA7bD4,8746,Loretta,Vaughn,Douglas-Barr,Kathrynhaven,Tonga,467.711.8987x6833,001-556-418-3305,hansencassie@meyer.net,2020-07-18,http://www.baird.biz/
11-Dec-2020,Cheque,"695,307.00",00.00,"1,890,050.00",cBaF2ebb2eFDA34,4470,Oscar,Huffman,Mays-Arellano,Brucefurt,Cuba,290-179-4737,(933)476-3246x0386,phelpsblake@sutton.biz,2021-12-28,https://www.mcbride.com/
11-Dec-2020,ATM,"4,861.00",00.00,"1,894,911.00",6372fDD324B57Bf,2579,Connor,Maldonado,Phillips Group,West Jillian,Comoros,+1-849-830-0298x62093,116.454.5110x609,stanley94@duffy-burke.com,2021-08-04,http://www.baker.org/
12-Dec-2020,Commission,"195,616.25",00.00,"2,090,527.25",83d9accaD6AFBF9,55,Jeremy,Guerra,Gamble Group,South Jeremiahberg,Nauru,001-343-604-8248x84492,142.473.8437x8627,lfaulkner@villanueva.com,2022-05-12,https://giles-newton.com/
12-Dec-2020,Commission,00.00,"696,842.42","1,393,684.83",7DdA048afAc78bE,2298,Lacey,Dunlap,Glover-Petty,West Elizabethburgh,Venezuela,378-739-2381,(620)405-4072x4893,simpsontanner@murray.biz,2021-02-27,http://hunter-sutton.com/
12-Dec-2020,RTGS,00.00,"348,421.21","1,045,263.62",1AE3dC9BDDc37Aa,3859,Carrie,Dillon,"Bowman, Small and Morton",Josephport,Wallis and Futuna,001-269-966-5280x725,(306)048-6199x68668,faulknershawna@simmons-pruitt.info,2021-12-04,https://www.jacobs-myers.org/
12-Dec-2020,IMPS,00.00,"1,045,263.62",00.00,AE7d02ec579ace4,6572,Tara,Mueller,Byrd-Irwin,South Cassandrafort,Moldova,+1-964-192-9926x78222,(804)283-4680x89321,hurstsean@wade-preston.com,2020-02-28,http://www.murphy-sweeney.com/
12-Dec-2020,Cash,61.00,00.00,61.00,48aF63FadeDdAa9,1690,Elaine,Davis,Robinson-Schneider,Lake Kristina,Belize,(642)083-1297x9038,001-805-820-6288x787,goldenbridget@rivers-harris.info,2020-08-16,http://www.castillo-lynch.com/
12-Dec-2020,Cash,"2,017,197.00",00.00,"2,017,258.00",E23d31e388cdeF4,8890,Janice,Zhang,Mccullough Ltd,Port Taylormouth,Mauritania,6639319032,+1-053-065-6084x0337,belindawiggins@santiago.net,2020-03-25,https://www.valdez.com/
13-Dec-2020,Miscellaneous,"22,649.30",00.00,"2,039,907.30",a8D993bf0eBb1b6,4149,April,Ali,Ferguson-Wise,Anthonyberg,Oman,(053)375-8083x62192,+1-246-926-3721x4480,ggallagher@lowery.com,2021-03-04,https://ford.com/
13-Dec-2020,Commission,06.00,00.00,"2,039,913.30",0e36f9a5AcB10EE,7165,Cole,Munoz,Norris LLC,Michaelaland,Egypt,216.125.1071,878.785.7708x719,pconner@combs.com,2021-10-30,https://www.lyons-mayo.com/
13-Dec-2020,Reversal,19.00,00.00,"2,039,932.30",E44e636cfE26CfB,314,Maria,Conrad,"Blackwell, Torres and Solomon",Port Ricardomouth,Norway,(899)628-5978,7821216654,gabriel57@spence-thompson.com,2021-11-15,https://www.horn.biz/
13-Dec-2020,Reversal,00.10,00.00,"2,039,932.40",DdCd40b5aEc3DD0,2736,Tara,Bowers,Moss Inc,South Glendaborough,Jamaica,(987)193-1940,001-249-967-5911x072,haroldmoody@olson-massey.com,2020-04-01,http://www.cline.biz/
13-Dec-2020,Transfer,950.20,00.00,"2,040,882.60",AADB6e12E29F6FA,6502,Mark,Watkins,Moses Group,Brittanyton,Cocos (Keeling) Islands,408.654.9599x351,001-631-105-9299x931,annettedonaldson@rojas.com,2020-03-03,https://mann.com/
13-Dec-2020,Cash,"263,354.00",00.00,"2,304,236.60",d1dbAE8d0e9FbA0,6308,Jody,Hodges,Vance-Hart,Harryville,Gambia,8048211608,(566)628-8053x97612,lutzbrandi@mcpherson.com,2020-10-29,https://lindsey.net/
13-Dec-2020,IMPS,"1,766,121.00",00.00,"4,070,357.60",b1477A9cfbc031A,8424,Franklin,Dennis,Gilbert PLC,Atkinsonfurt,Sierra Leone,6347369510,5745852340,debbiebaldwin@james.com,2020-05-08,http://armstrong.com/
13-Dec-2020,Bill,"205,148.00",00.00,"4,275,505.60",68b561BEf8D6EF3,9146,Tammy,Kerr,Scott Inc,East Dawnport,Colombia,(990)286-4483x3753,930-610-4706,qstuart@carr.com,2022-02-20,https://lowery.net/
13-Dec-2020,Interest,00.00,"475,056.18","3,800,449.42",d6e8c838F9ba64b,7553,Alfred,Ferguson,"Shepherd, Franklin and Buchanan",South Jakestad,Ukraine,(478)808-7409,818-024-0687,garciavirginia@ramsey.com,2020-06-30,https://walter.com/
13-Dec-2020,Purchase,"1,744.00",00.00,"3,802,193.42",d7FA5CCbCfD3565,3831,Geoffrey,Robles,Green Group,West Lauren,Netherlands Antilles,+1-865-144-6877x763,(656)834-1155x67358,sharonduncan@callahan.com,2020-10-09,http://sheppard-hunter.biz/
13-Dec-2020,Debit Card,00.00,"422,465.94","3,379,727.48",e30D09bcC5EaDEC,1957,Stacie,Reyes,Bradshaw PLC,Warnerton,Guinea-Bissau,+1-805-112-3373,651-826-9516,karl57@martin.com,2021-03-14,https://sampson.com/
13-Dec-2020,NEFT,00.00,"3,379,727.48",00.00,035B4df0C4AaB2c,1565,Sergio,Juarez,"Parrish, Mack and Beck",South Monica,Tunisia,001-820-334-3451x79860,311-339-7817x5869,shawna20@andrade.biz,2020-03-29,http://www.washington.biz/
13-Dec-2020,IMPS,"2,479.20",00.00,"2,479.20",5F1ccD0682bFFfB,3619,Amanda,Hawkins,Golden-Gates,East Kimberly,Andorra,882.976.9157x210,(571)663-5509,eugene62@rodgers.com,2021-10-28,https://www.cross-graham.com/
13-Dec-2020,IMPS,"69,881.94",00.00,"72,361.14",101283D2Cae7F8a,7438,Victoria,Webb,Carey-Bradley,East Bradley,Liechtenstein,2116856255,9335396984,mckenzie00@giles.biz,2020-05-04,http://hartman.biz/
13-Dec-2020,Bill,48.00,00.00,"72,409.14",65aED9Ddab41022,6273,Colton,Weiss,Hale Inc,Port Kimmouth,Uganda,001-526-220-1490x6353,322.146.3702,ncurtis@mccarthy-frye.net,2020-11-06,http://www.vaughan.biz/
13-Dec-2020,Debit Card,"150,675.00",00.00,"223,084.14",7E28aDB65b9D6Db,331,Anthony,Clarke,Bonilla Group,Reeseshire,Martinique,+1-043-839-9795x17910,390-366-6570x169,warelydia@coleman-morrow.com,2020-08-04,https://www.underwood.com/
13-Dec-2020,RTGS,00.00,"37,180.69","185,903.45",dAfC3DdDf2CdFa3,4727,Gabriel,Pierce,Beard Inc,South Ralph,Israel,(053)912-0408x297,(889)147-2000,zachary49@burnett-dominguez.com,2021-04-14,http://frost.com/
13-Dec-2020,Interest,00.00,"18,590.35","167,313.11",Ece19AE11E56746,991,Catherine,Estrada,Mccarty-Villegas,Mcfarlandview,Senegal,(700)179-3577,(099)761-6745,grayisaiah@hobbs.com,2022-05-06,https://moyer-tyler.com/
13-Dec-2020,IMPS,00.00,"33,462.62","133,850.49",a80Ac3f1F3fdF2c,4472,Tabitha,Kidd,"Barber, Castaneda and Nguyen",Jesseburgh,Israel,686.653.5144x0310,165-875-1422,lindsay21@reed-mendoza.com,2020-06-19,https://lindsey.com/
13-Dec-2020,Commission,35.00,00.00,"133,885.49",5Dcfa64CE65C8aD,115,Ralph,Merritt,Rosales-Hayden,Sarafurt,Saint Martin,(652)849-4605,424.685.1314x331,moneal@hudson.biz,2021-04-10,http://carpenter-estes.net/
13-Dec-2020,Miscellaneous,00.00,"13,388.55","120,496.94",59e3AfDeEd7aad0,2176,Meredith,Cantrell,Ramos-Sullivan,Coltonfurt,Saint Pierre and Miquelon,863-560-4047x25104,+1-216-860-7201,nina16@rodriguez-ruiz.net,2020-04-16,http://paul.info/
13-Dec-2020,ATM,"1,927,525.50",00.00,"2,048,022.44",82923863Bf5EBD0,9378,Stacy,Acevedo,Morrow-Hudson,North Amber,Cook Islands,745.278.2191,(707)302-9351x05511,barbara35@meyer-scott.info,2021-06-26,https://www.roberson.com/
13-Dec-2020,Tax,00.00,"204,802.24","1,843,220.20",7dA33Ad5c070D88,1291,Colton,Zavala,"Flynn, Joyce and Nunez",Hayesfurt,Northern Mariana Islands,891-987-1874x3280,001-790-373-0047,gjohns@faulkner.biz,2021-03-21,http://www.ball-lynch.info/
13-Dec-2020,Cash,00.00,"921,610.10","921,610.10",6AACBD5638e9b11,4057,Colton,Whitney,"Mccann, Hood and Dodson",Port Erinport,Bhutan,574-883-2406,9480033402,zimmermanfrank@collier.com,2021-11-22,http://www.carter.com/
13-Dec-2020,Debit Card,00.00,"92,161.01","829,449.09",5e5eBCeEBbcBE43,3472,Eric,Edwards,Leach-Atkinson,Hooperchester,Russian Federation,288.959.9416x1499,9451677750,carneyjon@avila.org,2020-03-12,http://avery.org/
13-Dec-2020,Cheque,211.70,00.00,"829,660.79",bb074d5D2F172c2,9663,Ethan,Cohen,Kemp Ltd,West Melissashire,Hungary,319.567.8411,(746)634-3625x07838,nashjoseph@gray.com,2021-02-02,https://www.rivers.net/
13-Dec-2020,IMPS,00.00,"92,184.53","737,476.26",Ed1eDdeecefEEa4,8279,Anne,Frank,"Nash, Bowen and Daniel",Port Virginiafort,Kuwait,(998)800-8203x486,(737)446-0048,starkjeremiah@michael.com,2020-12-01,https://tran-marquez.com/
13-Dec-2020,Cash,00.00,"73,747.63","663,728.63",7EE3FDFec35EBf2,556,Leon,Blair,Fitzgerald PLC,North Natashafort,Luxembourg,001-091-066-4467,134.835.0276x0417,samantha68@noble-townsend.org,2022-02-09,http://www.valentine-bowers.com/
13-Dec-2020,Purchase,"32,167.84",00.00,"695,896.47",7C81C2daAAAaaC8,4594,Loretta,Ramsey,Leonard-Hall,Burgesston,Moldova,978-272-2550x19043,+1-945-603-3380,barrkeith@cantrell.org,2021-11-24,http://www.calderon.com/
13-Dec-2020,NEFT,52.07,00.00,"695,948.54",e9afebccEFCdDc3,6546,Aaron,Pena,"Pollard, Michael and Powell",Port Gavinville,Angola,001-177-689-2075x4203,174.951.0383x2871,yvettewalters@arias.net,2020-08-16,http://www.wilkinson.com/
13-Dec-2020,Miscellaneous,00.00,"69,594.85","626,353.69",bEAd67d5792508E,8272,Roberto,Greene,"Hancock, Zamora and Davies",South Chloemouth,Chile,074-422-9655x21416,+1-177-018-6925x9019,tammyhodges@lopez-shaffer.com,2021-01-10,http://knapp.info/
13-Dec-2020,Miscellaneous,"2,029.76",00.00,"628,383.45",FBDdc4dc9f2dDe3,9703,Manuel,Rush,"Wise, Mora and Phelps",Gabriellaton,Syrian Arab Republic,001-745-870-2204,781.772.2155x5319,matthew59@mcguire-ross.com,2022-05-09,https://robbins-peck.com/
13-Dec-2020,ATM,00.00,"157,095.86","471,287.59",9Eb9A4D09A5E7Ae,7936,Oscar,Henson,"Jackson, Wilkerson and Morris",Port Tara,Gibraltar,771-918-4317x5497,001-310-937-7474x099,raguilar@friedman.com,2020-07-27,http://bright.com/
13-Dec-2020,RTGS,00.00,"157,095.86","314,191.73",0caDf60cC2fD25f,6599,Darryl,Bowen,Strickland LLC,Latashaberg,American Samoa,+1-329-741-8199,1524622485,brittanygray@kidd.biz,2021-08-25,http://goodwin-fleming.net/
13-Dec-2020,Cash,"1,457.31",00.00,"315,649.04",3b7d4A4aBE478fb,3974,Edward,Underwood,Mcknight Group,North Kayla,Zambia,001-836-140-3400x591,991-057-2431x20107,autumn08@richardson.org,2021-04-17,https://morrow.com/
13-Dec-2020,NEFT,"3,486.66",00.00,"319,135.70",6F5Fff931dbC1b0,9722,Allison,Powell,"Wilcox, Strickland and Zimmerman",West Kristaville,French Guiana,718.736.7449,491.883.9187x333,claudia76@navarro.org,2021-07-17,http://www.hutchinson.org/
14-Dec-2020,NEFT,"165,999.50",00.00,"485,135.20",A5Aef07bB307eaD,300,Chloe,Hodges,Atkinson Inc,Port Loriburgh,Lesotho,532-733-6539,+1-758-696-2112x340,ldiaz@barr-russo.com,2021-05-06,http://mckinney.com/
14-Dec-2020,Cheque,00.00,"48,513.52","436,621.68",a7E40d6D4CDdeB7,6187,Kristin,Molina,Brock Inc,Kelliehaven,Chile,730-369-0015x622,001-902-805-5954x887,greersierra@kane.com,2021-06-06,http://fowler.com/
14-Dec-2020,Cash,00.00,"87,324.34","349,297.34",324aEA95Cb3A886,4550,Judith,Schneider,Watson-Burns,Meadowsmouth,Thailand,331-987-6451,005-561-8093x427,vgood@tran.com,2021-03-08,https://morales.com/
14-Dec-2020,Purchase,"2,013,371.00",00.00,"2,362,668.34",9E86CF1f1b83C4A,4001,Rebekah,Dyer,Bonilla-Li,Kimhaven,Isle of Man,180.777.2613x89178,+1-008-925-0993x4044,elliskyle@cervantes.org,2020-09-02,https://www.ray.org/
14-Dec-2020,IMPS,19.00,00.00,"2,362,687.34",72B1162eACA0dCB,5517,Lindsey,Neal,Meadows Inc,Lake Ruth,Costa Rica,772.508.6285x72574,066-749-9222x975,epage@rowland.net,2020-11-20,http://herrera-peters.com/
14-Dec-2020,Debit Card,61.00,00.00,"2,362,748.34",a82EAeBa61Dbb20,8404,Angelica,Peck,"Nielsen, Valenzuela and Cantu",North Kaylee,Honduras,450.693.1381x0938,590.414.1063,sanfordcameron@carter.net,2021-10-28,http://hill.com/
14-Dec-2020,Transfer,119.81,00.00,"2,362,868.15",5eeCCaCF2F0d7fD,3746,Shane,Ayers,"Duncan, Rubio and Logan",New Traciview,Chad,001-094-160-1801x3820,453-789-8083x086,bradshawjackie@calderon.com,2020-08-18,https://www.hart-mcneil.com/
14-Dec-2020,Transfer,00.00,"787,622.72","1,575,245.43",add8585D174a0cB,1895,Joy,Crosby,Trevino-Mathews,South Charlestown,Isle of Man,564.723.7447,001-739-111-0380x9519,priscilla20@david.com,2020-12-07,https://www.cunningham-sanders.info/
14-Dec-2020,NEFT,"28,656.00",00.00,"1,603,901.43",4EE4cd7bfeA4Bc6,898,Preston,Rodriguez,Cantrell Group,South Leetown,Micronesia,(360)745-6810,(665)384-1044,brandyholloway@padilla.com,2020-04-21,http://beltran-wallace.com/
14-Dec-2020,RTGS,00.00,"267,316.91","1,336,584.52",adc155A42a8FEFa,1926,Janice,Garrison,Nunez Ltd,South Edwin,Mauritania,231-007-9710x4571,341-180-2305x81183,pedro48@page.com,2020-10-21,https://www.clayton.com/
14-Dec-2020,Cheque,00.00,"190,940.65","1,145,643.87",672c631cdcbD6B7,3592,Sandra,Moran,"Morrison, Welch and Wyatt",West Erika,Morocco,(141)401-3428x5493,140.981.7765,ashleylindsay@bruce-hoover.com,2020-04-26,https://www.monroe.com/
14-Dec-2020,RTGS,34.80,00.00,"1,145,678.67",0F67fbc6c6EaEe6,7771,Tanner,Christian,Glenn-Michael,Lake Hannahfurt,Austria,(274)536-5954x172,432-394-8683,bruce15@pena.com,2020-11-28,https://www.zhang.com/
14-Dec-2020,Cash,00.00,"163,668.38","982,010.29",816ACBaD7DABb1f,7950,Christie,Cohen,Bright-Thornton,Masseybury,Thailand,307.303.8839,+1-928-505-1505,darryl99@park-hicks.com,2020-03-02,http://key.biz/
14-Dec-2020,RTGS,00.00,"196,402.06","785,608.23",b545De0695cAAdC,1671,Hayden,Mckenzie,Beasley and Sons,Watsonview,Vanuatu,+1-761-961-4121x8524,853-784-3616x818,jwallace@rojas-rowe.org,2020-12-21,https://www.garrison.com/
14-Dec-2020,Commission,00.00,"392,804.12","392,804.12",aFA6d4Adb6a687F,943,Brett,Houston,May Inc,Port Preston,Yemen,+1-798-822-9077,+1-656-028-6435x20508,jeanette16@smith.com,2021-03-23,http://weber.com/
14-Dec-2020,ATM,00.00,"130,934.71","261,869.41",cCEEE9BEEE3Fe61,9573,Gregg,Dunlap,"Watkins, Wagner and Olson",South Tanner,Ethiopia,3469115890,223.519.9741x224,roymichael@medina-mccann.biz,2021-05-09,http://www.robles-sloan.net/
14-Dec-2020,Cheque,00.00,"29,096.60","232,772.81",ccAC41c6bb5EDbf,857,Brandy,Barr,Stafford LLC,Lake Morgan,Libyan Arab Jamahiriya,971.249.1728,(925)210-7631x9326,steven08@pineda.org,2021-12-28,https://www.leblanc-farley.com/
14-Dec-2020,Cash,131.00,00.00,"232,903.81",e3e9DDFdD8eCEF9,9185,Sandy,Robinson,Edwards-Villegas,West Feliciachester,Macedonia,+1-889-902-6495x56455,552-759-8897,evelynalexander@edwards.com,2020-11-05,https://shannon.net/
14-Dec-2020,NEFT,"2,253.20",00.00,"235,157.01",a494bCcff7cAB4f,8059,Derek,Warren,Garcia-Brandt,Oscarchester,New Zealand,1073146041,+1-308-097-9668x0278,darlenewalls@cantu.com,2020-08-02,https://glass.biz/
14-Dec-2020,Transfer,"2,507.33",00.00,"237,664.34",beF49bdEbEDCe0D,4109,Teresa,Hawkins,"Erickson, Jarvis and Harrington",Schultzshire,Cote d'Ivoire,254-813-0076,690-845-0779,loveannette@barrera.org,2020-07-01,https://jones.org/
14-Dec-2020,RTGS,"15,568.90",00.00,"253,233.24",F32c88af72E729D,8051,Karl,Braun,Benson-Everett,Gravesbury,Eritrea,552.080.6560,001-722-132-5633x52949,zchurch@schmidt.net,2021-03-07,https://www.burch-bender.com/
14-Dec-2020,Cheque,00.00,"28,137.03","225,096.21",92021846B5ad659,1608,Hayden,Mack,Simon LLC,Boltonstad,Saint Helena,(443)692-4767x5498,+1-295-529-0533x869,wangalicia@wright-potter.com,2020-03-01,http://waller.com/
14-Dec-2020,Commission,"2,602.00",00.00,"227,698.21",045CB24f1E7b657,9745,Dale,Hall,"Mccann, Leach and Winters",Port Bernardchester,Costa Rica,149-807-1413,180.696.2605,maysshari@murray.biz,2021-11-20,https://www.bailey-matthews.com/
14-Dec-2020,Miscellaneous,00.00,"56,924.55","170,773.66",CbB3a58ffAF1E1F,689,Jody,Thomas,Tran-Bray,Marcoshire,Fiji,+1-387-268-5336x2290,(379)634-8241x856,savannahlee@cabrera-kaiser.biz,2020-01-08,https://spence.net/
14-Dec-2020,Purchase,00.00,"28,462.28","142,311.38",fB4c81BB544ef47,8728,Marcia,Andrade,Pruitt-Hull,Port Joditon,Saint Vincent and the Grenadines,+1-447-154-7267x68144,697-553-0922,mwelch@nguyen.biz,2020-06-22,https://www.anderson-phillips.com/
14-Dec-2020,NEFT,"359,123.50",00.00,"501,434.88",81aec2a9e2DD5C7,7134,Raymond,Riley,"Richards, Bullock and Steele",Sarahfurt,Cook Islands,804.811.3305,662.747.3260,courtneyliu@vega.com,2021-03-17,http://moreno.com/
14-Dec-2020,Purchase,00.00,"55,714.99","445,719.89",8eB5B93C47dc00e,3501,Kristina,Swanson,"Esparza, Obrien and Guerrero",Mirandaville,Finland,(494)007-4732,001-265-716-5116x6447,clayton25@webb.com,2020-12-01,https://sims-oliver.com/
14-Dec-2020,Interest,"166,635.60",00.00,"612,355.49",Ee7c70aABaaBbc6,827,Megan,Velez,Stein-Finley,Milesland,Mali,+1-826-260-3637x80991,+1-722-744-2661x8616,carmen33@cervantes.org,2022-01-09,http://franklin.biz/
14-Dec-2020,Transfer,00.00,"612,355.49",00.00,f4706eceA3AaD33,5210,Faith,Larson,"Nelson, Noble and Torres",East Jane,Swaziland,(325)982-1819,+1-617-725-7198x205,qreeves@cardenas-doyle.biz,2022-02-23,https://guzman.biz/
14-Dec-2020,Transfer,36.00,00.00,36.00,26b77e7CBf59856,5006,Connie,Porter,Benjamin-Galloway,Curtisfurt,Barbados,499.382.3292x88532,(449)116-4209,yolandapaul@durham.com,2020-03-21,http://www.combs.org/
14-Dec-2020,Cheque,00.00,03.60,32.40,70ace5bad5Ce2a7,373,Sally,Golden,Rios and Sons,Jeanneview,Morocco,074.545.4625,412.164.8140x5271,stricklandregina@perez.info,2020-04-21,http://nichols.com/
14-Dec-2020,Cash,00.00,16.20,16.20,b47DF82DfcAd5db,6673,Edward,Burke,Vaughan Ltd,South Lacey,Reunion,872.965.7485x4994,379-267-2334x4952,lsherman@bean.com,2020-04-02,https://www.hays.org/
14-Dec-2020,Purchase,"7,434.31",00.00,"7,450.51",08D5DeAEd67321d,1666,Dwayne,Wheeler,"Cooke, Walls and Blair",Lake Yvetteport,British Indian Ocean Territory (Chagos Archipelago),573-999-7446,(235)194-7064,jennifer64@church.com,2020-02-09,https://vaughan.org/
14-Dec-2020,RTGS,00.00,745.05,"6,705.46",B31c210B2D05ed0,2216,Daisy,Shaw,Castillo Group,Sierraburgh,Qatar,+1-448-681-9378,(056)993-8612x0336,vbates@tate-walls.com,2020-04-13,https://fischer.com/
14-Dec-2020,Interest,00.00,"2,235.15","4,470.31",1cD7C84c8ee3196,9751,Brittney,Hall,"Osborne, Knox and Mcfarland",Barryfurt,Bahamas,001-921-567-7554x8348,(907)620-5955x54418,klinetony@schaefer.com,2020-12-26,https://www.carey.com/
14-Dec-2020,Purchase,03.45,00.00,"4,473.76",871d838F2cFbc1A,4868,Debbie,Thompson,Duke-Patterson,Ebonystad,French Polynesia,909.383.8633,221.125.4735,peckaudrey@pennington.net,2021-05-16,http://soto.com/
14-Dec-2020,Bill,"17,001.00",00.00,"21,474.76",baf2630E73Bcd41,7726,Harry,Newton,Herring Ltd,Monicatown,Cook Islands,(685)767-8271,229.947.1627x2216,steven58@casey-galloway.info,2020-06-14,https://kramer-castillo.com/
14-Dec-2020,IMPS,00.00,"21,474.76",00.00,9fBd5F9EeAe3B78,8946,Dillon,Jefferson,Booker-Patrick,West Steven,Bhutan,001-430-432-6706x0224,+1-975-635-4491x593,chasegriffin@estes.net,2021-02-14,https://osborne.com/
14-Dec-2020,ATM,"10,046.40",00.00,"10,046.40",14Bd8abd7779aec,7040,Bob,Austin,"Calderon, Zavala and Harmon",Whiteheadview,Guatemala,001-374-444-9239x847,109-051-7004,charlottebenitez@donovan.biz,2020-03-28,https://rocha.info/
14-Dec-2020,Cheque,00.00,"1,674.40","8,372.00",3354010Fe8ABBdb,9415,Abigail,Chapman,"Lam, Reilly and Mahoney",East Melody,Ethiopia,565.402.5570,+1-286-913-6114,cjacobs@mcdaniel.net,2020-02-03,https://gillespie.com/
14-Dec-2020,RTGS,00.00,837.20,"7,534.80",35F1d7ACF1E98ee,2276,Omar,Holder,Meyers-Braun,Alisontown,Grenada,6336966007,+1-515-813-1908x210,isaiahduarte@buck.net,2020-06-20,https://www.juarez.biz/
14-Dec-2020,Miscellaneous,00.00,"1,076.40","6,458.40",edb08eE9E9C0A45,4448,Priscilla,Molina,Ramirez-Medina,North Shari,Botswana,8352859646,(353)067-9819x76907,ekennedy@conway.com,2020-12-21,http://www.braun.com/
14-Dec-2020,Miscellaneous,00.00,807.30,"5,651.10",Ec605237b17E03A,4452,Omar,Kelly,"Brock, Rosales and Todd",Billyshire,Wallis and Futuna,+1-857-942-2853,+1-393-101-7370x4723,mercadokatrina@weiss.org,2022-02-05,https://www.duarte-garrett.net/
14-Dec-2020,Purchase,"142,217.12",00.00,"147,868.22",7039DDfb6BA00B8,4955,Cole,Mora,"Irwin, Williams and Maxwell",West Marilynfurt,Antarctica (the territory South of 60 deg S),5974979876,249-472-9217x518,adamsdillon@munoz-simmons.com,2022-01-11,http://www.hobbs-brewer.biz/
14-Dec-2020,Debit Card,119.00,00.00,"147,987.22",10E5cd5a792BFbD,5936,Eduardo,Burch,Copeland-Little,Adriennefort,Maldives,(546)680-6837x197,296.346.4906x5006,camachoamanda@singh.org,2022-05-22,https://www.fox-mccarthy.com/
14-Dec-2020,RTGS,00.00,"36,996.81","110,990.42",DF42EfcdACF9952,6808,Carly,Wheeler,Stokes Group,New Colebury,Montenegro,920-235-9919,001-777-288-4224,bernardhowe@schultz.com,2020-12-23,https://www.fuller.org/
14-Dec-2020,Reversal,"1,621,634.20",00.00,"1,732,624.62",f612fDc204BDfdd,3229,Raven,Hughes,Liu-Perez,Curryburgh,Finland,001-865-313-3310x498,174.140.7461x521,tanya20@jacobs.org,2021-11-17,https://www.drake.net/
14-Dec-2020,Tax,00.00,"192,513.85","1,540,110.77",610f3FAFBEd6F7a,5343,Devin,Gutierrez,Conner-Lynch,Lake Joshua,Senegal,001-143-493-4059x73808,(356)245-9283,haley46@gomez-house.info,2021-07-06,http://www.gallegos-contreras.com/
14-Dec-2020,Interest,03.00,00.00,"1,540,113.77",AF6BE2fb8A8584C,2107,Philip,Andersen,"Edwards, Blackburn and Fernandez",South Kathleenborough,Bosnia and Herzegovina,956.892.1458x53645,(928)202-0904x2344,msuarez@galloway.info,2020-10-22,https://www.delgado-hall.info/
14-Dec-2020,Tax,364.00,00.00,"1,540,477.77",bcae9F6eBF83E1c,7723,Monique,Holden,"Cuevas, Patton and Myers",Gardnermouth,Paraguay,800.735.9558x988,455-841-5590,cassidy08@riggs.com,2021-06-16,https://www.kennedy-sanford.com/
14-Dec-2020,RTGS,00.00,"220,068.25","1,320,409.52",D69C3ef77AbD0eC,6894,Lee,Glenn,Levy PLC,Virginiahaven,Mozambique,825.540.6318x10917,001-186-903-6412x18707,jaclyn71@wright.org,2020-02-20,https://www.morrison.info/
14-Dec-2020,Transfer,06.09,00.00,"1,320,415.61",03069A40c583EfA,3341,Jordan,Ho,York Group,Hahntown,Hong Kong,(094)070-8496,001-961-124-0000,johnsonlouis@velez.net,2021-12-15,http://mills.com/
14-Dec-2020,Commission,"173,962.30",00.00,"1,494,377.91",FcFcd5CCC5aB946,5049,Kayla,Stephenson,Larsen PLC,North Natalieside,Afghanistan,804-244-4792x978,547-726-4799,jeffpowell@ho.com,2022-05-28,https://www.newton-mcdonald.com/
14-Dec-2020,Cheque,174.80,00.00,"1,494,552.71",29A8E562DC75ede,105,Bobby,Collier,"Horn, Stevenson and Yoder",New Cindy,Mauritius,001-778-840-9271x74639,+1-151-871-9736x708,samantha34@mccarthy.com,2020-04-11,https://hendrix-pittman.biz/
14-Dec-2020,Miscellaneous,13.94,00.00,"1,494,566.65",FFbfa8DB1636c95,6142,Dillon,Gutierrez,Curry-Reeves,East Eugene,Ethiopia,001-256-235-2398x858,662.996.8911x18688,ehorn@beltran.com,2021-11-01,https://copeland.com/
14-Dec-2020,ATM,00.00,"498,188.88","996,377.77",9FFdCCA069A6a25,9521,Debbie,Hunt,Hampton-Banks,Santiagoland,Korea,(398)190-9748,001-883-925-2900,lclarke@jordan.com,2022-01-10,http://www.montoya-tapia.com/
14-Dec-2020,Debit Card,00.00,"99,637.78","896,739.99",9DC7CFBaf0bf30c,5638,Johnathan,Cole,"Ramos, Ho and Alexander",West Curtis,Saint Helena,360-117-6011x15273,(812)881-2711,autumn22@turner.com,2020-10-14,https://caldwell.net/
14-Dec-2020,Transfer,54.00,00.00,"896,793.99",761cD254af2510b,9749,Alvin,Stanley,Dominguez Ltd,East Francismouth,Romania,(632)233-9387x7068,(151)673-6114x437,jesse17@villa.com,2022-01-16,http://barker.info/
14-Dec-2020,Miscellaneous,00.00,"179,358.80","717,435.19",496d2Ca80Ff4E6c,6871,Katrina,Wu,Ho-Harvey,New Jade,Malaysia,(170)727-0987x057,8389704988,ischwartz@blackwell.net,2021-05-20,https://meza.biz/
14-Dec-2020,Tax,00.00,"358,717.60","358,717.60",a7A58daFFa207BD,2783,Kathryn,Clay,Garrison-Bond,Kurtburgh,Tajikistan,075.981.0402x6410,+1-698-265-4956x1457,rileyyvette@kane-ruiz.org,2021-11-16,http://www.mills-harper.com/
14-Dec-2020,Miscellaneous,00.00,"51,245.37","307,472.23",ce3f1ba75c5CaF2,4343,Mitchell,Quinn,Mayer-Mays,South Karla,Korea,(303)658-2688,920-649-2569x4315,mccarthyzachary@kelly.com,2020-06-25,https://www.mcknight-smith.com/
14-Dec-2020,Debit Card,04.41,00.00,"307,476.64",Ad79e23EE8ba1b7,6011,Allen,Garcia,"Downs, Lynch and Tran",North Margaret,Trinidad and Tobago,335-821-0963x6467,6115909210,carlybryant@hendrix.com,2020-09-16,http://www.vega.net/
14-Dec-2020,Tax,00.00,"38,434.58","269,042.06",a3AdE5d1fD0ebbb,8212,Wesley,Hebert,Nguyen-Mcgrath,Carolhaven,Namibia,764-200-9500,(303)383-9420,aford@gilbert-mcclain.biz,2021-06-07,http://www.velez.com/
14-Dec-2020,Miscellaneous,"162,528.00",00.00,"431,570.06",F196D46EbfbA82f,3711,Riley,Dickson,Logan-Chambers,Port Shelly,Uzbekistan,526-837-9911,001-643-608-3302x3445,tracey47@ayala.com,2020-11-26,http://www.glover.com/
14-Dec-2020,Tax,00.00,"53,946.26","377,623.80",4E83f21eAF07A57,8113,Karina,Russo,"Clayton, Silva and Knapp",Lake Sarahmouth,Greece,001-899-461-4139x668,481.151.0109,gregduke@mckinney.com,2022-05-25,http://holloway.org/
14-Dec-2020,Cash,00.00,"377,623.80",00.00,51dE6f5a10A9eb0,3860,Kimberly,Keller,Bean-Hahn,Stephenburgh,Haiti,+1-875-245-3183x763,001-708-706-2005x6648,carlos62@reid.biz,2021-04-05,http://joseph-blankenship.com/
14-Dec-2020,Cheque,06.90,00.00,06.90,3E1DEF6B8E1c5Bc,8580,Corey,Fernandez,Frye-Buckley,Cathyton,United States of America,(706)316-8625x31062,(756)194-9365,dnoble@hanna.biz,2021-10-02,http://www.sellers.info/
14-Dec-2020,IMPS,485.00,00.00,491.90,1BAebBabfCAC2Db,7885,Geoffrey,Landry,Pace LLC,Port Triciaberg,Saint Martin,937-421-0377,001-728-843-3142,martin55@bautista.com,2022-02-14,http://peterson.com/
14-Dec-2020,ATM,00.00,54.66,437.24,9F4971EFb502c27,5499,Kelsey,Morris,Collins PLC,Belindaview,Moldova,001-516-947-2216x1645,001-492-514-4137,awinters@lara.com,2021-09-07,https://www.phelps-powers.org/
14-Dec-2020,Commission,"1,124,732.50",00.00,"1,125,169.74",dEC3fafcC3fC2D7,8476,Nichole,Medina,"Bauer, Castillo and Moss",South Darlene,Somalia,544-619-7554x894,920.112.9201x098,tammieschwartz@snyder.com,2022-02-10,http://waters.com/
14-Dec-2020,RTGS,00.00,"125,018.86","1,000,150.88",6b05EA2b0D4Bba4,6423,Courtney,Rocha,Allison-Cohen,South Arthurborough,Kuwait,354-856-1248,(655)838-1244,alex54@colon.com,2022-04-04,https://mendez.net/
14-Dec-2020,NEFT,00.00,"125,018.86","875,132.02",BD34Ee5E186B64E,6963,Gary,Arnold,Brewer-Mejia,South Maxwellton,Svalbard & Jan Mayen Islands,104.435.6152x36190,928-770-2671x2577,linstacey@benjamin-dorsey.com,2020-04-04,https://english.com/
14-Dec-2020,Bill,"1,846.20",00.00,"876,978.22",E14dc5CfcD9A8a6,7783,Helen,Stuart,Pace Inc,Michelleshire,Aruba,+1-519-579-8348,134.819.8456x540,marisamorales@graham.com,2021-03-10,https://chavez.net/
14-Dec-2020,Tax,267.50,00.00,"877,245.72",19A53a797Cb3F7b,673,Erika,Hayes,"Cordova, Gates and Acevedo",Ashleyberg,Central African Republic,367-664-4769x9987,001-175-965-2381,robin62@mcknight.com,2020-07-11,https://www.mann-johnson.com/
14-Dec-2020,Transfer,00.00,"87,724.57","789,521.15",d3cCC3C94bfA15d,270,Martha,Molina,Cooper-Richards,East Jonathanborough,Fiji,916-950-6485x5931,723-255-8755,pratthector@ferrell.info,2021-08-07,http://www.knight-weiss.com/
14-Dec-2020,Transfer,00.00,"98,690.14","690,831.01",1F90caffb835946,7993,Alyssa,Warner,Bridges-Rangel,South Gilbert,Mexico,972-677-1840x5444,+1-153-477-8157,tashasantana@butler-booth.com,2022-02-06,https://www.goodwin.com/
14-Dec-2020,RTGS,00.00,"690,831.01",00.00,19A5D9Fc80c7b8b,6690,Marvin,Wall,Finley-Bell,South Rebekahborough,Burundi,359-218-3472,+1-913-731-7111x90296,michaela94@house.com,2020-02-23,http://www.vega-gibbs.com/
14-Dec-2020,RTGS,"4,983.00",00.00,"4,983.00",05c6e3D55a93Ce3,1471,Dakota,Chapman,Cochran and Sons,Coxton,Saint Pierre and Miquelon,572.114.6164x236,001-991-905-2279,gwalker@stevens.biz,2022-04-10,https://www.zuniga.info/
14-Dec-2020,Debit Card,00.00,"4,983.00",00.00,eA89dC7B08DA83B,5201,Kent,Washington,Carr and Sons,North Latoya,Poland,659.331.7232x239,+1-854-949-2936,alexanderjohn@donovan-shelton.com,2022-04-11,https://www.kerr.com/
14-Dec-2020,Transfer,07.00,00.00,07.00,2f9F0c87EEbfBd7,6742,Shelia,Garza,Leon-Bell,North Andrewhaven,Czech Republic,+1-643-748-3369x166,(908)142-7018,morristravis@castro.com,2021-02-09,https://downs.com/
14-Dec-2020,RTGS,08.00,00.00,15.00,D5f17Db99bA00Cf,7169,Nina,Woods,Avery-Pacheco,Hornefort,Venezuela,666.686.5884,904-792-5160,vargasadrienne@baird-simon.org,2020-03-08,https://burton-bird.com/
14-Dec-2020,Reversal,00.00,01.88,13.12,Fe4b23F7b42Ee9e,8710,Glenn,Chambers,"Mckinney, Chase and Beltran",Port Sherri,United States of America,138.494.0884x0515,+1-597-471-9271x4353,havery@logan.com,2021-12-25,http://mathews.com/
14-Dec-2020,Cheque,"4,003.00",00.00,"4,016.12",E2cFcC727F306d6,582,Alexandra,Ware,"Velasquez, Kent and Henderson",Gallegoshaven,Uganda,948-698-9959x305,(743)085-8227,wyattbriana@cervantes.net,2020-02-04,https://www.ramos.info/
14-Dec-2020,ATM,"1,353.17",00.00,"5,369.29",f575ca97eaB6e8C,835,Latoya,Floyd,Buchanan-Cervantes,South Brittney,Libyan Arab Jamahiriya,(892)350-5679,472.477.3220x1735,apotts@dalton-reese.com,2020-09-09,https://pollard.com/
14-Dec-2020,Miscellaneous,00.00,"1,789.76","3,579.53",0aCDC09DBfb863B,3381,Lydia,Michael,Mueller-Bowman,Singletontown,Philippines,001-058-677-3992x1537,905-197-4917x615,ldelgado@waller-bell.net,2021-08-16,http://www.nicholson-wu.com/
14-Dec-2020,Commission,00.00,596.59,"2,982.94",6CaAB9eB928DcC5,536,Rebecca,Rasmussen,Park and Sons,North Tanya,Comoros,749-064-9430x7897,204-684-0840x23498,weberkerry@mcbride.biz,2020-08-06,http://ashley.com/
14-Dec-2020,RTGS,"67,792.00",00.00,"70,774.94",056EE52d310c8Ef,9114,Wanda,Mays,"Wolfe, Kaufman and Fischer",Brandonmouth,Denmark,9475849787,(828)630-6959x8734,randolphmackenzie@wheeler-huffman.com,2021-12-01,http://www.lowery-nolan.net/
14-Dec-2020,Transfer,"957,410.00",00.00,"1,028,184.94",83D3EfF10D3fCE7,8317,Clinton,Shannon,Rojas Group,West Darlene,Finland,201.127.5206,082.880.5381x29459,molly02@noble.com,2020-10-27,http://fischer.net/
14-Dec-2020,Cheque,"208,935.72",00.00,"1,237,120.66",5E7F3322Ca5B87d,2051,Roberto,Zavala,Frey PLC,Lake Danielside,Falkland Islands (Malvinas),+1-750-453-7643x5618,926.104.7160,lambertjoan@mccall-hancock.info,2022-01-06,https://joyce.org/
14-Dec-2020,NEFT,00.00,"206,186.78","1,030,933.88",DAFfBd2aC85655D,6585,Sean,Fernandez,Miles LLC,North Ronaldshire,Denmark,308-545-9982,169.012.9079x6779,morselaurie@hart.org,2022-01-07,http://davies.com/
14-Dec-2020,Commission,00.00,"206,186.78","824,747.10",664c5ABFDc5c6DD,8623,Grace,Duarte,Hutchinson-Townsend,Franciscostad,French Southern Territories,468-498-2829x16187,1225413846,daisy89@patel.info,2021-05-02,http://www.johnston-love.org/
14-Dec-2020,RTGS,"192,738.00",00.00,"1,017,485.10",FCAAa5D90f2dC65,8943,Ralph,Gonzalez,Pham-Park,Port Jackson,Montenegro,(955)592-2996x37256,6380005245,kaitlinsutton@yang-werner.info,2021-11-19,http://www.hoffman.com/
14-Dec-2020,Reversal,"1,840,816.75",00.00,"2,858,301.85",1ADFe8Df3CEE0f4,4100,Bianca,Dalton,"Blanchard, Hawkins and Frye",West Lindsey,Rwanda,6811925239,556.340.1059x8902,robertroth@craig.info,2020-06-16,https://www.herrera.info/
14-Dec-2020,Interest,"3,881.00",00.00,"2,862,182.85",EAF26EBADD8bc90,5303,Jonathan,Irwin,Castillo PLC,Port Jim,China,001-725-591-2817x963,(440)070-5254,rayralph@french-duke.com,2020-11-18,http://www.cain.com/
14-Dec-2020,Commission,"2,634.00",00.00,"2,864,816.85",f1fCDC389b6deF6,4409,Clifford,Duffy,Cooper and Sons,New Jenna,Guadeloupe,0861483008,001-388-309-6343x26974,priscillamoon@nash.com,2020-02-06,https://blackwell-bernard.org/
14-Dec-2020,Tax,"114,648.00",00.00,"2,979,464.85",B1Cbd3b8810b78c,7987,Natasha,Kidd,Hill-Hendricks,East Haydenville,Tuvalu,852-220-0484,001-372-352-4399,patelshannon@wyatt.info,2022-01-22,https://daugherty.com/
14-Dec-2020,IMPS,00.00,"297,946.49","2,681,518.37",5c6d2EBBB3229AF,1917,Karina,Zhang,"Allen, Byrd and Oliver",Daveville,Lao People's Democratic Republic,(679)223-3818x7569,001-856-286-4813,bridgesivan@reynolds.com,2020-01-08,http://bass.net/
14-Dec-2020,RTGS,00.00,"297,946.49","2,383,571.88",04FCcde4DEb9fBE,799,Melissa,Hahn,Randolph Group,Mckenziefort,Liberia,0895604091,+1-779-509-6543x047,hnorris@benton.com,2020-05-05,https://mcmahon.info/
14-Dec-2020,Debit Card,00.00,"2,383,571.88",00.00,64Afc702a6c5Fad,1046,Kara,Bennett,Swanson-Mahoney,East Mathew,Estonia,(379)747-9902x4324,+1-578-411-2031x91611,kaitlinpeters@pacheco.net,2022-01-30,https://www.carson.com/
14-Dec-2020,Bill,131.10,00.00,131.10,e010b9FAAFa6366,8315,Chloe,Anderson,Rhodes-Durham,Mosesstad,Brunei Darussalam,001-486-712-6029x6810,(110)537-0452,karinacaldwell@hull.biz,2020-02-14,http://www.thomas.com/
14-Dec-2020,Transfer,00.00,26.22,104.88,EE7FaFDEA2E0fcA,8556,Tammie,Stein,Foster-Stafford,West Pedro,Bermuda,(732)173-0418x79735,(670)675-3568x7529,barnettmeagan@floyd.info,2020-02-26,https://www.webb.info/
14-Dec-2020,Cash,00.00,104.88,00.00,cBe7A74Ba85a6bd,538,Darlene,Haney,Hughes-Sanchez,West Joyceside,San Marino,001-318-878-3519x90125,+1-957-916-6199x1636,ricardo33@tran.info,2021-01-08,https://www.ali.net/
14-Dec-2020,Purchase,"150,937.53",00.00,"150,937.53",97AEFB7Ff65bCD0,2428,Gregg,Delgado,Miranda LLC,North Kenneth,Solomon Islands,+1-940-218-5387x367,(306)434-0744x420,dmclaughlin@gentry.net,2022-04-24,https://mueller.com/
14-Dec-2020,IMPS,00.00,"21,562.50","129,375.03",d342b8C9cbCfB4e,7932,Bridget,Carpenter,"Collier, Novak and Monroe",Mcconnellburgh,Vanuatu,404-593-8120x5650,833-845-3664,mconrad@lamb.com,2020-12-29,https://www.christian.com/
14-Dec-2020,Purchase,00.00,"12,937.50","116,437.53",6DdADca2C7744fD,224,Max,Gates,Solis-Olson,West Rubenburgh,Micronesia,001-401-710-2797x2407,4420602669,xrollins@mcfarland.com,2020-02-11,https://www.hood-decker.com/
14-Dec-2020,NEFT,51.85,00.00,"116,489.38",9F4971EFb502c27,5499,Kelsey,Morris,Collins PLC,Belindaview,Moldova,001-516-947-2216x1645,001-492-514-4137,awinters@lara.com,2021-09-07,https://www.phelps-powers.org/
14-Dec-2020,Transfer,00.00,"11,648.94","104,840.44",8c16D1cee97F4bd,5650,Walter,Watts,"Newton, Stewart and Maxwell",Allisonberg,Lesotho,+1-691-439-5069x7634,2893500582,katiemendez@gaines.com,2020-01-26,https://www.patrick-rose.com/
14-Dec-2020,Interest,"1,786.00",00.00,"106,626.44",B7eb7C0e1e7c35c,7002,Kaylee,Schaefer,Herrera-Vance,Port Veronicaland,Cameroon,478-244-3635x5750,755.801.2843,caroline46@stone.com,2020-04-15,https://nielsen-hamilton.biz/
14-Dec-2020,Debit Card,"212,055.60",00.00,"318,682.04",f9f5D3dCb425E5a,2381,William,Mcknight,Sheppard LLC,Lake Dana,Mauritania,(353)073-4038x9352,7758673691,nicholas70@short-leonard.com,2021-02-21,http://www.newman.com/
14-Dec-2020,NEFT,400.00,00.00,"319,082.04",2d70c20FF2DCFe0,6577,Janet,Mccoy,Moran-Farrell,West Mike,Western Sahara,001-768-908-5887x414,236.486.7225,rivasjames@kelley.com,2021-04-26,http://www.melendez.com/
14-Dec-2020,Cash,00.00,"45,583.15","273,498.89",07dbfcceEebc1eE,9228,Mary,Ballard,"Collier, Decker and Wade",East Kelli,Guadeloupe,(733)133-0404x62734,455-423-5137,steelebriana@cummings.com,2022-05-10,http://beard.com/
14-Dec-2020,Commission,00.00,"68,374.72","205,124.17",0b360CEfC28856F,4308,Gregg,Harrison,Lyons-Malone,Adriennefurt,Georgia,001-110-660-9582x4357,385-003-0821x23479,nballard@dyer.com,2020-04-26,http://pena.net/
14-Dec-2020,ATM,00.00,"20,512.42","184,611.75",4a8bB77e9dEB49F,3481,Mario,Cook,"Valencia, Wells and Sexton",East Joanneton,Panama,0465411805,984.963.0700x7690,katelyn88@hays.com,2020-05-16,http://www.fitzpatrick.com/
14-Dec-2020,Bill,00.00,"18,461.18","166,150.58",ca750CCfBbEDc4D,8827,Ray,Cobb,Mccall PLC,South Terrence,Niue,823-942-0556,(928)354-2092x03308,carolvasquez@keith.info,2021-11-15,http://www.donaldson.com/
14-Dec-2020,Interest,"9,820.00",00.00,"175,970.58",E5Bc9CFdD7E8cCe,285,Sheena,Donaldson,"Villanueva, Li and Hurley",South Robynton,Brazil,+1-711-991-7360,+1-562-005-5140x18832,candace29@diaz.com,2021-04-12,http://www.scott-lutz.com/
14-Dec-2020,NEFT,00.00,"175,970.58",00.00,3F389fdde74aaAB,6674,Alex,Pace,Strong and Sons,Wangfort,Madagascar,(156)793-6917x4940,742.192.0076x7446,bradsolomon@bryan.org,2022-05-29,https://www.charles-gordon.info/
14-Dec-2020,Purchase,98.26,00.00,98.26,0A3b2f5F057B9FD,6010,Eddie,Mccormick,Bailey Ltd,Lake Jesusville,United Arab Emirates,(285)504-4426,001-104-343-3432x981,andrewsherman@davis.com,2021-01-01,http://www.hartman.com/
14-Dec-2020,Miscellaneous,00.00,49.13,49.13,eF28AcC4D6d40C2,9724,Victor,Rasmussen,"Cortez, Shepherd and Love",Chloefort,Cote d'Ivoire,129.629.4288x1670,+1-541-855-4042,melaniesanchez@walton.com,2021-07-23,http://www.parsons-pratt.com/
14-Dec-2020,NEFT,56.00,00.00,105.13,762AaDC9A3c17Bc,2725,Jon,Mccoy,"Erickson, Reid and Wolfe",West Brooke,Estonia,001-552-332-8213,+1-621-110-2708x85553,bookertyler@gross.com,2021-07-23,http://www.brown-zhang.net/
14-Dec-2020,Cheque,"172,631.00",00.00,"172,736.13",aAC287d15f531C0,5975,Randall,Lyons,Mclean-Stout,Kentburgh,Tokelau,376-024-1899x0663,001-047-231-4317x468,deannablanchard@madden.info,2020-04-17,http://mora.com/
14-Dec-2020,Debit Card,00.00,"17,273.61","155,462.52",fAc9CfAc327d9b8,8431,Lacey,Cabrera,Mora LLC,North Isabellabury,Liberia,001-528-077-0999x699,3687586645,cameron90@barrett.biz,2020-07-09,http://larson.net/
14-Dec-2020,Reversal,52.00,00.00,"155,514.52",EF0Bbad286c34Ab,4616,Kristen,Hill,Ellison PLC,Gabrielaborough,France,5591223818,739-578-4901x501,wandahaley@park-gross.com,2020-07-26,https://woodward-doyle.com/
14-Dec-2020,Transfer,"2,551.00",00.00,"158,065.52",8D4A1B8aDd8eCec,3279,Andres,Rubio,"Willis, Burton and Griffith",East Dawn,Tonga,143-893-7884,114.962.9738x85245,sharon62@pace-barr.com,2021-01-19,http://jones-mayer.org/
14-Dec-2020,Commission,00.00,"79,032.76","79,032.76",ed2B4beDCD098ba,6445,Roberto,Mejia,Price Ltd,Katiestad,Malaysia,007-005-6213x2785,+1-231-226-3466,elijahcasey@butler-elliott.org,2020-05-16,http://www.reid.com/
14-Dec-2020,RTGS,00.00,"15,806.55","63,226.21",347FA7d85Faa2BF,9932,Loretta,Mclean,Morales Ltd,North Julianfort,Dominica,440-483-3810x71362,(316)998-6672x458,fosterperry@valencia.com,2020-10-17,https://www.bright-mckenzie.info/
14-Dec-2020,Cash,31.82,00.00,"63,258.03",fCDecCAAf3c0b17,5618,Kathy,Cook,"Chase, Washington and Mora",New Cindy,Palau,0239473510,634.317.6429x452,cole55@drake.com,2021-11-14,https://tyler.info/
14-Dec-2020,Cash,00.00,"21,086.01","42,172.02",AcB32b621dBDC09,5251,Jesus,Caldwell,"Gardner, Gilmore and Butler",Bonillamouth,Tunisia,001-637-510-7065x4620,802-204-6152x4848,bbowman@stanton-curtis.com,2020-11-26,http://dalton.com/
14-Dec-2020,IMPS,"397,488.00",00.00,"439,660.02",3c3B6BdffCcFfDb,1038,Desiree,Lara,Hartman-Fletcher,Morrowmouth,Iraq,+1-793-004-0121,+1-524-560-1034x202,tyrone10@spears.com,2020-01-04,http://jensen.com/
14-Dec-2020,NEFT,00.00,"62,808.57","376,851.45",7F23F7acC9700EC,3061,Lorraine,Herman,"Berger, Barton and Huffman",New Michaela,Sudan,001-301-655-3175,533.040.0548x08673,hooverbenjamin@parker.net,2021-01-21,http://velez-shields.biz/
14-Dec-2020,Bill,00.00,"188,425.73","188,425.72",FCafacc76bBdB6E,9919,Marilyn,Gross,"Casey, Villegas and Christian",Madisonchester,Macedonia,(961)190-1574x93373,538-570-1678x1584,padilladawn@hale-pittman.com,2020-06-24,http://sanford.com/
14-Dec-2020,Bill,44.00,00.00,"188,469.72",78Ca3130dbcEDed,3067,Kellie,Delgado,"Irwin, Combs and Hays",Charlotteton,Belarus,922.502.9388x43864,039-914-2239x8442,devin11@briggs.org,2021-05-10,https://carey.net/
14-Dec-2020,Debit Card,"229,403.00",00.00,"417,872.72",a1b1fE22c26AE2f,1357,Rebekah,Branch,Mcgrath-Alvarez,Leonardchester,Lao People's Democratic Republic,296.432.1556x8710,(544)113-1837x084,selenaterry@cooley-arnold.com,2021-09-28,https://www.meyers.com/
14-Dec-2020,Tax,04.59,00.00,"417,877.31",7dBbbA4F7f4eeC1,8290,Nathan,Donaldson,Delgado Inc,Cummingsport,Cote d'Ivoire,(274)255-4865x480,381.739.4422,jvilla@phillips.com,2020-11-15,https://www.long.com/
14-Dec-2020,Commission,00.00,"83,575.46","334,301.85",e8C814720B065b3,5040,Jon,Bradshaw,Mathis-Houston,Alexisstad,Zambia,001-543-454-8025x287,(462)648-9874,zhouse@carter-vaughn.biz,2020-09-16,http://www.kline-buchanan.biz/
14-Dec-2020,ATM,00.00,"111,433.95","222,867.90",f1cf4EBd1c93f8b,3488,Shawna,Adams,Nelson-Luna,North Timberg,Indonesia,001-026-631-3424x46582,644.460.5193,bethanybradshaw@pugh.com,2020-05-29,https://www.carpenter.com/
14-Dec-2020,Cheque,00.00,"24,763.10","198,104.80",3cBb4ef80f50f64,2303,Dakota,Pacheco,Mckenzie Inc,Ralphborough,Japan,416.142.8154x7807,001-516-725-4972x387,williamsonfernando@meyers.com,2021-10-29,http://williams.com/
14-Dec-2020,Miscellaneous,00.00,"39,620.96","158,483.84",6d350C5E5eDB4EE,4,Patty,Ponce,Richardson Group,East Kristintown,Northern Mariana Islands,302.398.3833,196-189-7767x770,hohailey@anthony.com,2020-07-02,https://delacruz-freeman.org/
14-Dec-2020,Purchase,02.00,00.00,"158,485.84",cfC51Eb78eBbc9d,2349,Rita,Hensley,Barker Ltd,Loganside,Palestinian Territory,+1-761-592-4317,(155)060-2584x863,jeanette03@mitchell-blevins.org,2020-08-02,http://eaton-davies.org/
14-Dec-2020,Bill,00.00,"26,414.31","132,071.53",05a734fB7EbE534,7405,Cesar,Parks,Sandoval-Caldwell,South Rodneybury,Uruguay,(639)612-9351,001-636-538-3986x65208,vrubio@wilcox.info,2020-08-07,http://www.chapman.net/
14-Dec-2020,RTGS,181.70,00.00,"132,253.23",7741E98D0D5ED12,4941,Clifford,Sanchez,"Shaw, Little and Jordan",South Tyler,Mauritius,5208128451,001-328-765-1610x286,hvincent@hatfield.org,2021-12-16,https://www.benson-schneider.com/
14-Dec-2020,Miscellaneous,00.00,"33,063.31","99,189.92",6913dfE4BB9A2Cf,6030,Connor,Decker,Hayes-Sharp,South Wandamouth,Kuwait,182-169-0643,894-262-7896x7900,daniel66@york.net,2020-01-12,http://york.com/
14-Dec-2020,Purchase,00.00,"9,918.99","89,270.93",39B3b72eA60759a,3134,Cesar,Hansen,Robinson-Kemp,Port Emma,Wallis and Futuna,283-592-7552x364,696.896.1928,isaunders@booker.com,2020-03-24,https://www.li.com/
14-Dec-2020,Cash,"2,034.10",00.00,"91,305.03",01AbCb7ea1FA2Ad,6070,David,Jensen,Whitehead PLC,New Staciefort,Brunei Darussalam,(139)650-9349x81978,+1-382-043-3180x81705,chelsea51@petty.net,2022-03-22,https://willis.com/
14-Dec-2020,Transfer,00.00,"10,145.00","81,160.03",DA85ce14eDd49EB,302,Kristopher,Hammond,Hopkins-Hawkins,New Martha,Vietnam,8589013055,001-908-067-4996x26932,pgreene@stanton.info,2021-05-15,http://www.horne-bradshaw.net/
14-Dec-2020,Bill,00.00,"11,594.29","69,565.74",4307d24D3DA910d,3679,Renee,Rose,Benson-Hinton,Lake Malikhaven,Malawi,001-795-643-9662x120,236-574-9910x46145,crossbrent@burnett.com,2021-03-28,http://www.li.org/
14-Dec-2020,Interest,04.11,00.00,"69,569.85",adFCbCFc5Dace94,3641,Paul,Rodriguez,Nash LLC,Sherribury,Nauru,496-898-7501,001-013-249-6205x142,chandana@santos.info,2021-05-19,https://www.mosley-frost.com/
14-Dec-2020,NEFT,00.00,"17,392.46","52,177.39",2CdAa11D2f8EFea,7025,Toni,Solomon,Rowe-Sellers,South Matthew,Brazil,(624)393-0138x891,303.362.9655x865,billyowens@mcdowell.com,2020-07-25,https://www.sellers.org/
14-Dec-2020,Transfer,"189,888.90",00.00,"242,066.29",32B7A0Fa103c698,1143,Earl,Ferguson,"Harrington, Carr and Stanton",Laurachester,Lao People's Democratic Republic,(555)257-9307,6161653556,beasleyjoel@rasmussen-guerrero.info,2021-06-01,http://www.pineda-davis.com/
14-Dec-2020,Cash,"2,850.30",00.00,"244,916.59",71AD8b7efCcF72B,9220,Cynthia,Vaughn,Lam and Sons,Medinaville,Syrian Arab Republic,450-248-3738x11386,342.956.5502,rossmeyers@lyons.com,2021-04-11,http://www.irwin.net/
14-Dec-2020,IMPS,"256,043.10",00.00,"500,959.69",2784F936a59CD9A,3568,Hayley,Gay,Logan-Ayala,North Carmenbury,Martinique,+1-856-087-3536x31490,380-239-8063,sbaker@cherry.com,2020-09-27,https://www.herring.com/
14-Dec-2020,Transfer,00.00,"55,662.19","445,297.50",f6ebaafaA5e23BB,5566,Rebekah,Salazar,"Meadows, Koch and Baker",West Kevin,Falkland Islands (Malvinas),+1-780-476-2431,325.994.8061,camerondawn@huffman.com,2020-02-16,http://peck.info/
14-Dec-2020,Debit Card,00.00,"63,613.93","381,683.57",8d9AfDF5d4B5ed5,6513,Darrell,Hoffman,"Browning, Becker and Meyers",New Terri,Venezuela,902.666.8908x060,(397)779-8873x954,johnskaren@parks.org,2020-02-20,http://nelson.com/
14-Dec-2020,Cheque,00.00,"381,683.57",00.00,Db2f1dD4D11363a,8393,Stefanie,Soto,"Morales, Grant and Holder",Dorseyview,Montenegro,001-229-828-3310,001-061-498-8457x07281,samanthalloyd@jenkins-mccarthy.info,2020-08-19,http://stephenson.com/
14-Dec-2020,Purchase,"413,747.50",00.00,"413,747.50",1eb1743a5B5FEcF,2789,Perry,Tanner,"Pearson, Baldwin and Medina",South Timport,Hungary,001-829-951-9186x25150,001-509-981-7000x97666,jackson94@cain-hayes.com,2020-04-01,http://www.gaines-neal.com/
14-Dec-2020,NEFT,377.10,00.00,"414,124.60",3fDD8Cf1DaFcE3F,5771,Carly,Barrett,Murray-Horton,Port Cheryl,Estonia,001-008-694-9207,+1-530-387-1677x330,mcguirelouis@tapia-logan.com,2021-07-23,http://www.daniel.com/
14-Dec-2020,Purchase,00.00,"138,041.53","276,083.07",fE3dcedce0bb637,3046,Patrick,Lucero,Williams PLC,Annetteside,Montserrat,5157952114,+1-270-871-7146,marcusgeorge@cortez-york.biz,2021-12-03,https://foley.info/
14-Dec-2020,Bill,00.00,"276,083.07",00.00,Ca492c76A52Da9F,67,Kelli,Bridges,"Black, Richardson and Sandoval",Lake Aaron,Mongolia,5657167326,220.834.4618x14578,daisyblair@walsh-holmes.org,2021-12-05,https://www.trevino.info/
14-Dec-2020,Transfer,"1,992,366.00",00.00,"1,992,366.00",980196D28cE27Ab,5651,Lorraine,Cochran,Wiggins-Shah,Alberttown,Thailand,+1-663-917-9102,5567946904,hector38@frey.org,2021-10-12,http://gay-weber.org/
14-Dec-2020,Cheque,00.00,"398,473.20","1,593,892.80",1b5851b304fE8B3,6899,Ebony,Rich,Stevens LLC,Sparksstad,Pitcairn Islands,925-780-9614,429.785.3223,allenhartman@cain.com,2021-11-10,https://decker-carson.com/
14-Dec-2020,Tax,"3,172.77",00.00,"1,597,065.57",72A962E3a3A1908,2015,Tiffany,Bird,"Cochran, Barrett and Pierce",Annburgh,Chile,357-784-7136x12025,259.252.6874x5666,jodilara@chang.biz,2022-05-18,https://richards.com/
14-Dec-2020,NEFT,00.00,"266,177.60","1,330,887.98",d47D9cf5dFA3813,1780,Corey,Melton,Jacobson-Wade,Port Bailey,New Zealand,+1-104-581-5426x4237,001-614-999-8183x785,kemplaurie@bradshaw.com,2022-03-17,http://morales-brewer.net/
14-Dec-2020,Cash,00.00,"190,126.85","1,140,761.13",dfFE0Ad4C1D70Af,6590,Terrance,Knox,Li-Simon,Keyport,Mexico,(208)783-4162x65732,434-125-7929x940,chaseprince@copeland.info,2021-05-04,http://www.compton.com/
14-Dec-2020,IMPS,00.00,"228,152.23","912,608.90",fA99aEF4eE28aD8,68,Summer,Washington,Benjamin LLC,North Elizabeth,Grenada,3412967650,9330266446,thomasnicholas@blankenship-ford.com,2021-09-26,https://www.wagner.org/
14-Dec-2020,Interest,"1,051.00",00.00,"913,659.90",c5A27f8F3FEbBde,4950,Randy,Mckinney,"Jennings, Bernard and Roth",East Sarachester,Martinique,+1-807-931-4668x63748,892.275.5404,nicole03@hampton.org,2020-06-13,https://www.jefferson.com/
14-Dec-2020,Transfer,00.00,"91,365.99","822,293.91",B9a96c6b38BBBA9,3989,Blake,Schneider,Randolph PLC,Lake Michelle,Monaco,818-278-6281x232,+1-840-417-6556x0086,cameron21@dunlap-raymond.com,2020-12-19,https://www.cannon.com/
14-Dec-2020,Commission,00.00,"164,458.78","657,835.13",8611dCB2Dce80ad,6095,Brent,Dickson,Nolan PLC,Lake Marciashire,Czech Republic,079.424.6951x34200,(696)654-5355x56726,sheilagonzales@logan-meadows.com,2021-12-26,http://www.bryant.com/
14-Dec-2020,ATM,"22,183.90",00.00,"680,019.03",09ab9a7C04dfeEA,2063,Kathryn,Daniels,Gould PLC,Beanbury,New Caledonia,001-429-901-6553x40763,5228356751,deanna86@brennan.net,2021-05-11,https://mckee-fields.com/
14-Dec-2020,Debit Card,"65,791.75",00.00,"745,810.78",cA9Ffb8B1Db54dE,5300,Maureen,Singh,Spears Group,Hermanberg,Spain,+1-530-934-2008,333.270.7085,brandy28@foster.net,2020-10-03,https://www.mccall.com/
14-Dec-2020,Purchase,00.00,"186,452.70","559,358.08",00bcE7218Abf9ae,8496,Dennis,Collins,Gallegos-Grimes,Arthurchester,Mozambique,6607178773,+1-015-419-8529x96690,kristybarry@chaney.net,2020-10-03,http://wang.net/
14-Dec-2020,ATM,00.00,"79,908.30","479,449.78",aD2Fe51F22249Bd,5865,Christian,Townsend,Lindsey-Lawrence,Skinnertown,Thailand,568.590.8059x14579,(920)130-5020x3209,levimcdonald@shah.com,2021-11-03,http://www.holland.com/
14-Dec-2020,Bill,00.00,"119,862.45","359,587.34",F97f1ffBF7eD33E,453,Destiny,Snow,Duffy LLC,Brentshire,United States of America,873-940-1704x5312,(066)607-0041,alejandro05@bradshaw-chen.com,2020-10-18,https://weiss.com/
14-Dec-2020,Reversal,"535,465.00",00.00,"895,052.34",B2C56C6fAa2c343,3795,Mallory,Lowe,Hudson PLC,Gilesmouth,Northern Mariana Islands,001-796-220-1715x572,(428)226-8864,careylawrence@leblanc.com,2021-04-16,http://moran-hughes.biz/
14-Dec-2020,Purchase,00.00,"298,350.78","596,701.56",Ce24Bc9Ded4b17A,6353,Elaine,Barry,"Fields, Deleon and Davis",Frankfurt,Finland,+1-233-544-4972,104-719-7916x1695,calebvelasquez@dennis-mathews.com,2021-03-26,https://www.cherry-ryan.com/
14-Dec-2020,Debit Card,24.00,00.00,"596,725.56",Ee0A10B69EAEBB1,5685,Peter,Vargas,"Pena, Lin and Barrett",North Xavierfort,Belgium,001-543-969-0587x343,084-590-7198,rlawrence@hess-boyer.com,2022-04-28,http://www.ellis.com/
14-Dec-2020,Transfer,100.06,00.00,"596,825.62",E8F27Bb9e2bf1C6,3161,Duane,Ward,Torres LLC,East Patriciaborough,Heard Island and McDonald Islands,556-612-5431,123.125.5585x879,stacielittle@kirk.biz,2021-08-26,http://bernard.com/
14-Dec-2020,ATM,00.00,"198,941.87","397,883.75",f5E359A51AF6848,5700,Tiffany,Knapp,Stokes-Wu,Port Jeffreytown,Estonia,(853)182-6190x70008,511.917.3005x32663,rutharroyo@spears-lloyd.com,2022-03-12,http://ross-foley.com/
14-Dec-2020,Cash,00.00,"44,209.31","353,674.44",5cfDaaDdD638E6f,7718,Courtney,Ingram,Phillips-Oliver,New Sheryl,Uganda,028.777.2909,(711)575-0955,powellcassandra@mckee-andrews.com,2022-03-03,https://swanson.com/
14-Dec-2020,Miscellaneous,06.10,00.00,"353,680.54",ed69b06aC7c341d,101,Tammie,Strong,Wang LLC,Port Harold,Trinidad and Tobago,(290)848-7109,540.770.4481x964,carrillokenneth@bowman-montoya.com,2021-10-22,https://allison.info/
14-Dec-2020,Cash,00.00,"35,368.05","318,312.49",4244D72Ab6a5c2D,988,Lynn,Booth,Morton-Petty,Geraldtown,Peru,(111)338-4918,3474514709,david48@everett.info,2021-08-29,http://kirk-zhang.com/
14-Dec-2020,Debit Card,00.00,"318,312.49",00.00,bFBdC1cf26cecdF,1525,Darren,Murillo,"Martinez, Mccormick and Gilbert",Victoriaview,Kazakhstan,449.315.4450,+1-433-875-0164x46367,cassidykent@green.com,2021-05-15,http://roberson-gonzales.org/
14-Dec-2020,IMPS,"60,595.00",00.00,"60,595.00",0929F53A08faE52,6472,Tanya,Fuentes,Leonard-Hunt,Bobtown,Grenada,+1-302-340-3595x5894,(824)151-9119x448,isaiah58@burke.com,2021-09-08,https://hanson-wiley.com/
14-Dec-2020,Bill,402.86,00.00,"60,997.86",E6a9296fdE54341,3571,Misty,Walton,Hays-Oconnell,Meganbury,Poland,001-118-045-2810,315.990.6413x62913,dukecaitlin@lozano-gibbs.info,2021-04-04,https://www.hooper.com/
14-Dec-2020,Cash,450.00,00.00,"61,447.86",aEd04e38C0B9EA8,4696,Ebony,Ayala,Barker-Bowers,Guyberg,Guatemala,001-774-214-3901x313,570.254.0252,tracey40@koch.org,2020-10-26,http://bonilla-schneider.com/
14-Dec-2020,Miscellaneous,412.20,00.00,"61,860.06",8f22c9cA5a0bac0,1367,Kim,Terry,"Vargas, Roman and Washington",Port Sean,Solomon Islands,438.732.2394x185,7579914194,espinozamelissa@gutierrez.org,2020-04-01,https://underwood.com/
14-Dec-2020,Bill,00.00,"6,186.01","55,674.05",F7CFa3DA1a6Fceb,7881,Jeremiah,Brock,"Hart, Bates and Sanders",Port Kristenfurt,Malawi,001-741-915-9694x19681,001-531-716-1358x947,sally78@curry.net,2020-04-29,http://little.com/
14-Dec-2020,Miscellaneous,"1,264,011.50",00.00,"1,319,685.55",7da9fc73098CC9d,3610,Bob,Shea,"Clayton, Osborn and Vega",Piercefurt,Turkey,+1-511-068-9973x2682,534-500-3331x33804,mclayton@austin-brewer.com,2021-07-31,http://young-ibarra.info/
14-Dec-2020,NEFT,00.00,"219,947.59","1,099,737.96",aC3CC586cfEbF6B,6802,Latoya,Avila,Cuevas-Boyer,Lake Erikfort,Pakistan,593.570.1320x32993,(229)029-5391,anthonyfischer@yoder.info,2021-11-01,https://www.herring.com/
14-Dec-2020,IMPS,"2,797.00",00.00,"1,102,534.96",aBcaaa9B6Fe122D,6374,Diamond,Reed,"Glover, Wyatt and Shaw",Brooksburgh,Liechtenstein,124.257.8120,(296)790-0002,pollardamy@parker.com,2022-05-27,https://lindsey-spencer.com/
14-Dec-2020,Reversal,"1,160,441.00",00.00,"2,262,975.96",0AfaB4ede8Fc6E7,1110,Corey,Cuevas,Blackwell Ltd,New Kara,Bangladesh,001-191-353-7628x2389,+1-991-856-6435,carl90@munoz.org,2020-04-10,https://www.hobbs.com/
14-Dec-2020,ATM,28.80,00.00,"2,263,004.76",0ca826f0ab0baA9,5214,Thomas,Chung,Dodson PLC,Shermanville,British Virgin Islands,(195)060-3690x9690,902.658.8926,darryl22@jones.biz,2021-01-11,https://www.terry.com/
14-Dec-2020,Tax,07.00,00.00,"2,263,011.76",7eDeE5dBFEaBD9C,5838,Jasmin,Cuevas,Wyatt-Walter,Orozcoshire,Kiribati,(905)027-3698x19725,001-341-012-5973x197,staffordsavannah@jarvis.org,2022-04-24,http://www.rojas-reeves.biz/
15-Dec-2020,RTGS,35.80,00.00,"2,263,047.56",5eFC3E915B0FC4D,4410,Melissa,Newton,Zhang and Sons,West Dalefort,Puerto Rico,200-172-7254x6513,373.330.0545,bobwood@terry-travis.com,2021-08-21,https://www.holden-pugh.net/
15-Dec-2020,Cheque,"693,771.75",00.00,"2,956,819.31",afdB01fb4CC3ebe,3730,Betty,Peck,"Vincent, Nichols and Hebert",North Darryl,Myanmar,654-694-7354,919.785.8208x4390,freemanjenna@carey-quinn.org,2020-07-27,https://www.wu.biz/
15-Dec-2020,Interest,818.00,00.00,"2,957,637.31",d07882386D90Af8,1794,Julia,Williamson,"Murray, Jennings and Mccarty",Moorefurt,Cote d'Ivoire,+1-000-610-1378x37842,913-094-6948,cassiesilva@patton-edwards.com,2022-04-10,http://www.mejia.com/
15-Dec-2020,Cheque,62.80,00.00,"2,957,700.11",f0d9CaAb9d8cfbe,4177,Danielle,Rocha,Flores-Scott,West Isaiah,Portugal,+1-078-800-5568x2810,(364)182-2597x901,raybrandt@meyer.info,2021-02-19,http://www.bonilla-hays.info/
15-Dec-2020,Debit Card,00.00,"591,540.02","2,366,160.09",F43Da0d8ca5C741,4405,Martin,Roman,"Scott, Brennan and Morris",Port Marisa,Guam,(018)085-0587,523.683.8485,cameronmason@mcmahon.com,2021-07-09,http://chavez.com/
15-Dec-2020,Tax,"896,958.75",00.00,"3,263,118.84",E9Bc41A88ED6D6b,5029,Terri,Fowler,"Bradley, Buckley and Frye",New Connie,Djibouti,(266)274-4481x818,050-135-3611,xholmes@davidson.biz,2021-10-11,http://www.jimenez-singleton.com/
15-Dec-2020,Cheque,00.00,"407,889.86","2,855,228.98",F68eDCB42Bdc4BC,7265,Tonya,Figueroa,"Schultz, Wilson and Collins",Cathyport,Namibia,040-734-1331x554,001-016-768-2386x2816,priscillali@adams.com,2020-01-29,https://www.mooney.com/
15-Dec-2020,ATM,00.00,"475,871.50","2,379,357.48",fd14D2d6dDad2F3,9363,Michael,Avery,Bailey LLC,North Miashire,Haiti,+1-680-279-3048x13605,(612)854-1328x7458,turnermelissa@lam.com,2020-11-14,http://www.small-meyer.net/
16-Dec-2020,IMPS,00.00,"396,559.58","1,982,797.90",977DEacE80FEbb4,8263,Derrick,Hurst,Ho PLC,Rodneychester,Bermuda,7531749308,863.688.5049,sherriroth@padilla-wilkins.com,2021-06-15,https://www.cook-fischer.com/
16-Dec-2020,ATM,02.90,00.00,"1,982,800.80",cb4F18Ba4B81649,2567,Stanley,Rush,"Singleton, Callahan and Harmon",North Greggmouth,Bahamas,948-508-5700x38342,7518505348,skirby@patton.com,2020-01-11,https://ross-wilkins.net/
16-Dec-2020,Cheque,00.00,"247,850.10","1,734,950.70",Fb6Da7d46CE88e3,217,Eric,Mitchell,Shannon-Valencia,East Jo,American Samoa,(880)412-2558x97593,692-203-8338,lauren64@faulkner-hood.info,2020-12-05,http://mckee.com/
16-Dec-2020,Commission,18.00,00.00,"1,734,968.70",be59c970A678b8E,9550,Jo,Patrick,"Bailey, Phelps and Mason",North Seth,French Guiana,(999)181-1994x26851,(021)841-5459x3552,pchoi@nelson-burke.com,2020-08-02,https://www.levy.com/
16-Dec-2020,Interest,"1,860,481.00",00.00,"3,595,449.70",D3bfA7A69f8cFe2,4669,Collin,Campbell,Church-Charles,Port Scott,Chad,919-517-8971x059,386.130.6874x24713,elijahlozano@cole-roman.biz,2022-03-12,http://www.cardenas-garrison.org/
16-Dec-2020,Tax,03.80,00.00,"3,595,453.50",bEcb134FeCc4fD5,1548,Kenneth,Harris,Marks-Farmer,Port Brandy,Macedonia,774-937-5625x89638,408-223-4142x1543,blake59@jefferson.com,2022-01-10,https://www.marquez.net/
16-Dec-2020,Tax,00.00,"399,494.83","3,195,958.67",9cbAfF926Ca1279,636,Charles,Bartlett,Hull-Reese,Conwayshire,Montenegro,352.231.2266,+1-183-553-1609x045,dwaynewarner@graves.com,2020-04-19,https://walton-huerta.biz/
16-Dec-2020,Interest,"2,210.74",00.00,"3,198,169.41",4Fc2AE0D62a61aB,5612,Mercedes,Mayo,Morris LLC,South Kaitlinview,Central African Republic,+1-874-931-8666x26485,475.558.4079x495,harrycarey@mccarty.com,2020-08-02,http://dominguez.com/
16-Dec-2020,NEFT,560.90,00.00,"3,198,730.31",aD7FCD2FB05E924,9365,Haley,Zimmerman,Meyer-Everett,New Eugene,Montserrat,(447)094-8199x46204,(726)482-5634x380,kurt02@harris.info,2020-05-03,http://olson.com/
16-Dec-2020,Cash,"14,626.37",00.00,"3,213,356.68",D7D38b0a3013D5A,4380,Grant,Shea,"Buck, Wong and Duncan",East Daniellechester,Bahrain,001-928-562-0609x070,(726)618-2094,vangcorey@hines-murphy.com,2020-12-11,https://www.barnes.com/
16-Dec-2020,Transfer,"216,729.70",00.00,"3,430,086.38",0F6E13dc86e8e7A,9602,Curtis,Johnston,Mitchell-Montes,North Staciemouth,Brazil,+1-471-189-1356,701.172.2585x1906,knappmindy@johnston.org,2021-09-10,https://www.murray-roth.biz/
16-Dec-2020,Reversal,359.70,00.00,"3,430,446.08",beDDbdf4BD0ADcc,7371,Damon,Reeves,Bryant PLC,Lindsayview,Algeria,(173)197-2970x388,+1-069-376-1558x334,john91@marshall-zhang.com,2022-03-17,https://santos-lutz.com/
16-Dec-2020,RTGS,"26,022.86",00.00,"3,456,468.94",0eDfe821cE6611C,3378,Douglas,Decker,"Haas, Watts and Castillo",Suareztown,Austria,+1-939-214-2463x3091,001-674-540-0265x2389,pruittshelby@mcpherson-drake.com,2021-01-10,https://www.dickerson-holloway.net/
16-Dec-2020,Cheque,"25,331.20",00.00,"3,481,800.14",8b7dd3663ca8210,986,Earl,Reid,"Singh, Miller and Golden",West Lancestad,El Salvador,(304)401-6534,(579)946-4417x338,wayne62@jennings-burnett.com,2020-09-16,http://www.salas-gross.biz/
16-Dec-2020,Bill,00.00,"870,450.04","2,611,350.10",C1A251F9B2a7C0b,4649,Vicki,Christensen,"Solomon, Smith and Dickson",East Glen,Liberia,727.088.6580x148,001-798-600-9417x297,jasminmoreno@terrell-cunningham.com,2021-06-12,https://www.neal-fleming.biz/
16-Dec-2020,NEFT,00.00,"326,418.76","2,284,931.34",E0afC96Db355d3d,8651,Harry,Downs,Gamble LLC,Davisborough,Congo,707.775.2580x0844,168.256.4777x8926,ltrujillo@castaneda.com,2020-06-20,http://murphy.net/
16-Dec-2020,ATM,"1,763,138.00",00.00,"4,048,069.34",BeB75D98261CFE9,5563,Wayne,Gallegos,Graves-Vaughan,Liuborough,Greece,+1-341-876-2824x2122,(975)476-1003x6771,alanpayne@wilkins-goodwin.com,2020-05-11,http://love.biz/
16-Dec-2020,RTGS,00.00,"1,349,356.45","2,698,712.89",2b6d11f4b7317Df,4185,Isabel,Mercado,"Daniels, Brown and Chen",Paceview,Palau,001-493-878-3213x96767,871.513.2204,gwendolyn12@stevenson.org,2022-01-12,http://www.ellison.com/
16-Dec-2020,Reversal,04.30,00.00,"2,698,717.19",78CD5Fcb6c37843,4635,Amber,Clarke,Velez PLC,West Keithstad,Korea,(379)588-3043,150-165-5209,dburns@santiago.org,2022-01-21,http://thompson-patterson.com/
16-Dec-2020,Commission,48.00,00.00,"2,698,765.19",F7c6EFB87beeF1B,3461,Robin,Jones,Banks-Barnett,North Wandachester,Fiji,602.324.8275,001-876-081-7620x5027,iyoung@turner.com,2021-05-05,http://white.com/
16-Dec-2020,Miscellaneous,00.00,"899,588.40","1,799,176.79",88881cFbE0bAb96,7167,Leslie,Norris,Maynard-Cooke,South Shannonburgh,Albania,001-980-647-4181x913,388-168-9888x278,bailey65@dunn-carter.com,2022-02-05,https://www.barrett.org/
16-Dec-2020,Debit Card,00.00,"257,025.26","1,542,151.53",6B2f0ADf2b1bAd2,106,Misty,Sanchez,"Soto, Wheeler and Baker",Lake Bobberg,Vietnam,+1-871-796-6526x1655,671-320-4275,joconnor@cooley.com,2021-07-09,https://jones.com/
16-Dec-2020,Commission,290.00,00.00,"1,542,441.53",2CF975b751Db0Cf,7729,Tammie,Peterson,Lamb Ltd,Salinashaven,Palestinian Territory,(732)832-6458x43282,763-662-8626x542,dodsonkirk@clarke.org,2022-03-20,http://frye-garcia.biz/
16-Dec-2020,Reversal,00.00,"385,610.38","1,156,831.15",DBada96b18B3f8b,8443,Isabel,Nichols,Melton-Moody,South Ryanstad,Syrian Arab Republic,362.834.1012,831.756.2107x506,petersroger@henry.info,2021-02-10,http://mullen-moore.com/
16-Dec-2020,Cash,02.40,00.00,"1,156,833.55",c29cFACFFec3b2A,8054,Jim,Arellano,Mcgrath Inc,Russoborough,Isle of Man,6272692847,7069842909,jkaufman@holt.com,2020-12-24,https://www.bond.com/
16-Dec-2020,RTGS,53.04,00.00,"1,156,886.59",EeA3D31aDAE09ea,896,Jaime,Williamson,"Warren, Palmer and Walter",North Chloe,Austria,942.896.0798x321,+1-388-636-8570x9629,yvonneford@shields.com,2021-02-19,https://www.clayton.info/
16-Dec-2020,NEFT,248.00,00.00,"1,157,134.59",73B9332DFa56A53,5802,Joyce,Gillespie,"House, Cherry and Villarreal",East Beverly,Central African Republic,057.025.8945x209,589-302-6922x0375,nicholsmarc@anthony-anderson.com,2021-11-13,https://www.tucker-case.com/
16-Dec-2020,RTGS,00.00,"578,567.30","578,567.30",14abfB44C5F38DC,3776,Kenneth,Li,Ball LLC,New Clifford,Azerbaijan,001-627-749-7814x8640,+1-695-037-5618x756,isabella25@williamson.net,2020-07-03,http://harding.com/
16-Dec-2020,Transfer,00.00,"115,713.46","462,853.84",Db050dAb0ae034e,670,Sue,Rosario,"Lynn, Ferrell and Arellano",Traceyton,Christmas Island,184.098.0261x25985,(237)533-8675x80608,angie33@anderson-huber.com,2021-08-10,https://adkins.com/
16-Dec-2020,Purchase,"2,697.90",00.00,"465,551.74",6baB4aA113eB446,5521,Shelley,Phelps,"Riggs, Contreras and Allen",South Steve,Netherlands,275.069.6731,779.885.2413x25416,dominic75@may.com,2022-05-08,http://www.avila.com/
16-Dec-2020,RTGS,00.00,"155,183.91","310,367.83",87E1A3fDfEe4813,7171,Jaclyn,Short,Hutchinson Group,Donberg,Marshall Islands,969-209-6592,(387)971-2383x590,jbarron@bradford.com,2021-03-22,https://mann.biz/
16-Dec-2020,Cheque,04.88,00.00,"310,372.71",A77fc8e7C585cCf,4388,Mary,Stein,Henderson-Duran,Lake Matthew,Barbados,+1-119-575-2988x057,(516)713-0024,odunn@haley.com,2021-10-03,http://patterson.com/
16-Dec-2020,Cash,03.35,00.00,"310,376.06",cB5bF4B1e78Ecda,412,Kevin,Munoz,Knapp-Bernard,Castanedamouth,Seychelles,(858)198-9773x6361,020-176-9382,eboyer@hebert-rosario.info,2021-02-13,https://www.cohen.com/
16-Dec-2020,Purchase,"71,909.22",00.00,"382,285.28",f8CCf2BFf6AbEbb,2974,Dominic,Salas,Cobb Ltd,North Jerry,Palestinian Territory,441.295.7488x00063,603-385-8247x731,rodneylin@romero.com,2021-05-29,http://www.bolton.com/
16-Dec-2020,Commission,"10,058.24",00.00,"392,343.52",a7EEA9653B26f7A,1490,Dakota,Beltran,Rhodes Ltd,Jaredberg,Chile,7406557525,+1-827-770-4844x72130,kathleen80@fernandez-noble.org,2021-12-03,https://www.david-clarke.com/
16-Dec-2020,Miscellaneous,00.00,"39,234.35","353,109.17",FcF1EEFABe6e012,133,Carolyn,Byrd,Simon-Walton,Ethanberg,Burundi,+1-950-053-4045x2170,+1-760-012-4288,alisonsanders@durham.com,2020-04-26,https://www.mack.biz/
16-Dec-2020,Commission,857.00,00.00,"353,966.17",Cef3AEf6c0e66FF,795,Tracey,Costa,Harmon-Graves,East Brendanbury,New Caledonia,611-021-3027x21053,440-140-6605,qrandolph@poole.com,2020-03-09,http://www.lawrence.com/
16-Dec-2020,ATM,"169,315.60",00.00,"523,281.77",e19aB3CA335EdCa,3092,Teresa,Blanchard,Bates Group,South Prestonbury,Cayman Islands,+1-530-940-9484x625,0525759904,bryce97@weeks-brennan.com,2020-03-14,http://www.mckee.com/
16-Dec-2020,Transfer,"21,297.00",00.00,"544,578.77",02dAf091a8B7a64,4051,Jacqueline,Byrd,"Gill, Koch and Long",New Staciefort,Comoros,001-655-736-1174,001-708-639-5390x74540,cassidyking@shelton-mcgee.info,2021-12-25,https://www.logan.com/
16-Dec-2020,Purchase,00.00,"181,526.26","363,052.51",1Ab8F1e061B6A5c,9711,Miranda,Sims,Washington Group,North Harry,Suriname,106-077-1924x46701,474-678-8887x0558,claire16@ball.com,2020-07-05,https://cain.com/
16-Dec-2020,Commission,03.00,00.00,"363,055.51",Db6a5ade5F16D99,4597,Shawn,Everett,Cain Ltd,South Jerome,Peru,523-003-1733x2400,304.325.7095x929,qsnyder@collier.org,2020-04-21,https://day.com/
16-Dec-2020,IMPS,00.00,"363,055.51",00.00,FBDdc4dc9f2dDe3,9703,Manuel,Rush,"Wise, Mora and Phelps",Gabriellaton,Syrian Arab Republic,001-745-870-2204,781.772.2155x5319,matthew59@mcguire-ross.com,2022-05-09,https://robbins-peck.com/
16-Dec-2020,Interest,00.00,00.00,00.00,BA880CAeF9bcCe2,4263,Preston,Adams,"Oconnor, Brown and Nash",Debraview,Costa Rica,7566662510,5103729025,kirstenberger@strong-wallace.com,2021-09-15,https://parrish-cunningham.com/
16-Dec-2020,RTGS,246.80,00.00,246.80,B0fecEcD5b24d6A,623,Jill,Saunders,Haney-Lutz,Port Jasmin,Liberia,+1-791-579-4498x189,500.536.6575,riveraleah@caldwell.com,2020-10-06,https://www.rivas.org/
16-Dec-2020,Tax,00.00,30.85,215.95,EDF84b2D3f452d7,1848,Lisa,Norton,"Beck, Sharp and Waller",Bentleyland,Maldives,681.119.3503x195,064.571.4165,jherring@gates.com,2021-04-13,https://www.butler.com/
16-Dec-2020,NEFT,00.00,30.85,185.10,8D56C41cEDD7fba,1333,Sherri,Hunter,Santos PLC,Lake Douglas,Croatia,+1-594-593-7132x27679,576-660-1577,czuniga@oconnor.com,2020-07-12,https://www.smith.com/
16-Dec-2020,Cheque,00.00,46.28,138.82,946E6faF3c22a9C,9568,Beverly,Chung,Sims PLC,Houstonfurt,Lebanon,(072)076-8034x9717,(590)759-3528,bradleyyolanda@mccullough.info,2020-03-09,http://www.golden-cobb.com/
16-Dec-2020,NEFT,"54,511.00",00.00,"54,649.82",4EbDcCBAfd5bBDF,5977,Kaitlyn,Medina,"Gilmore, Costa and Pham",Tanyaview,Botswana,946.775.7259x697,001-582-182-5971x29965,suzanne81@bush-kane.com,2020-03-15,https://www.bowers.com/
16-Dec-2020,Interest,00.00,"9,108.30","45,541.52",ABA6f356ebfeAcE,8851,Cathy,Marquez,Reed Ltd,West Connor,Malawi,001-032-736-3590x45349,800-949-3297x81634,paigeward@orozco-francis.com,2021-10-23,http://www.hudson-santiago.com/
16-Dec-2020,RTGS,"241,238.72",00.00,"286,780.24",f9EFAC82DFeFbAB,7491,Kathy,Perez,"Jacobs, Andrade and Burton",Port Megan,Mauritius,001-719-685-9164x25826,(246)738-8274x495,cynthiagalloway@bonilla.com,2020-01-25,http://rollins-wang.com/
16-Dec-2020,Debit Card,00.00,"71,695.06","215,085.18",6696Ab85adDD2dA,9110,Larry,Vang,Wise Ltd,Stanleytown,Tuvalu,(424)344-4954,+1-177-350-9540x0321,lloydarthur@warner.com,2020-05-09,https://french-valentine.com/
16-Dec-2020,Tax,"36,227.00",00.00,"251,312.18",a0Ce8E2C0eFA2Ad,3857,Laura,Hoover,Turner Inc,Lake Marcusborough,Mauritania,399-764-5395,444.966.0012,hayley44@ellis.info,2021-01-04,http://www.roy.com/
16-Dec-2020,Debit Card,38.00,00.00,"251,350.18",9BAe4DED6250e85,861,Madison,Dixon,"Reyes, Mcconnell and Hamilton",Heathertown,Puerto Rico,2813885005,3301661072,william98@barr-pearson.com,2022-05-21,http://www.rivers-osborne.com/
16-Dec-2020,Cheque,41.07,00.00,"251,391.25",6Ec287E31b2e71a,4292,Kristen,Singh,Riddle-Bautista,Ariasberg,India,001-102-883-6491x43981,827.700.4983,daltonsheri@aguilar.com,2020-07-07,https://www.waters.net/
16-Dec-2020,Purchase,00.00,"83,797.08","167,594.17",bBcEe7a25676EdA,9149,Madison,Nunez,Hurley Inc,Audreyview,Liberia,001-594-583-0165,900-767-8433x89251,blankenshipsierra@rios.org,2020-03-02,http://brady.net/
16-Dec-2020,RTGS,"139,499.80",00.00,"307,093.97",4b8BfCd1cf834F2,5254,Raven,Walters,"Nunez, Weeks and Ingram",New Jorge,Bouvet Island (Bouvetoya),001-958-462-0151x591,475-847-5692x4151,rasmussenjeremiah@huber-mccullough.org,2020-01-31,http://richmond-good.org/
17-Dec-2020,IMPS,00.00,"38,386.75","268,707.22",8bEfF473c4b5C6f,7321,Desiree,Crane,"Johnson, Choi and Hinton",Reneeburgh,Ecuador,055-864-2672x243,8462917376,diamondpatterson@hardy-terrell.com,2021-07-18,http://www.morton.com/
17-Dec-2020,Debit Card,00.00,"33,588.40","235,118.82",5fBDE5cDc5F4B96,3499,Angel,Kim,Fox-Conrad,Thomasshire,Oman,635.882.8193x809,001-406-615-9671x81681,tomhall@kline.com,2021-08-25,http://www.grant.com/
17-Dec-2020,Interest,"8,715.30",00.00,"243,834.12",F551BAbe8F4ACcd,7059,Gregory,Mcbride,Joseph Inc,Meghanburgh,Saint Lucia,(321)894-9871x0621,304.266.9175,williamsonyvette@hayes-simpson.com,2020-03-06,https://www.kane.com/
17-Dec-2020,Cash,00.00,"30,479.27","213,354.86",e090f2CAF78D1fa,2497,Erica,Sloan,Rowland LLC,West Noahview,Botswana,+1-092-286-3619x944,001-666-132-2734x6100,hendrixshelby@gallagher-villanueva.com,2021-12-15,http://vargas.com/
17-Dec-2020,ATM,"31,518.00",00.00,"244,872.86",b700f7Ec36DDcAd,3264,Robyn,Hill,"Hoover, Jacobson and Santana",New Andre,Montenegro,+1-694-562-0057x3452,+1-263-753-1926,allenjoel@kennedy.com,2021-05-23,http://www.allen-mccall.com/
17-Dec-2020,NEFT,03.00,00.00,"244,875.86",8Ee9bdeC8A1E3AD,609,Sydney,Davidson,"Mendez, Whitney and Mooney",Ferrellberg,Malawi,736.279.3232x66035,+1-429-493-5414x7234,hatfieldcynthia@calhoun.info,2022-05-15,https://www.ford.com/
18-Dec-2020,Tax,235.00,00.00,"245,110.86",e4Eaea346DB60Fc,7595,Diamond,Burton,Stone-Waters,South Diamondside,Botswana,(004)111-3109x04787,001-957-148-3874,vramirez@rush.com,2021-04-16,http://www.decker.com/
18-Dec-2020,RTGS,"2,616.90",00.00,"247,727.76",dAc7Ae97cDba29C,9380,Brittany,Arnold,Roberts-Hart,North Ethanport,Peru,1970702822,(700)509-0376x64227,edickson@vaughn.org,2021-07-05,https://gutierrez.com/
18-Dec-2020,Cheque,05.67,00.00,"247,733.43",5CB0De5F9dCCDff,7008,Madeline,Barnes,Orozco Inc,New Kerry,Gambia,006.539.0727,(438)553-6489,emilyschwartz@levy.com,2021-10-14,http://www.hernandez-rose.com/
18-Dec-2020,Cash,00.00,"27,525.94","220,207.49",7B63C90d01DB0F8,1722,Connor,Serrano,"Solis, Fields and Paul",North Jimmyfort,Mayotte,745-360-7320,5115516988,olivia37@phelps.com,2021-03-31,https://french.com/
18-Dec-2020,NEFT,"4,604.94",00.00,"224,812.43",4EA04B80A5fc7fD,8642,Jacqueline,George,Murphy Ltd,Stacyport,Cameroon,273-598-2082,(849)313-1804,megancraig@bowen.com,2021-03-21,http://www.brandt.com/
18-Dec-2020,Tax,16.70,00.00,"224,829.13",bD6157314Fe60FF,5414,Ariel,Shah,"Leach, Cross and Douglas",East Leemouth,Sweden,7651722701,633-226-5643x4922,shelbypennington@holt-winters.com,2020-12-22,https://tate.com/
18-Dec-2020,Reversal,00.00,"56,207.28","168,621.85",Fa1bf4A5aDb3AE6,9042,Laurie,Blackburn,"Holt, Meyers and Sharp",Beckytown,Argentina,7275517486,230-110-7181x574,chenselena@cochran-fuller.info,2021-03-31,https://washington-brewer.com/
18-Dec-2020,Commission,276.10,00.00,"168,897.95",68f72aBD8AFBA5b,3600,Barry,Barr,"Petersen, Bass and Davila",Lake Erinchester,Philippines,001-180-847-7273x77247,1597433083,ernest35@ochoa.com,2020-06-12,https://www.mcfarland-bender.com/
18-Dec-2020,Reversal,00.00,"18,766.44","150,131.51",2fbFf0e597c0665,4786,Frances,Bryan,Lloyd-Murray,Port Vickitown,Kiribati,017-109-9484x8401,001-512-990-7737,hmercado@york.com,2022-04-25,http://www.lopez.biz/
18-Dec-2020,Debit Card,"345,770.25",00.00,"495,901.76",4EECdbcDce6C4fC,1825,Dennis,Bailey,Conley Inc,West Desireebury,South Africa,001-194-904-0576x4632,001-845-191-8517x8250,roykelli@huang.com,2020-11-23,https://www.stanton-strickland.com/
18-Dec-2020,Interest,00.00,"70,843.11","425,058.65",0f769DC4FdB0c1D,3838,Mary,Duffy,Caldwell-Kelley,Audreyborough,Lao People's Democratic Republic,+1-022-004-3995x8343,001-692-908-5867,tcummings@barr.org,2021-12-05,http://www.olson.com/
18-Dec-2020,Miscellaneous,"16,859.12",00.00,"441,917.77",1C4B0BfBDe9f77c,2290,Lori,Lam,Meadows-Fitzpatrick,Jaredstad,Cyprus,790-809-6196x3115,001-635-155-8772x7234,haleygabriella@roth-nixon.net,2021-04-08,https://montgomery.info/
18-Dec-2020,Interest,00.00,"441,917.77",00.00,C3Ac9a163b9b4F2,1540,Kellie,Fitzgerald,Potts-Cooke,North Stephanie,Madagascar,244-736-2987,6771263984,rchaney@stout.com,2020-01-12,http://browning.com/
18-Dec-2020,Reversal,00.00,00.00,00.00,badfbbcD8EC3f16,1234,Audrey,Escobar,Brady-Taylor,Port Greg,Mayotte,+1-630-541-6954x2007,847.303.7671,swarner@young.com,2020-07-26,http://www.mckenzie-mahoney.com/
18-Dec-2020,Purchase,"1,131,879.00",00.00,"1,131,879.00",f20a7dcbD2AF1F6,5305,Norman,Ortega,"Lindsey, Simmons and Ponce",Kerrburgh,Saint Martin,+1-764-805-7030,+1-379-526-5536x48893,bglover@mcdonald.org,2020-06-07,https://www.wise-lamb.biz/
19-Dec-2020,Interest,"2,026.50",00.00,"1,133,905.50",9f6C1EF41E03EB1,1012,Lindsey,Houston,"Avila, Barton and Weeks",West Kathyburgh,Trinidad and Tobago,+1-948-118-2481x570,544.609.2502x38377,kelly48@cantrell-grimes.com,2020-04-15,https://monroe-oliver.com/
19-Dec-2020,Interest,262.00,00.00,"1,134,167.50",Df12bAEF5EE5baf,3966,Autumn,Galloway,Keller-Quinn,Port Lori,Maldives,001-908-885-5126,714-532-9173x425,gordonabbott@carson-robles.com,2020-09-06,http://perkins.com/
19-Dec-2020,NEFT,510.40,00.00,"1,134,677.90",A8BCD5969FacBF7,9250,Edwin,Harrison,Hall-Mcgrath,Kristyville,Armenia,+1-600-634-9836x70055,+1-652-685-6293x7221,dennisstefanie@ortiz.com,2022-03-15,https://larsen.com/
19-Dec-2020,NEFT,00.00,"567,338.95","567,338.95",CBcfFC286FDc461,356,Rebekah,Barnes,Arias-Montgomery,Bethanytown,Pakistan,(472)810-4201,306-531-6684x302,christianmata@gates.com,2021-02-17,http://patel.biz/
19-Dec-2020,Cash,35.81,00.00,"567,374.76",cFd7092AfDAb56D,2705,Dakota,Bowman,Dougherty Ltd,Lake Kathryn,Canada,(045)978-7376x06315,(372)988-1114x15353,wongelizabeth@bentley.org,2021-01-31,https://www.mcconnell.com/
19-Dec-2020,RTGS,"46,258.40",00.00,"613,633.16",15B07b57eca7dcf,8425,Micheal,Flynn,Wheeler-Sampson,Walterburgh,United States Minor Outlying Islands,(327)939-7358x324,328-273-5007,gravesariel@white.com,2021-11-19,https://donovan-odonnell.com/
19-Dec-2020,Purchase,29.00,00.00,"613,662.16",ecB2192674da4Ce,8399,Jeffrey,Monroe,"Melton, Pittman and Harmon",Wallaceview,Turkmenistan,001-102-847-1317,+1-425-537-7014,gary73@chang.com,2021-10-04,http://www.stephenson-collier.com/
19-Dec-2020,Interest,"154,307.60",00.00,"767,969.76",f7BDdB36bA829dA,6306,Seth,Payne,"Moses, Guzman and Harvey",Kiddchester,Pitcairn Islands,666-688-9844,001-365-538-1550x222,dcardenas@tanner-rush.biz,2020-12-25,http://morrison.com/
19-Dec-2020,RTGS,39.00,00.00,"768,008.76",BdB0e3D5a0De8a7,4509,Kayla,Pineda,Mccarthy-Tran,Haroldville,Finland,148-988-3788x6603,001-798-980-9733x6788,maryblackburn@zamora-duffy.info,2021-12-27,http://www.scott-ruiz.com/
19-Dec-2020,ATM,00.00,"96,001.10","672,007.66",82a510CA31C1Fe5,9617,Christine,Moses,Hahn Ltd,South Sonya,Pitcairn Islands,741.726.9154x017,(757)441-5891x988,osborntanya@juarez.com,2021-11-07,https://banks-dougherty.biz/
19-Dec-2020,Debit Card,00.00,"224,002.55","448,005.11",9c6b6C3b6a74c81,9105,Sean,Carlson,Kelly Group,Darrellfort,Reunion,4059279575,2427188099,kenneth00@wagner.com,2020-01-19,http://wilkerson-myers.net/
19-Dec-2020,Reversal,"161,693.00",00.00,"609,698.11",89Aa2b94dC05FB1,7612,Ross,Pham,Gentry-Soto,Port Tasha,Peru,001-339-302-4307x5895,001-333-586-7546x064,woodardjoe@keller.org,2020-10-12,https://blackwell.com/
19-Dec-2020,Commission,00.00,"60,969.81","548,728.30",d23Fad10DfBddF8,8669,Mackenzie,Cross,Jimenez LLC,South Javier,Bhutan,312-070-9923x2026,857-298-0834x76153,wjimenez@arnold-maxwell.com,2020-01-03,https://www.schmidt.net/
19-Dec-2020,Transfer,00.00,"182,909.43","365,818.87",Ca492c76A52Da9F,67,Kelli,Bridges,"Black, Richardson and Sandoval",Lake Aaron,Mongolia,5657167326,220.834.4618x14578,daisyblair@walsh-holmes.org,2021-12-05,https://www.trevino.info/
19-Dec-2020,Purchase,00.00,"91,454.72","274,364.15",a99e0D7beEb41A0,5785,Jeanette,Ruiz,"Daniel, Paul and Ferrell",West Loritown,Brazil,001-429-647-7042x5700,+1-457-870-4026,zoe13@levine-hebert.com,2021-09-07,https://www.shields-bryan.com/
19-Dec-2020,Cash,"205,738.40",00.00,"480,102.55",D3Ad7c5856dbEfd,5919,Rhonda,Lutz,Arnold PLC,East Erik,Uganda,(050)579-3402,800.156.9570,christensenmackenzie@gay-zhang.com,2022-04-18,http://hebert-mercer.info/
19-Dec-2020,Tax,00.00,"96,020.51","384,082.04",ECaf5CD6fAe10c9,8475,Anita,Flowers,Pollard-Charles,West Jamie,Egypt,999-815-5834x6421,+1-938-285-0457x792,alan18@scott-villanueva.com,2020-08-21,https://monroe.com/
19-Dec-2020,RTGS,00.00,"96,020.51","288,061.53",051cb9dc53BC7Cc,8978,Rachel,Nguyen,"Estes, Alexander and Henderson",Tammieside,Vanuatu,(564)993-0418,+1-217-334-1877x34270,lorettaharmon@serrano-caldwell.org,2021-05-11,https://davidson-velazquez.org/
19-Dec-2020,ATM,00.00,"72,015.38","216,046.15",Acdac3A1Dd8831a,5971,Travis,Clements,Velasquez-Shannon,Cheyenneton,Trinidad and Tobago,+1-779-554-8082x01804,(640)474-1656x9918,travisreginald@ochoa.info,2021-04-10,https://cline-salinas.org/
19-Dec-2020,Debit Card,00.00,"108,023.08","108,023.08",128aB9ca17FCcF8,6982,Leah,Yu,"French, Riley and Lee",South Kellyfort,Palestinian Territory,+1-039-248-2513x8095,001-505-600-6588x36904,rbates@webster-mcintyre.com,2020-01-03,http://wiggins.com/
19-Dec-2020,Purchase,00.00,"13,502.89","94,520.20",cF69E415A7aACea,5937,Faith,Nixon,"Knight, Mora and Barrera",New Victoriaport,Palau,645-039-5402x265,(995)935-8539x1007,kentward@hooper-wong.com,2022-03-05,https://www.jordan-rubio.biz/
20-Dec-2020,Debit Card,00.00,"13,502.89","81,017.31",5CafBaecA4D78ea,4674,Darren,Dudley,"Bowen, Ho and Mays",South Dorisberg,South Georgia and the South Sandwich Islands,642-370-5582,(613)162-6050x25919,zoe41@bray.com,2020-03-11,http://www.grant.com/
21-Dec-2020,Reversal,00.00,"9,001.92","72,015.39",B2c9Fae7DfbE4cA,1520,Sandy,Carlson,"Berg, Miles and Gamble",South Melodyburgh,Marshall Islands,+1-266-483-6070,001-804-702-3280x77623,curtis04@gomez.biz,2021-04-20,http://www.sanders.biz/
21-Dec-2020,Bill,00.00,"10,287.91","61,727.48",43b624ad3BEB86F,7960,Toni,Hester,Gonzales-Arias,Carsonland,Saint Pierre and Miquelon,001-580-863-3359x4420,001-670-919-4323x47851,rowlandsandy@schwartz.com,2020-12-19,https://www.woodard.com/
21-Dec-2020,ATM,00.00,"6,172.75","55,554.73",25EfF0BcbDFdFf4,2876,Tasha,Hammond,Dawson-Mays,Andresfurt,Finland,036-640-2022x77716,+1-098-102-2625x1043,lukemaynard@harvey.com,2021-01-07,http://fitzgerald.org/
21-Dec-2020,Miscellaneous,00.00,"5,555.47","49,999.26",c00E78BA78Ade7A,6223,Angela,Schneider,Madden PLC,Vasquezfort,Armenia,521-209-3743,652.119.4974x69809,harrellcaroline@cortez-espinoza.com,2020-10-31,https://www.jenkins.info/
21-Dec-2020,ATM,00.00,"4,999.93","44,999.33",fe3fB3f0ad8Dd0C,7956,Judith,Hess,Williams LLC,Dayfurt,New Caledonia,001-710-314-4012x7406,383-854-4664x11982,calvinnewman@villarreal.biz,2021-05-10,https://guerra.com/
21-Dec-2020,Tax,00.00,"4,999.93","39,999.40",AA7E26a19e3Adea,7901,Calvin,Casey,Rogers PLC,Garyside,Central African Republic,+1-145-803-2986x264,+1-366-812-8076x93270,lgarner@knapp.biz,2021-07-09,https://chavez.net/
21-Dec-2020,Miscellaneous,00.00,"6,666.57","33,332.83",853D8f80cFcD7bf,2601,Tony,Shelton,Clements Ltd,New Bernard,Bouvet Island (Bouvetoya),001-120-276-7889x7417,(008)729-6888,grantmullins@bentley.com,2020-12-10,https://anderson-fischer.com/
21-Dec-2020,Reversal,"24,939.34",00.00,"58,272.17",df1d9e4BDC126d1,889,Sydney,Singh,Maxwell Inc,Eileenmouth,France,009-677-5689x250,+1-541-183-2145x803,dominique06@raymond.biz,2021-09-13,http://walsh-dennis.org/
21-Dec-2020,Reversal,00.00,"58,272.17",00.00,Bfa3bCc248D4289,1500,Jake,Whitney,Floyd and Sons,New Javier,Brazil,(938)229-2017,(852)721-4601x27340,gouldtroy@shelton-compton.com,2021-01-25,https://wall.com/
21-Dec-2020,Interest,21.00,00.00,21.00,ba362eE7A41eD4B,8948,Spencer,Washington,"Wood, Jackson and Neal",Marilynmouth,Guadeloupe,(710)755-3103x832,742-024-1246x67037,stevensonwillie@rich.com,2021-10-16,http://www.pitts-case.com/
21-Dec-2020,NEFT,00.00,02.10,18.90,4C8824eDCFAe42b,9387,Jessica,Wilcox,"Newman, West and Cooper",Ericside,Martinique,943.928.6213x7182,350-588-2174x6991,weeksnathaniel@molina.com,2022-04-10,http://www.carroll-brown.com/
21-Dec-2020,IMPS,"179,682.00",00.00,"179,700.90",C3e83C94C47Ac4E,9441,Angie,Welch,Quinn-Watts,Randallmouth,Saint Martin,+1-316-070-4456x799,7554065930,ryan05@murray-fletcher.com,2021-07-02,https://www.roberts-rush.net/
21-Dec-2020,Miscellaneous,00.00,"19,966.77","159,734.13",8CeaB2697903D9A,6036,Shaun,Alvarado,Villegas and Sons,Geoffreytown,Mayotte,001-449-923-2348x61639,9935465464,lindsayholt@durham-turner.com,2021-07-28,https://www.gonzales.com/
21-Dec-2020,Purchase,00.00,"79,867.07","79,867.06",06cdDFEc1Ab3EB2,4797,Brandy,Schneider,Francis-Garrett,North Ritaside,Cambodia,(146)763-0957,(749)917-4770x03623,jackbarrett@johnson-collins.biz,2021-09-29,https://www.clayton-parsons.com/
21-Dec-2020,Reversal,"2,000,101.80",00.00,"2,079,968.86",9f8a8EFd7d551cc,7373,Christie,Townsend,Ryan-Underwood,Snyderview,Russian Federation,350-687-1416x49706,+1-568-213-6329,huffjacqueline@cross.net,2022-03-13,http://www.patton-wilkins.com/
21-Dec-2020,Bill,00.00,"519,992.22","1,559,976.64",9ce13c3d8af19d3,9811,Neil,Blackburn,Miles-Clayton,North Glentown,Malawi,954-959-9670,440.400.1503,coreyanderson@case.org,2021-09-14,http://pacheco.com/
21-Dec-2020,ATM,00.00,"311,995.33","1,247,981.31",ad72E2c53510Aed,8171,Douglas,Bennett,Hatfield Group,Devonmouth,Mauritius,3783301320,+1-561-310-2412x632,ericamorales@ball-arias.com,2021-11-15,https://www.ray.com/
21-Dec-2020,Cash,00.00,"124,798.13","1,123,183.18",150A8E6d3E7Bc68,6834,Gail,Molina,Simon-Barton,Melvinborough,Ecuador,245-548-4832x22703,(242)052-2718x269,raymondsnow@cantrell.biz,2020-05-26,https://www.baker.biz/
21-Dec-2020,Debit Card,01.00,00.00,"1,123,184.18",5BF40306BA799d0,2510,Monique,Brown,Crawford-Sloan,Shortborough,Guinea,0914568898,(328)742-2391x188,darrylstark@lloyd.com,2021-02-26,http://munoz-porter.info/
21-Dec-2020,RTGS,00.00,"1,123,184.18",00.00,dE4A3EeFBe8fEDa,8221,Henry,Cherry,Young LLC,New Damon,Indonesia,001-132-580-7917,+1-966-552-6754x33300,amorton@bell-lane.org,2021-10-17,https://andersen.org/
21-Dec-2020,Interest,"9,218.00",00.00,"9,218.00",91F08f19ECd707c,7133,Bridget,Choi,"Dyer, Armstrong and Pearson",Thomasberg,Uruguay,+1-327-045-5317x62624,001-379-655-6782x3596,bautistacaitlyn@wood-newman.com,2021-03-23,http://www.potter-patton.com/
21-Dec-2020,Miscellaneous,06.00,00.00,"9,224.00",c672a7Ec1652ddd,1285,Whitney,Rojas,"Crane, Hebert and Velez",Port Bradleyland,Iran,(761)590-7983,001-663-320-0183,lovemaria@shepherd-mcfarland.net,2022-04-16,http://bullock-stevenson.com/
21-Dec-2020,IMPS,"256,077.00",00.00,"265,301.00",eDdcfb47aa0d87E,8487,Stanley,Patton,Andrews Ltd,Lake Shelby,Anguilla,+1-574-527-4896x23045,001-546-480-6273x694,rothjason@sims-ashley.com,2021-01-12,https://poole-bender.com/
21-Dec-2020,Interest,"84,016.20",00.00,"349,317.20",d4C174a7ed3ffdc,4833,Guy,Giles,Nguyen-Charles,Andreamouth,Brazil,657-220-3385,368.985.0279x6002,todddalton@mckinney-ellis.com,2020-04-04,https://romero.com/
21-Dec-2020,Bill,"30,497.77",00.00,"379,814.97",43598E87ECeC4de,3577,Hailey,Green,"Ray, Eaton and Ponce",West Joshua,Western Sahara,(157)961-0439,001-686-068-9940x836,kimlang@meyers-vincent.biz,2020-06-23,https://cowan.biz/
21-Dec-2020,Cash,"1,366,827.00",00.00,"1,746,641.97",973cb7366f4Fc3b,5261,Deborah,Hanson,Arias-Simon,East Laurie,Comoros,(622)099-2914,+1-349-503-9505x82955,hillfrank@cole.com,2021-07-07,http://www.carpenter.com/
21-Dec-2020,RTGS,00.00,"291,107.00","1,455,534.98",F60B28b98B67Dac,4643,Dwayne,Perkins,"Campos, Dorsey and Reeves",Mcgeeberg,Chile,+1-739-700-1637x50483,254-887-9798x79166,ocharles@byrd-roach.com,2020-08-11,http://wilkerson-phillips.com/
21-Dec-2020,Bill,"2,022.12",00.00,"1,457,557.10",8Acb14a4FBB1F42,7383,Tammie,Good,"Jordan, Bradshaw and Barber",South Jayhaven,Djibouti,001-626-577-9248x0032,382-920-2668x05668,chaselarsen@holland.info,2020-02-03,https://www.bright.com/
21-Dec-2020,Cheque,291.90,00.00,"1,457,849.00",7dBc52e4Aafc1EA,4812,Briana,Estes,Cunningham-Mckenzie,Penningtonburgh,Cote d'Ivoire,001-494-909-5571x340,(893)083-1759x97992,ayersrebekah@klein.info,2022-04-10,http://www.briggs-crane.com/
21-Dec-2020,IMPS,"118,726.75",00.00,"1,576,575.75",183882Ad5ab29Ea,4166,Evan,Willis,Robertson Group,North Randall,Zimbabwe,+1-968-113-7344x108,+1-459-219-0572x946,regina02@lutz-lowery.com,2020-01-02,http://www.small-mooney.com/
21-Dec-2020,Bill,00.00,"197,071.97","1,379,503.78",df7bcDDeE57A6B1,1115,Mark,Hardy,Hendricks-Cline,Lake Austin,Pitcairn Islands,001-053-359-9856x32971,+1-495-352-6406x116,prestonsmall@poole.com,2022-02-27,http://bell.net/
21-Dec-2020,Debit Card,"260,178.94",00.00,"1,639,682.72",dabeFBadD80Eeec,2097,Erik,Hatfield,Frost-Marquez,East Dalton,Guatemala,326.359.9776,+1-731-976-9733,barbarasosa@cain.com,2020-09-24,http://hayes.com/
21-Dec-2020,ATM,00.00,"327,936.54","1,311,746.18",57a3fE70eFEcc4d,5162,Shari,Michael,"Olsen, Leonard and Lynch",South Kaitlinbury,Austria,(451)313-9050x9308,(011)955-3747,bethany24@frederick.com,2021-02-11,http://www.huber.com/
21-Dec-2020,Reversal,00.00,"163,968.27","1,147,777.91",AeCbd58D3ec794f,580,Adrienne,Duran,Conley-Travis,Drakechester,American Samoa,(126)764-9447x443,857-459-6993,gravesamy@macdonald.com,2022-01-18,http://www.branch.net/
21-Dec-2020,NEFT,00.00,"229,555.58","918,222.33",beeF22589d6bb3A,3013,Cindy,Kelly,Thornton-Bell,Donnaton,Tanzania,7692029723,(769)796-5707,tina86@morrow.org,2021-02-03,http://bass.com/
21-Dec-2020,Cheque,00.00,"91,822.23","826,400.10",65225ddFefA23E8,824,Doris,Werner,Spencer-Floyd,Dianeview,Guadeloupe,+1-545-779-6923x214,095.315.5606,jordanwarren@stafford-garza.com,2020-04-13,http://pittman.com/
21-Dec-2020,RTGS,"97,531.30",00.00,"923,931.40",8b7dd3663ca8210,986,Earl,Reid,"Singh, Miller and Golden",West Lancestad,El Salvador,(304)401-6534,(579)946-4417x338,wayne62@jennings-burnett.com,2020-09-16,http://www.salas-gross.biz/
21-Dec-2020,RTGS,284.00,00.00,"924,215.40",2AbB126BFf05C1d,9191,Cristian,Orozco,"Duncan, Harrington and Acevedo",Hannastad,Libyan Arab Jamahiriya,001-707-094-9478,300-788-9684,sallybishop@shields.info,2020-04-28,http://cain.com/
22-Dec-2020,Debit Card,"3,490.00",00.00,"927,705.40",a1A7c5d6B086dBF,2145,Holly,Lin,"Garrett, Fuentes and Olson",Baldwinfort,Honduras,218.645.5150x16428,860-912-6407,shelleyleonard@carlson.net,2021-06-02,https://grimes-fry.com/
22-Dec-2020,Reversal,418.10,00.00,"928,123.50",fF5C11e5bCbfAdf,1939,Grant,Davila,"Vaughn, Benton and Khan",Robertsbury,New Zealand,(423)587-1259x098,641-936-8092,mccarthyerika@bruce.info,2020-10-25,https://levine.com/
22-Dec-2020,NEFT,"67,144.00",00.00,"995,267.50",6Ea1B42FD8C1Bde,852,Cristina,Phelps,Bridges-Barnett,North Patricia,Togo,390-299-6226x19930,001-178-259-8076x650,alexlittle@boyd.net,2020-08-02,http://wu.com/
22-Dec-2020,Debit Card,"31,492.40",00.00,"1,026,759.90",ECBC129D0d0C6B8,3368,Diana,Monroe,Washington and Sons,Port Suzanneton,Saint Martin,001-023-454-5016x5952,(287)573-3895x59250,gwade@sosa.com,2022-04-06,http://www.rodgers.info/
22-Dec-2020,Purchase,00.00,"114,084.43","912,675.47",e586A2D67bcdB48,12,Sara,Shaffer,"Dudley, Coleman and Green",Orrland,Gambia,4229986278,001-028-824-7381x56737,gabrielaleach@rose.net,2021-04-07,https://www.hoffman-rubio.com/
22-Dec-2020,Bill,00.00,"152,112.58","760,562.89",2fB6bC11D650b9E,7035,Cristian,Collins,Clayton Group,Feliciaborough,Ghana,+1-869-820-0527x42505,+1-880-802-5248,marthamercer@summers-brennan.com,2020-02-10,http://sherman.com/
22-Dec-2020,Cheque,293.70,00.00,"760,856.59",Ff76BFAEeBCE31f,7222,Jade,Esparza,Herring-Mahoney,North Gabriela,Mayotte,001-909-367-3286x1469,001-263-358-1751x730,castillobrianna@gallagher.com,2021-01-16,https://irwin.biz/
22-Dec-2020,IMPS,27.40,00.00,"760,883.99",A597ef6924af151,3872,Jaclyn,Heath,Choi Group,New Jimmy,Dominican Republic,(793)677-2406x636,919.750.6267x63716,cblackwell@friedman.com,2020-09-03,https://www.knox.net/
22-Dec-2020,Interest,00.00,"84,542.67","676,341.32",080F07eD9FC82ed,2512,Miguel,Schneider,"Vincent, Lambert and Burch",Port Amy,Equatorial Guinea,055.764.6167,552.625.1374,reynoldsross@jennings.org,2021-01-16,http://chapman.org/
22-Dec-2020,ATM,"17,153.00",00.00,"693,494.32",6eEAd5890dF3ec5,6364,Wesley,Whitney,Conrad PLC,New Alexandria,Western Sahara,(097)236-3138,372-180-4005x8887,fhodges@browning-hahn.com,2020-08-11,http://www.downs-franklin.com/
22-Dec-2020,Cash,450.90,00.00,"693,945.22",a450b2C2aA15B6F,6108,Leslie,Zavala,"Arias, Silva and Hicks",Stuartstad,Vanuatu,949-808-6406,487.550.2617x45190,sjohns@cantrell.com,2020-01-08,https://www.valenzuela.biz/
22-Dec-2020,Reversal,00.00,"173,486.31","520,458.92",Ba2d8aCd75af0C0,4539,Shelby,Garza,"Cameron, Malone and Coffey",North Brandyview,Chad,+1-531-557-3501x1312,(375)086-3840x41583,cochrandestiny@colon.com,2022-03-16,https://www.beck.info/
22-Dec-2020,Tax,00.00,"52,045.89","468,413.03",D6bAddB76237B9F,94,Terry,Chapman,Huffman LLC,Maryland,Heard Island and McDonald Islands,+1-020-368-6749x8950,(631)274-6737x26447,adrian55@gardner-gaines.com,2022-04-14,https://www.gutierrez-lloyd.com/
22-Dec-2020,Debit Card,00.00,"66,916.15","401,496.88",ae8c0735aCFCD41,746,Tabitha,Fowler,"Perkins, Hale and Sellers",Mendezbury,Uganda,867.358.8227x7535,001-025-615-0930,frank82@casey.com,2021-08-29,https://www.mccullough.org/
22-Dec-2020,Transfer,00.00,"100,374.22","301,122.66",953eBB9D79Ec1da,3209,Bruce,Baldwin,Bishop-Marshall,Port Sherryport,Fiji,189.127.6559,000.910.4961,whunt@walter.com,2020-02-16,http://www.michael-garrett.info/
22-Dec-2020,Debit Card,00.00,"37,640.33","263,482.33",E5442BDcf0d79cF,9695,Carl,Stark,"Zhang, Garrison and Tanner",Steveburgh,Korea,1545099664,(799)844-2011x304,darrylbradley@wyatt-norton.net,2022-03-02,http://www.velazquez-baldwin.com/
22-Dec-2020,Cash,00.00,"32,935.29","230,547.04",eEDBF12Fc97bB15,3212,Melody,Schroeder,English-Carey,Christinehaven,American Samoa,+1-096-017-3175x611,598-327-3725x73385,ashley12@jarvis.com,2020-12-22,https://fowler.biz/
22-Dec-2020,Tax,00.00,"230,547.04",00.00,69c0Abbba9c1CFC,5433,Oscar,Fletcher,Avila-Barrera,Jesseton,Burkina Faso,(098)116-4019x187,+1-631-034-4825x362,evelyn37@shah.com,2021-07-28,http://www.higgins.com/
22-Dec-2020,Cash,40.38,00.00,40.38,1d33fD8cFc8372d,2001,Kendra,Banks,Frey-Krause,Chasefurt,Indonesia,614-529-3677x831,(101)924-9066,tonibest@ellis.biz,2020-10-11,http://www.gonzales.com/
22-Dec-2020,Miscellaneous,"81,952.00",00.00,"81,992.38",148D7C9ca46571d,3773,Shaun,Wood,"Christian, Peck and Levy",West Bethland,Faroe Islands,001-289-404-7981,+1-363-405-6198x38860,barrettanthony@hendricks-singh.com,2021-09-23,https://www.kramer.com/
22-Dec-2020,Cash,00.00,"16,398.48","65,593.90",BFD257E7a62F43f,622,Bill,Dunlap,"Hoffman, Mccarty and Mcmillan",Peggyfort,Saint Barthelemy,098.661.3555x48646,+1-137-479-0704,nicholsjared@odonnell-weaver.com,2020-08-06,https://moses.net/
22-Dec-2020,Interest,00.00,"8,199.24","57,394.66",Fa094Bf730CdAe4,8712,Raven,Krause,Deleon Inc,South Dominique,Latvia,001-408-146-1021x55726,(756)222-4344,ellenweiss@hester.com,2021-08-19,http://www.douglas-willis.com/
22-Dec-2020,Tax,00.00,"5,739.47","51,655.19",99fBA93ffF751Ba,9237,Aimee,Lucero,Andrade-Strong,Whitneyborough,Luxembourg,+1-223-760-6945x38566,180.548.2643,moonsara@benitez-nielsen.biz,2020-11-16,https://www.kirk.biz/
23-Dec-2020,IMPS,00.00,"10,331.04","41,324.15",bDE2bCbf0c37c5a,9489,Tricia,Knapp,Miranda Ltd,Bradleyshire,Uzbekistan,579-705-5839x58286,(040)375-9814,xalvarez@carr.com,2021-06-07,http://www.beck-molina.biz/
23-Dec-2020,Cash,372.00,00.00,"41,696.15",500aec857FFc945,5980,Stephen,Riley,Shepard Ltd,Port Katrina,Niue,+1-511-202-6207,925.348.2300,qbarr@landry.biz,2020-09-07,https://www.humphrey.com/
23-Dec-2020,Debit Card,00.00,"5,212.02","36,484.13",A9A1d18Ba443F0E,1677,Jerome,Ortega,Solomon Group,Bernardfort,Saint Pierre and Miquelon,+1-737-995-5737x03400,(664)856-8452x6313,dwarner@huffman.com,2022-03-25,http://holloway.com/
23-Dec-2020,Cash,00.00,"4,053.79","32,430.34",3e751A7A3D70A2b,9692,Emma,Booth,Rivers-Moyer,Lake Tom,Oman,+1-801-357-4774,001-248-857-1395x4891,hlloyd@saunders.com,2021-06-16,https://shepard.com/
23-Dec-2020,IMPS,00.00,"10,810.11","21,620.23",af52bdca6D4C2a1,7667,Caitlyn,Cordova,"Marsh, Mullen and Garner",Port Jackie,Djibouti,(183)870-5120x262,243-601-1311x06719,gfrederick@bray.net,2021-10-24,http://www.rogers.com/
23-Dec-2020,Bill,"127,868.75",00.00,"149,488.98",0ac6F8c5c9aBfe7,3899,Mark,Delacruz,"Reese, Franklin and Wyatt",Mackmouth,Iran,(528)023-2785,001-179-206-3422x7181,kelsey90@bryant-olson.com,2021-07-16,https://www.parsons.org/
23-Dec-2020,Miscellaneous,"27,339.70",00.00,"176,828.68",2C7CBa68e6c1595,3066,Tasha,Bentley,"Young, Hester and Campbell",Lake Roseborough,Dominican Republic,513.199.9301,806-436-5148,linda14@flynn.com,2021-11-28,http://www.salas.com/
23-Dec-2020,Commission,"50,830.28",00.00,"227,658.96",2C5856eBEEdbe29,3339,Guy,Mayo,"Estrada, Heath and Dunn",South Leon,Niue,894-925-7760x168,+1-812-310-4347x32477,chavezemma@butler-hart.com,2022-04-28,https://stokes-chambers.com/
23-Dec-2020,Commission,00.00,"37,943.16","189,715.80",ebaAa48B8e9F6Eb,5696,Jesus,Juarez,Blanchard Inc,Port Christina,Kenya,001-292-275-0778x5391,(398)760-6403x088,briggsnichole@alvarado.net,2021-05-22,https://www.ferrell.org/
23-Dec-2020,NEFT,"8,096.00",00.00,"197,811.80",4EE4cd7bfeA4Bc6,898,Preston,Rodriguez,Cantrell Group,South Leetown,Micronesia,(360)745-6810,(665)384-1044,brandyholloway@padilla.com,2020-04-21,http://beltran-wallace.com/
23-Dec-2020,RTGS,"32,582.00",00.00,"230,393.80",7Cc9BD021b2F3eB,5705,Tanner,Cooley,Harrell LLC,Riosfort,Chile,644-377-0958,+1-391-431-1535x196,zamorapreston@shaffer-garza.com,2020-10-12,http://jensen.com/
23-Dec-2020,Interest,00.00,"46,078.76","184,315.04",664C8C7c9aDEDd3,8056,Grace,Hull,"Paul, Murray and Morgan",Bradview,Benin,(539)023-6000x7869,492-623-6360x33769,monica15@vance-padilla.info,2021-04-29,http://chan.com/
23-Dec-2020,RTGS,205.47,00.00,"184,520.51",d1Be4D41500884C,4914,Steven,Finley,Lamb Group,Stantontown,Bouvet Island (Bouvetoya),340-106-7755x365,(809)563-5088,zwoodward@petersen-mclaughlin.com,2021-07-06,https://www.archer.com/
23-Dec-2020,IMPS,00.00,"18,452.05","166,068.46",cEe6Db2E326c78e,933,Chad,Nguyen,Sullivan-Cline,Lake Joanne,China,(765)971-5674,+1-535-486-3537x158,glenda75@gay.org,2021-10-14,https://www.donovan-pruitt.biz/
23-Dec-2020,Cash,"30,463.00",00.00,"196,531.46",fA9E5e13CECd1B1,2592,Gloria,Frank,"Cross, Kirby and Roach",South Ashleeshire,Macedonia,2204058228,001-459-843-5166,krystal05@carlson.info,2022-01-20,https://www.mccullough.biz/
23-Dec-2020,Cash,55.10,00.00,"196,586.56",DEC9679E0F4DDbd,3949,Rachael,Sosa,Gill-Harding,Frankburgh,Ukraine,272.069.6850x0322,+1-325-958-7818x8363,norma21@campos-hurley.com,2020-07-25,https://www.tyler-zhang.biz/
23-Dec-2020,IMPS,"191,791.20",00.00,"388,377.76",B47C43ea6e70772,7390,Kayla,Martinez,Dodson-Proctor,Lake Amandatown,Sierra Leone,550.736.0226x730,+1-160-665-7731x963,drasmussen@hamilton.net,2020-06-29,https://www.juarez.com/
23-Dec-2020,Interest,"1,762.70",00.00,"390,140.46",0aB3b979af2d6D0,1904,Mckenzie,Jackson,"Mcgrath, Escobar and Cuevas",Henrymouth,Burkina Faso,299.348.8964x6462,(402)661-4214x6322,brosario@mercer.com,2021-11-30,http://foster.info/
23-Dec-2020,Debit Card,"140,595.44",00.00,"530,735.90",abb7bA3B8640ceD,4013,Bonnie,Kerr,Poole-Buchanan,North Lindafurt,Algeria,001-061-217-1877x97112,249.446.5249x4638,jacobsondale@rice.com,2021-03-27,http://watkins-wright.com/
24-Dec-2020,Reversal,"1,973.00",00.00,"532,708.90",b19dC2238F4fef0,2939,Antonio,Stokes,Green Ltd,Lake Adrianaland,Guinea-Bissau,(359)940-3164,259.156.7270,randallanthony@mack-trevino.com,2021-10-27,https://www.zhang.org/
24-Dec-2020,Transfer,00.00,"66,588.61","466,120.29",e2CBa0F3D2f28F8,191,Melissa,Bullock,Charles-Mcknight,West Gregory,Central African Republic,001-132-816-6782x927,851-296-9631x9588,cwolf@arellano.com,2021-09-30,http://www.wise-horton.com/
24-Dec-2020,Transfer,"665,992.75",00.00,"1,132,113.04",f900721a6CAD4bc,2403,Edward,Compton,Daniels-Ponce,Steveland,Kazakhstan,317-847-3021x374,850-681-6365x88112,nduarte@guzman-griffin.com,2021-12-14,https://villanueva.net/
24-Dec-2020,Miscellaneous,"108,387.00",00.00,"1,240,500.04",f11Cda20dBF5F3b,6268,April,Richardson,Bass Group,Lake Donna,Korea,(383)002-6697,001-650-103-6215x171,earlmora@farley-barry.com,2021-11-12,http://www.rosario.com/
25-Dec-2020,Bill,00.00,"620,250.02","620,250.02",0ca826f0ab0baA9,5214,Thomas,Chung,Dodson PLC,Shermanville,British Virgin Islands,(195)060-3690x9690,902.658.8926,darryl22@jones.biz,2021-01-11,https://www.terry.com/
25-Dec-2020,NEFT,"15,581.75",00.00,"635,831.77",B14E9F56e7a9ccd,3299,Theresa,Moody,Colon Ltd,East Stuartborough,Slovakia (Slovak Republic),971-417-0679x89840,354-166-9297,luceroalice@barron.com,2021-08-05,http://www.crane.com/
25-Dec-2020,Commission,"2,001,052.00",00.00,"2,636,883.77",Ba5d97ccb36E6B6,6902,Denise,Sawyer,Lyons LLC,North Warrenshire,Belarus,001-565-991-9313x05394,1194644018,kerri33@gates.com,2020-10-17,https://zamora.com/
25-Dec-2020,Tax,"761,905.50",00.00,"3,398,789.27",75dCf9ff42050ac,5043,Belinda,Baxter,Chapman Ltd,New Stephanieton,Burundi,001-173-424-1543x7624,758.667.4710x49955,logansharon@martinez.biz,2020-11-08,http://www.beasley-aguilar.com/
25-Dec-2020,Interest,37.80,00.00,"3,398,827.07",AdF14cE45b4fd08,2520,Cesar,Chambers,Maxwell-Murillo,South Christinamouth,Heard Island and McDonald Islands,(238)370-8734,001-639-899-3305x98066,warren68@harris-barnes.com,2020-07-12,http://steele.com/
25-Dec-2020,Tax,00.00,"566,471.18","2,832,355.89",6b21EbdEdE08A2f,7728,Debbie,Conrad,Bartlett Inc,Brandthaven,Grenada,275.855.8366,+1-875-493-4139x9666,qbooker@hays.org,2020-06-09,http://brooks.biz/
25-Dec-2020,NEFT,00.00,"314,706.21","2,517,649.68",153AB6DbCE4854c,9297,Yolanda,Haynes,Carr PLC,Port Robertofort,El Salvador,(898)601-9971,433.361.6402,royhouston@parrish.com,2020-05-17,http://tate.com/
25-Dec-2020,Commission,00.00,"279,738.85","2,237,910.83",7ee0955c09C42C5,1562,Lonnie,Shah,Conner-Cruz,West Blake,Palau,766.881.4499,148.159.5414x188,andrewstoni@whitehead.biz,2020-09-19,https://www.fox-reyes.com/
25-Dec-2020,Reversal,00.00,"559,477.71","1,678,433.12",F1Bcfaf0FffACaE,5766,Sylvia,Yoder,Brewer and Sons,Claytonfort,South Africa,717.882.1925x93248,723-335-1762x158,april61@arroyo.com,2021-04-23,http://miller-wilkerson.com/
25-Dec-2020,Cheque,00.00,"209,804.14","1,468,628.98",E0DCaD3fFEB09A9,6424,Alisha,Lane,Calhoun and Sons,Michellebury,Uzbekistan,+1-677-054-5112x0002,267-373-0840,andreszavala@castro.com,2022-05-02,http://garner-baldwin.org/
25-Dec-2020,Interest,"9,459.00",00.00,"1,478,087.98",2b98EaB2dA46fA7,1932,Norman,Aguilar,Tanner-Fuentes,Judyhaven,Lithuania,9969867329,001-177-695-3840x97459,wallsparker@dorsey-payne.net,2020-02-11,https://www.walton.org/
25-Dec-2020,Interest,00.00,"184,761.00","1,293,326.98",dFB51feFaa9a9ae,4302,Ariel,Fry,Edwards and Sons,New Cesar,Mauritius,954.874.3651,242-049-3506,dmccoy@henson-hahn.com,2021-08-25,https://jarvis.com/
25-Dec-2020,IMPS,"218,344.91",00.00,"1,511,671.89",6F26Bc9Fb4c5EB9,8197,Wyatt,Weeks,"Rice, Chan and Lambert",Kelleyburgh,Somalia,(963)185-1664x41097,+1-859-138-9489x49341,marksleon@padilla.com,2022-02-10,http://harrell.com/
25-Dec-2020,Interest,157.28,00.00,"1,511,829.17",0ACBeC875A0d9ce,818,Terry,Bolton,Morrow-Bond,Scottfurt,Mongolia,(403)070-7427x51629,+1-936-614-1429x43538,bdavidson@payne-conley.com,2021-01-09,https://lyons-bruce.com/
25-Dec-2020,Transfer,00.00,"377,957.29","1,133,871.88",6149CD54bc96ccf,4891,George,Ellison,Schwartz and Sons,South Angel,Myanmar,352.924.0451,810.454.4430x597,mliu@velasquez.com,2020-12-29,http://www.golden-simmons.com/
25-Dec-2020,IMPS,00.00,"377,957.29","755,914.59",f5E359A51AF6848,5700,Tiffany,Knapp,Stokes-Wu,Port Jeffreytown,Estonia,(853)182-6190x70008,511.917.3005x32663,rutharroyo@spears-lloyd.com,2022-03-12,http://ross-foley.com/
25-Dec-2020,Reversal,10.00,00.00,"755,924.59",Fe4b23F7b42Ee9e,8710,Glenn,Chambers,"Mckinney, Chase and Beltran",Port Sherri,United States of America,138.494.0884x0515,+1-597-471-9271x4353,havery@logan.com,2021-12-25,http://mathews.com/
25-Dec-2020,Cash,05.70,00.00,"755,930.29",A4EAc3aaDBfF292,1835,Kirk,Kidd,Bridges-Salazar,West Meaganhaven,South Africa,200.769.2581,+1-201-869-1581x13901,chloeray@sims.org,2020-11-14,http://www.savage.com/
25-Dec-2020,Cheque,235.20,00.00,"756,165.49",fe51ef5bEcb9B3a,9553,Breanna,Moran,"Maddox, Cabrera and Donaldson",Oscarburgh,Honduras,073.104.4157,367.206.8377x7278,jilliandoyle@bridges-walker.biz,2021-08-18,https://www.salinas.com/
25-Dec-2020,RTGS,22.60,00.00,"756,188.09",6b133ca2D3A1D00,1987,Donald,Ingram,"Sosa, Bolton and Macdonald",Tashafort,Anguilla,001-498-373-7008,6435716927,danny62@montgomery-rosales.com,2022-01-14,https://dyer.com/
25-Dec-2020,Transfer,239.84,00.00,"756,427.93",076bb3DeD6Bbffc,6049,Chad,Pratt,Parks-Monroe,North Haileyfort,Comoros,(307)535-2299x1978,422-650-1676x142,fcompton@valenzuela.biz,2022-04-19,https://www.cantrell.com/
25-Dec-2020,Cash,00.00,"756,427.93",00.00,FeDc06C4D5cdD50,4737,Jackson,Huber,Hinton-Bautista,Traciehaven,Syrian Arab Republic,+1-878-854-1035x153,+1-224-676-3734x21683,joycemarks@massey.com,2020-02-02,https://www.walls.com/
25-Dec-2020,Cash,"28,565.42",00.00,"28,565.42",8D72B3c4472A3Bd,5253,Robin,Carson,"Orr, Massey and Barrett",Palmerport,Ukraine,825.314.5321,(105)258-6887x04775,villanuevaalec@whitaker.biz,2022-04-25,https://www.mcbride-dunlap.net/
25-Dec-2020,IMPS,00.00,"4,760.90","23,804.52",47d35349E691a5F,5306,Yvette,Roberson,Gregory Inc,Rossmouth,Holy See (Vatican City State),(665)501-9229x8851,(497)411-9460x821,emilygarner@wiley.net,2020-04-26,http://melendez.com/
25-Dec-2020,Tax,"1,976.22",00.00,"25,780.74",C8a35774688E16b,3502,Bailey,Morrow,Rasmussen-Coleman,New Devin,Lithuania,(964)801-8438,896-192-4951,wardralph@key.com,2020-10-21,http://montes.biz/
25-Dec-2020,IMPS,00.00,"3,222.59","22,558.15",6Ec9CDC2E22dbC9,6250,Tracie,Kim,Horton-Pruitt,New Peggyside,Cuba,500.857.6318x88838,089.963.2568,hailey78@holloway.net,2020-09-04,https://marsh.biz/
25-Dec-2020,Purchase,85.00,00.00,"22,643.15",70eCEd2CAB2961E,7691,Dean,Lynch,Jefferson Group,Dakotaberg,Ghana,482.466.8022x74240,720.917.5455x11388,alishabarker@conley.com,2021-02-01,http://sherman-cabrera.info/
25-Dec-2020,Debit Card,00.00,"11,321.58","11,321.58",30F0323e54c375A,8613,Dawn,Boyle,Powell-Lynn,Kristyville,Costa Rica,001-183-046-7726x764,+1-756-792-6041x628,tbowers@trevino.com,2021-09-21,http://www.graves-mercer.com/
25-Dec-2020,Cash,312.00,00.00,"11,633.58",fD5A2cd7cdEfae8,4832,Connie,Zavala,"Nash, Schwartz and Watson",Lake Brian,Netherlands,044.085.9948x8002,001-308-044-1066,colinibarra@christian.info,2022-03-04,https://schmidt-frost.biz/
25-Dec-2020,Cash,"2,538.74",00.00,"14,172.32",b5fceAA9bdFa8ed,6612,Molly,Moreno,Arias Group,Ginaborough,Ethiopia,4096378199,(959)437-7243x658,piercecharlotte@oliver-clayton.com,2020-10-20,http://kelley.com/
25-Dec-2020,Interest,"24,526.51",00.00,"38,698.83",Fe672df1557D2B8,8208,Shelley,Stokes,Sharp-Carroll,Lake Darylview,New Zealand,099-355-0140x62291,387-614-7887x90503,kendra91@richmond-evans.com,2021-11-15,http://zavala.com/
25-Dec-2020,Bill,00.00,"38,698.83",00.00,BC4E5ded790cf5B,4223,Traci,Hendrix,"Matthews, Medina and Fowler",West Hunterchester,Haiti,(539)846-0835,323-838-2618x7724,osanders@trevino-mora.com,2020-05-26,http://www.ross-beck.com/
25-Dec-2020,IMPS,"1,777.17",00.00,"1,777.17",C9c35E6F9A125CE,344,Chase,Cooke,Mason LLC,North Nataliefurt,Bosnia and Herzegovina,337-592-5339,+1-369-587-4745x6291,zrobbins@ross.net,2020-12-26,http://www.russell-clayton.com/
25-Dec-2020,Cheque,42.40,00.00,"1,819.57",aA9787B3AC0bcb5,6985,Tracie,Clayton,Case LLC,New Pennymouth,Saint Barthelemy,(999)569-0601,520.895.2679,andrewerickson@hurst.com,2020-10-05,http://howe.net/
25-Dec-2020,ATM,"1,459.85",00.00,"3,279.42",3e0Ae2c4Ba86f6C,4015,Jaclyn,Powell,Forbes-Riddle,Donaldland,Uzbekistan,748-972-7140x8984,(470)673-4372,mary13@gillespie.com,2021-05-14,http://bender-savage.org/
25-Dec-2020,IMPS,00.00,364.38,"2,915.04",14BEc500d6A777d,2491,Rebecca,Sampson,Cameron-Moyer,Beardchester,Isle of Man,+1-690-922-4618x82795,306-928-2344x098,meyersrobin@vazquez.com,2021-08-05,https://www.scott.com/
25-Dec-2020,NEFT,01.74,00.00,"2,916.78",Dfe8e5318F1de42,415,Pam,Atkins,Chase and Sons,Lake Leslieborough,Taiwan,7209726342,783.775.8921x2153,gdoyle@hooper-johnston.com,2021-08-25,https://webb.com/
25-Dec-2020,Purchase,00.00,"2,916.78",00.00,9DBedB1D10E5e9C,8609,Jordan,Coleman,Ashley and Sons,New Kristyville,Gabon,+1-643-181-0085x534,001-422-780-7120x21775,cesarchristensen@stanton.com,2020-12-07,https://www.heath-chung.biz/
25-Dec-2020,Interest,"1,160,294.75",00.00,"1,160,294.75",D738bdE54ce14f6,9592,Jasmine,Hammond,Weaver LLC,South Marcview,Kazakhstan,(363)137-4115x33296,630.027.3000x23175,lvillanueva@orr-gutierrez.com,2020-06-11,http://bush.info/
25-Dec-2020,IMPS,"1,260,868.00",00.00,"2,421,162.75",4FAECeB4ff5EC4c,2812,Beverly,Howell,Gentry Inc,West Terrance,Egypt,081.368.6932x02989,7909268060,hornlucas@waters.org,2021-06-14,http://reeves-santana.com/
25-Dec-2020,IMPS,"843,452.20",00.00,"3,264,614.95",a8eC9494e9CCb46,9992,Christy,Wilkinson,"Gray, Ponce and Hayden",South Jillian,Austria,342-307-9452,001-070-026-2258x071,amandaharrell@ballard.biz,2021-10-22,http://petty-acosta.com/
25-Dec-2020,Cheque,927.00,00.00,"3,265,541.95",6724d84547e3193,7298,Sandy,Short,Shaw Ltd,East Roberta,Egypt,450-920-8949x042,506.964.7231,dodsonkatie@boyer.com,2021-12-03,http://www.barnes-rowe.com/
25-Dec-2020,NEFT,00.00,"1,088,513.98","2,177,027.97",bd7Da4B82F28279,405,Zachary,Shaffer,"Haynes, Lara and Lara",Mccormickmouth,Czech Republic,(713)867-5810x3140,540.738.7911x210,avilasummer@hensley-richmond.net,2022-01-30,https://www.burgess.org/
25-Dec-2020,Interest,"2,413.30",00.00,"2,179,441.27",Dc1bdf9664Df609,6213,Ashlee,Bender,King-Rios,East Ebonyborough,Syrian Arab Republic,059.264.6112,+1-745-601-2687,kbuck@sullivan-stewart.net,2021-11-07,http://massey.net/
25-Dec-2020,Tax,"27,611.91",00.00,"2,207,053.18",F944522Ee51CEc7,4705,Courtney,Miles,"Cross, Dawson and Chen",South Destiny,Fiji,(058)889-5214,146.967.2482x0399,mirandanorman@kelly.info,2020-04-10,http://frye.com/
25-Dec-2020,Reversal,00.00,"275,881.65","1,931,171.53",f2D8A8c56DC14F3,6278,Erika,Schroeder,Hunt and Sons,Malikton,French Southern Territories,001-349-255-2457,522-179-4237x89945,sgoodman@kerr-knox.net,2020-02-10,https://www.dickson.net/
25-Dec-2020,NEFT,00.00,"965,585.77","965,585.76",ea43D10489F80DA,6477,Jeffrey,Huff,Rosario PLC,East Jacob,Latvia,684.709.6435,2482136336,edwardvaughan@payne.net,2022-03-02,https://rollins.com/
25-Dec-2020,Transfer,00.00,"107,287.31","858,298.45",DE5cD8ABBcaAeFa,7225,Jose,Little,"Madden, Frazier and Stone",Bryantburgh,Colombia,322.017.3409x61066,068.390.8202,michaelamoyer@duran.info,2020-06-24,https://www.shaw.info/
25-Dec-2020,RTGS,00.19,00.00,"858,298.64",b9Ce9c92FdFb2eA,6764,Sean,Faulkner,"Young, Swanson and Aguilar",North Darrenville,Algeria,515-733-4945x347,001-536-418-8455,navarroemily@briggs-mcguire.com,2020-12-08,https://james.com/
25-Dec-2020,Debit Card,00.00,"122,614.09","735,684.55",75d998AB58C6E7f,9050,Leon,Mckee,Hartman-Ashley,Port Ebony,Cuba,001-565-864-1872x3520,080.320.8712,autumn51@stuart-monroe.com,2021-05-06,http://www.wood.com/
25-Dec-2020,NEFT,"7,833.00",00.00,"743,517.55",731C1AB0cAF588b,323,Curtis,Armstrong,Boone LLC,Barkerchester,Comoros,955.476.5937x20987,357.645.5729,monique66@daniel.info,2020-03-09,http://ochoa-hodges.biz/
25-Dec-2020,Purchase,00.00,"92,939.69","650,577.86",05d0BBD8588dc21,9538,Randall,Chung,Daniel-Stuart,Rileyhaven,Mali,429-485-7232,+1-316-077-0083x122,jonbright@conway.org,2020-09-15,http://www.payne.biz/
25-Dec-2020,Miscellaneous,00.00,"65,057.79","585,520.07",d3cCC3C94bfA15d,270,Martha,Molina,Cooper-Richards,East Jonathanborough,Fiji,916-950-6485x5931,723-255-8755,pratthector@ferrell.info,2021-08-07,http://www.knight-weiss.com/
25-Dec-2020,Commission,00.00,"73,190.01","512,330.06",6b62f128fECfdFC,2048,Gregory,Greer,"Stanton, Foley and Freeman",North Tracey,Kuwait,001-508-010-4129x85155,857.070.1813,norriscolleen@jensen.biz,2022-01-14,http://wilkerson-hess.com/
25-Dec-2020,RTGS,"16,181.80",00.00,"528,511.86",EDeE6FcBe021AbF,8639,Kelsey,Medina,Odonnell Group,North Lisa,French Southern Territories,+1-410-692-7968x5464,+1-082-579-2667x503,portermackenzie@cline-dawson.net,2021-10-27,https://dodson.com/
25-Dec-2020,ATM,00.00,"528,511.86",00.00,0761F862962A9C7,7878,Aimee,Fischer,Powers Inc,Lake Kristophershire,Turks and Caicos Islands,5200934585,023-106-6292x908,chelsea51@cordova.com,2021-11-02,https://gill-tyler.net/
25-Dec-2020,Bill,11.90,00.00,11.90,b77AcEcdC7AfCEB,9648,Jillian,Hendrix,Zhang Group,Bridgettown,Macedonia,804-544-7885x59713,683.530.9772,audrey30@herman-howard.com,2022-04-02,http://www.robertson.com/
25-Dec-2020,Debit Card,00.00,02.98,08.93,3A69C4E0929fA6C,7000,David,Mosley,"Rush, Stone and Burton",East Kevinburgh,Maldives,529.256.7196x9217,202-498-2948,thaas@chan-jones.com,2020-05-10,http://www.johnston.com/
25-Dec-2020,Transfer,00.00,08.93,00.00,cC66f892bbaEC38,2450,Shelley,Bentley,Stafford-Cook,Dyerport,Pakistan,551-614-0350x511,9128676431,hannahgutierrez@barker.com,2021-03-03,http://shepard-ponce.com/
25-Dec-2020,Miscellaneous,507.30,00.00,507.30,BF8fFcfB9e49aFA,846,Tammie,Reyes,"Holloway, Hubbard and Whitehead",Ritaview,Jordan,8056180713,026.238.5851x807,cassandra17@alvarado.com,2020-10-21,http://shea.net/
25-Dec-2020,Tax,00.00,169.10,338.20,a0003BeCa9da94D,57,Gilbert,Meza,Howard Ltd,Dorseyfurt,Egypt,250-821-7086x670,565.200.3181x012,katie69@romero.net,2020-11-12,https://nolan.com/
25-Dec-2020,Miscellaneous,00.00,37.58,300.62,8B395e4dDfD45EF,5730,Heather,Harrison,Walton PLC,Claudiaton,Madagascar,001-545-336-9892x066,001-862-983-6538x466,connie18@sandoval-pope.com,2021-09-03,https://nunez-brennan.com/
25-Dec-2020,Tax,00.00,300.62,00.00,D65A031AFdf6b6f,6226,Marc,Beard,"Clay, Church and House",Lake Frankchester,Anguilla,001-883-975-3168,152.434.2299x447,zbeck@bruce.net,2020-02-15,http://www.avila-baker.com/
25-Dec-2020,Miscellaneous,"1,743.89",00.00,"1,743.89",c1204d27800378B,6436,Jonathon,Hurst,Marquez Inc,Shermanhaven,Cambodia,094.596.6730x681,+1-753-052-5092x21382,vcarson@nelson-schmidt.com,2021-12-08,http://tanner.net/
25-Dec-2020,Miscellaneous,"53,998.00",00.00,"55,741.89",F0EE02EEE35f89D,8820,Ricardo,Davidson,"Burch, Alvarado and Abbott",East Haileyland,Tajikistan,363.669.8954x370,5743541383,johnkirby@fischer.org,2021-12-12,http://www.moss.net/
25-Dec-2020,IMPS,03.00,00.00,"55,744.89",c5f6b6A9C3b7DDe,1088,Devon,Holt,"Espinoza, Wade and Hood",East Chris,Western Sahara,560-913-6288,+1-073-524-4698,mirandamcfarland@woodard-kline.com,2020-06-05,http://www.murillo-cohen.biz/
25-Dec-2020,Cash,358.90,00.00,"56,103.79",38BB58C607f3aFF,2122,Alicia,Burgess,Walls LLC,Atkinsonhaven,Aruba,(336)322-1892x7059,790.480.5029x51608,stefaniegentry@conley-webb.com,2022-04-25,https://rasmussen-wood.com/
25-Dec-2020,RTGS,03.00,00.00,"56,106.79",8e630AE99FD4a35,591,Holly,Allen,Flowers-Wood,East Heatherville,Equatorial Guinea,158.501.2921,001-813-415-0802,friedmansuzanne@lopez.com,2021-01-05,http://www.luna-cooper.com/
25-Dec-2020,Interest,00.00,"7,013.35","49,093.44",979bd600cAc33C7,3424,Jaime,Bean,Austin Ltd,Lake Rhonda,Northern Mariana Islands,535.471.4561,001-264-523-5870x801,hensonlydia@becker.com,2021-04-28,https://holder.com/
25-Dec-2020,Debit Card,00.00,"8,182.24","40,911.20",9dBCDfaFf795ba2,5442,Mikayla,Wang,Adkins and Sons,Lake Jaredstad,Barbados,(578)532-3458,747.175.0815x870,henry04@ramirez.com,2022-04-29,http://www.conway.com/
25-Dec-2020,Bill,00.00,"13,637.07","27,274.13",d535Ccee51f5Cc6,236,Leslie,Ramos,"Stephens, Green and Dudley",Vaughnside,Montenegro,+1-004-914-0818,463-667-7297x27905,oscar33@holden-morrow.com,2022-03-23,https://maynard-madden.net/
25-Dec-2020,NEFT,00.00,"3,896.30","23,377.83",EF34d56476FCAf8,3036,Tricia,Blevins,Vang-Solis,North Eddieberg,British Virgin Islands,755.446.6954x82959,349.054.2562x88748,uzimmerman@forbes.info,2021-01-30,http://www.terry-goodwin.info/
25-Dec-2020,Miscellaneous,59.45,00.00,"23,437.28",9cd1937E01cFEcc,9670,Donald,Orozco,Best and Sons,West Joelburgh,Hong Kong,001-808-067-2215x18434,0328567290,tamiayers@hanson.com,2021-11-19,http://www.barber.com/
25-Dec-2020,NEFT,00.00,"3,906.21","19,531.07",Da00c81eFbe77Ed,7525,Kristie,Adkins,"Fuentes, Ritter and Salas",Leahchester,Cote d'Ivoire,001-845-179-3700x90030,+1-408-319-1444,howard93@giles-clayton.net,2020-10-10,https://dudley.com/
25-Dec-2020,Commission,"1,243.40",00.00,"20,774.47",570A781Bc8631Fb,4408,Sandra,Roman,Reyes LLC,Lake Tracey,Kuwait,350-270-8647,001-308-595-5217,zimmermansue@kennedy-nolan.com,2020-01-23,https://bolton.com/
25-Dec-2020,Transfer,"329,720.00",00.00,"350,494.47",6fadD74c35B4028,9753,Erin,Francis,"Everett, Baxter and Ponce",Lake Julian,Anguilla,392.421.2646,(508)370-4265,rknox@pruitt.org,2020-08-06,http://morris-lucero.net/
25-Dec-2020,Debit Card,00.00,"70,098.89","280,395.58",61ce30f9aA1a9C6,7861,Susan,Mcclure,Forbes Inc,Port Randallchester,Greenland,785.552.5785,001-445-850-0325x036,mandyyoung@finley.org,2021-10-27,https://www.berger-padilla.com/
25-Dec-2020,RTGS,"71,752.12",00.00,"352,147.70",1af2172a1E4bdB0,4606,Becky,Kelly,Green LLC,New Jaychester,Bermuda,152.324.7838x5491,850.087.2085,gregory77@cooley-bird.com,2022-05-05,https://www.ashley.net/
25-Dec-2020,Debit Card,48.86,00.00,"352,196.56",90397AE3c2Dd1D4,5017,Roberta,Mckay,Soto and Sons,Jeremiahburgh,Azerbaijan,+1-564-887-7636x89509,+1-591-386-2942,danny92@baxter.org,2021-03-05,https://www.murphy.info/
25-Dec-2020,Tax,"149,822.31",00.00,"502,018.87",cf492E1eF7Cab9D,5504,Darlene,Hoover,Stout-Hanson,New Austinview,Peru,+1-728-566-2148x3585,+1-371-811-5720x2038,uhopkins@castillo.com,2022-05-26,http://www.todd-weaver.com/
25-Dec-2020,NEFT,04.26,00.00,"502,023.13",83756137Bba4A42,6202,Rick,Beck,Crane and Sons,Rachelbury,Mayotte,+1-547-208-1278x24175,162-511-6942x64165,bbates@newman.info,2021-06-26,http://gallagher.biz/
25-Dec-2020,Bill,00.00,"251,011.57","251,011.56",Dfb02CB8A5cc89f,8185,Aaron,Tucker,"Trujillo, Kemp and Perkins",Port Sheri,Honduras,774-817-3017,+1-799-404-4553x5122,sherri62@everett-sellers.com,2020-10-01,http://kennedy-mathis.com/
25-Dec-2020,Tax,03.00,00.00,"251,014.56",0bEE4cf2Ee9cFA9,4393,Thomas,Johnson,Callahan-Blake,Bridgesview,Vanuatu,(638)197-2824x5483,(816)533-1979,tdixon@ingram-benjamin.com,2021-01-12,http://mooney.com/
25-Dec-2020,RTGS,"1,593,229.50",00.00,"1,844,244.06",68a17341d8242d4,6218,Anna,Rice,Faulkner-Boyer,Billymouth,Madagascar,(442)960-3423x8782,001-790-654-0861,brentedwards@riley-craig.com,2022-02-06,http://www.bullock.com/
25-Dec-2020,ATM,"2,612.00",00.00,"1,846,856.06",5cBEdEe2A12AccE,5934,Christopher,Giles,Brown PLC,Alexandriabury,Heard Island and McDonald Islands,684.171.1119x692,523.175.2979x58552,ohoward@roth.com,2021-05-11,http://lawrence-guzman.com/
25-Dec-2020,IMPS,426.00,00.00,"1,847,282.06",CC1cEe9Ae4e7D73,4484,Gwendolyn,Kennedy,Gonzalez-Shaffer,Rebeccaview,Colombia,432.746.8259,189-745-2517,angelica06@woodward.com,2020-08-25,https://graham.com/
25-Dec-2020,IMPS,00.00,"307,880.34","1,539,401.72",2c0bE27aBAaA8bB,3145,Dwayne,Peters,Glenn-Howard,Port Lorraineside,Syrian Arab Republic,(661)540-1716x26870,+1-057-070-7005x8840,kmay@lewis-mcmillan.com,2022-05-29,http://www.novak.com/
25-Dec-2020,Commission,02.30,00.00,"1,539,404.02",2EcCF9B4972ABC8,4442,Loretta,Powell,"Norton, Phelps and Mckee",Port Kim,Falkland Islands (Malvinas),815-835-7979,981.446.7488x203,jacquelineschaefer@blackburn.com,2021-03-31,https://glenn.com/
25-Dec-2020,Transfer,00.00,"192,425.50","1,346,978.52",e90BDb1cFa1072A,3271,Wyatt,Ibarra,"Bryant, Escobar and Porter",West Jasminemouth,Honduras,702-970-6647,+1-817-054-4185x095,qvillegas@page.com,2022-04-15,http://roy.info/
25-Dec-2020,Cash,00.00,"448,992.84","897,985.68",Dc1bdf9664Df609,6213,Ashlee,Bender,King-Rios,East Ebonyborough,Syrian Arab Republic,059.264.6112,+1-745-601-2687,kbuck@sullivan-stewart.net,2021-11-07,http://massey.net/
25-Dec-2020,Commission,00.00,"179,597.14","718,388.54",2dFa57260F6c5Bb,3247,Vincent,Hood,Strong-Carter,Aguirreland,Tanzania,616.017.0799x68348,001-635-778-2969x84352,morenojason@mcneil.com,2022-01-01,https://www.wilcox.com/
25-Dec-2020,NEFT,00.00,"71,838.85","646,549.69",00EafDA1be0d4c0,4319,Ricardo,Nolan,Sexton-Walls,Port Troy,Georgia,146.115.1909,944.689.3377x905,tammyglass@rosales-waller.biz,2022-04-14,http://parsons-mendoza.org/
25-Dec-2020,Purchase,00.00,"71,838.85","574,710.84",a17Fc98B86Db6F5,5946,Kim,Perkins,Bray PLC,Bryanchester,Malawi,(946)071-0993x860,(422)580-9394,schwartzjessica@quinn-mayo.com,2020-04-09,https://terry.net/
25-Dec-2020,NEFT,"8,981.00",00.00,"583,691.84",9cbAfF926Ca1279,636,Charles,Bartlett,Hull-Reese,Conwayshire,Montenegro,352.231.2266,+1-183-553-1609x045,dwaynewarner@graves.com,2020-04-19,https://walton-huerta.biz/
25-Dec-2020,Bill,58.00,00.00,"583,749.84",5CAcF8AA295dff4,3388,Kelly,Snyder,Hale-Barrera,Colontown,Paraguay,(141)172-1086,150.843.6054x7783,andrewmcpherson@rose.com,2022-03-05,https://www.brady.com/
25-Dec-2020,Bill,"42,436.00",00.00,"626,185.84",c473aBAaaBBbB26,5795,Jim,Sanford,Ware Inc,Livingstontown,Algeria,712-148-9607x48422,735.880.6544,ekeller@manning.info,2020-01-05,http://wiggins-baldwin.biz/
25-Dec-2020,ATM,"2,613.76",00.00,"628,799.60",Cd56CbD20AF7B9b,2660,Tim,Doyle,"Simmons, Mcmahon and Pacheco",Curtisshire,Denmark,467.583.1879x2266,+1-210-411-7419,kelseymedina@ellison.net,2022-02-09,https://www.downs.com/
25-Dec-2020,Commission,03.10,00.00,"628,802.70",00FFCc74aCcB5BD,2561,Dominique,Simpson,Blanchard-Villegas,Jennyshire,Oman,179-908-8758,(767)991-8977,julieburns@bray-mccarty.net,2020-08-29,https://www.choi-kerr.com/
25-Dec-2020,ATM,00.00,"78,600.34","550,202.36",dFEe227EEB6Db9b,4758,Johnathan,Alvarado,Rasmussen-Campos,South Kiara,Libyan Arab Jamahiriya,(916)216-1638,+1-885-803-6119x8162,toddsydney@yoder.info,2021-12-12,https://www.mullins.com/
25-Dec-2020,Reversal,00.00,"78,600.34","471,602.02",bd2eeD1aB601AF1,4885,Alisha,Hudson,Calderon Inc,Port Christinaburgh,Botswana,108.991.5728x293,(151)632-3663x0150,abuck@holder.com,2020-04-11,https://lutz.com/
25-Dec-2020,Miscellaneous,00.00,"52,400.22","419,201.80",6cA9b2cba4FFf1b,3643,Kaitlyn,Berger,Hahn LLC,East Drewton,Andorra,508-795-4892,135-800-6180x6572,qkline@gamble-pena.biz,2020-03-06,https://www.hoover.com/
25-Dec-2020,NEFT,"29,345.55",00.00,"448,547.35",ff8f77B7BDEEF11,6131,Joanne,Love,"Graham, Anderson and Waller",South Chelseyville,Cuba,101-884-2079x856,177-052-6881,cfernandez@patel.org,2020-03-17,http://www.erickson.com/
25-Dec-2020,Tax,413.29,00.00,"448,960.64",d63fC569F1a72DE,8235,Jeremy,Fry,Nichols-Carrillo,South Isaacview,Belize,473.766.8694x85956,(656)516-1655x6652,gillvickie@hoover-stevenson.com,2022-01-02,http://chapman.info/
26-Dec-2020,NEFT,00.00,"56,120.08","392,840.56",87Bb78c5ab6F3a0,4519,Noah,Hawkins,Ruiz-Clements,Terrytown,Argentina,780.531.3799,001-443-314-7166x4995,james43@goodman.net,2021-01-20,https://ramos-gross.org/
26-Dec-2020,IMPS,339.70,00.00,"393,180.26",E2cFcC727F306d6,582,Alexandra,Ware,"Velasquez, Kent and Henderson",Gallegoshaven,Uganda,948-698-9959x305,(743)085-8227,wyattbriana@cervantes.net,2020-02-04,https://www.ramos.info/
27-Dec-2020,NEFT,04.78,00.00,"393,185.04",c835eBECa934FBF,3951,Daniel,Owens,Rivas Ltd,New Rebecca,France,492-675-0101,+1-651-089-5018,chris52@garcia.com,2021-07-15,https://booth.net/
27-Dec-2020,Cheque,00.00,"131,061.68","262,123.36",74FD4bC6D0FeF5E,674,Tommy,Hickman,"Osborn, Norman and Manning",Louismouth,Lao People's Democratic Republic,+1-773-385-4858,915.083.3780x717,evanwatkins@castro.biz,2020-11-29,http://perez.com/
27-Dec-2020,Cheque,00.00,"131,061.68","131,061.68",20C41E2CfBe30b3,7409,Tiffany,Deleon,Rollins Inc,Buchananburgh,Nicaragua,971.530.5187x096,+1-590-645-4892x8687,nvelasquez@powers.biz,2020-11-04,http://www.davidson.biz/
27-Dec-2020,Purchase,"18,200.00",00.00,"149,261.68",de85BF9AE3DfFC5,3970,Shelia,Davies,"Morgan, Forbes and Flowers",New Kevinfort,Mauritius,598-752-2598x1467,+1-280-194-8705x644,audreycraig@riggs.com,2020-10-27,https://www.trujillo-gilbert.com/
27-Dec-2020,NEFT,00.00,"49,753.89","99,507.79",bbF6b6caD8aa3e8,7295,Tyrone,Cobb,Valenzuela and Sons,Jeremyport,Lebanon,098.812.6668,9664978777,rhahn@jones.net,2021-01-04,https://www.hogan.info/
27-Dec-2020,NEFT,03.47,00.00,"99,511.26",7BBd1805E1FE540,8310,Roy,Frank,Donaldson LLC,Pecktown,Kenya,001-037-296-8897,451-385-0745,leonhendricks@garner-little.biz,2021-10-21,http://dickerson.com/
27-Dec-2020,Debit Card,00.00,00.00,"99,511.26",6BA45A55aDFbDD6,1004,Robyn,Burns,Fitzgerald-Dean,South Franklin,Wallis and Futuna,(488)442-9817x071,(808)320-6815,ashlee98@acosta-lyons.com,2021-06-19,http://www.jenkins-hoffman.info/
27-Dec-2020,Debit Card,"915,154.00",00.00,"1,014,665.26",D04AC90f81a6150,1099,Shelby,Hinton,Wilkinson-Estrada,New Steven,Peru,001-658-468-2974x38149,912-359-9856,oconnorivan@robertson.org,2021-11-03,https://stark.com/
27-Dec-2020,Tax,"42,340.00",00.00,"1,057,005.26",B26fA9cF14Aa65F,5862,Bonnie,Graham,Rowe-Gates,Quinnbury,United Arab Emirates,001-021-184-4884x907,402.848.8587x4544,durhamsonia@acosta-sheppard.net,2020-07-28,https://adams.com/
27-Dec-2020,Transfer,00.00,"176,167.54","880,837.72",faacFEEfFD78eaC,9304,Erin,Branch,"Cooke, Mccormick and Donaldson",Cannonbury,South Africa,001-124-944-1053,(154)347-2169,lameugene@freeman-mills.org,2021-05-17,https://koch.net/
27-Dec-2020,Transfer,473.93,00.00,"881,311.65",15AA8Eba4CaB1AE,8519,Melody,Snow,Mckee-Pacheco,Vazquezberg,Cape Verde,350.767.2813,768.007.5811,bschroeder@green-blake.com,2020-02-04,http://www.davis.org/
27-Dec-2020,Bill,03.00,00.00,"881,314.65",3deF6B4Db3908f2,8005,Penny,Hayden,"Wallace, Brown and Norton",North Franklintown,Northern Mariana Islands,402-309-7946x4651,994-869-2910x111,sergiojames@christensen-cohen.com,2020-09-17,http://www.burnett-murphy.com/
27-Dec-2020,Interest,06.14,00.00,"881,320.79",6C4519BbDaDFf0c,2682,Ebony,Kane,Fitzpatrick Inc,South Anthonyburgh,Haiti,(777)868-8026x251,001-990-162-3614x971,nolanneil@adams-newton.com,2021-02-28,https://www.mccormick.com/
28-Dec-2020,Tax,00.00,"110,165.10","771,155.69",A184fC7364be631,8588,Leslie,Delacruz,Horn and Sons,Lawrenceshire,Mauritius,417.135.6451,001-896-247-8605x04388,ncline@santana-cross.net,2020-02-04,http://www.raymond.com/
28-Dec-2020,Reversal,00.00,"771,155.69",00.00,BA4059FF63Bc07b,8959,Jody,Tyler,Chan PLC,Whitneyhaven,United Arab Emirates,(520)185-6083x93875,+1-784-659-7334x721,colleen42@zimmerman-marsh.org,2020-03-18,https://ortega-lynch.com/
28-Dec-2020,Purchase,"3,454.00",00.00,"3,454.00",aEedc73C6FcC16F,5561,Shelby,Miles,Horton Ltd,Johnsonbury,Congo,+1-661-669-8127,487.510.8216x61385,iavery@myers-flynn.com,2021-02-07,https://soto.info/
28-Dec-2020,Reversal,00.00,"3,454.00",00.00,E74b239786C3aeb,2105,Karen,Morgan,"Whitney, Navarro and Williamson",New Yvonne,Egypt,2131743899,589.389.3273,pdalton@rivera.com,2022-01-25,http://www.pace.org/
28-Dec-2020,Interest,701.70,00.00,701.70,5546c08f8E23d8c,5806,Zoe,Hanna,Lam-Lin,West Stacie,Oman,(926)764-9929,(509)727-4215x375,bkerr@barry-bender.org,2021-10-11,https://www.watts.org/
28-Dec-2020,Reversal,05.47,00.00,707.17,35A65Ae488863Da,1239,Mckenzie,Ponce,Vazquez Ltd,Lake Dwayne,Cape Verde,113-307-7903,768.662.4692x88411,paigecalderon@berger-black.com,2020-12-13,http://haas.info/
29-Dec-2020,Tax,00.00,101.02,606.15,1f6321b7C33d6dB,1600,Kim,Adams,"Larson, Reilly and Wade",West Belindamouth,Cameroon,+1-843-452-1172x524,(030)488-9936,marco42@mcneil.com,2022-02-15,https://www.klein-trevino.com/
29-Dec-2020,NEFT,"1,071,365.00",00.00,"1,071,971.15",f7Ad0BBbbBa05dC,2242,Deborah,Conrad,Lowery-Avila,Lake Russellland,Thailand,007.052.4018,(347)823-1312x560,whobbs@atkins-pruitt.com,2021-08-23,https://rowe-molina.biz/
29-Dec-2020,NEFT,00.00,"535,985.58","535,985.57",C6d74ed7DCc5048,3189,Isabel,Davies,Smith-Burnett,Parkfort,Grenada,001-174-925-6474x5928,(932)634-2118x74708,wadesheena@weiss.com,2020-06-03,https://strong.org/
29-Dec-2020,RTGS,00.00,"535,985.57",00.00,3aaE3FdeE15878F,5431,Breanna,Curry,"Dillon, Henson and Herring",North Gina,Netherlands,(613)297-2142,256-048-2595x744,murphyamy@tyler.biz,2021-07-03,https://www.silva.net/
30-Dec-2020,Commission,688.47,00.00,688.47,78EF2aaEfA71DdD,2929,Cory,Mcintyre,Coleman-Steele,Gracemouth,Brunei Darussalam,001-504-152-3758x45756,001-757-118-4165x545,cameronbrenda@ortega.biz,2020-04-07,http://hodges.com/
30-Dec-2020,Debit Card,"110,938.00",00.00,"111,626.47",Add5c18c6c7cAd1,7217,Judith,Delacruz,"Adams, Bishop and Gentry",Robertside,Kuwait,338.005.5311x716,001-890-428-4310,mikayla80@mcguire.com,2020-07-23,http://barrera.biz/
31-Dec-2020,NEFT,00.00,"37,208.82","74,417.65",1C6be3affF9cCFe,343,Alexandria,Walters,Obrien-Wise,East Brendaborough,Slovenia,001-480-013-2079x644,642-251-4234x321,clifford91@combs.com,2022-02-10,https://blankenship-mcpherson.com/
31-Dec-2020,ATM,26.48,00.00,"74,444.13",D5bD3Bab8F151f7,5723,Chloe,Holden,Bean-Mullen,Ashleychester,Norfolk Island,642-065-8798x213,(795)938-9142x73453,qcox@conley.biz,2020-09-28,http://www.burgess-chang.com/
31-Dec-2020,Tax,"74,304.16",00.00,"148,748.29",83f8924AEa5aBc2,1921,Marilyn,Huerta,Heath-Cummings,Arthurberg,Yemen,001-564-986-8605x792,354-293-9198x36238,sreeves@maddox-fry.biz,2020-09-24,http://www.daniel.net/
31-Dec-2020,Tax,00.00,"18,593.54","130,154.75",8EdEfEa665c6bad,3217,Riley,Burke,"Harrell, Moran and Cline",Jillfurt,Korea,212.464.3237x894,+1-151-332-5284,arthur92@novak.com,2021-11-19,http://www.donaldson.com/
31-Dec-2020,Purchase,00.00,"14,461.64","115,693.11",1f9B6Bc6fcC41bc,2160,Ivan,Gardner,Kennedy-Dalton,Karinamouth,Australia,261.770.3981x49432,(700)151-3217,holmesdakota@compton-rogers.com,2022-01-15,https://www.frazier.com/
31-Dec-2020,Cheque,"3,179.10",00.00,"118,872.21",EB9Bf46a74aBacE,5136,Louis,Deleon,Jacobs LLC,East Alanton,Martinique,(131)857-4732,(595)141-5230x054,uchung@burnett-collier.biz,2020-02-26,https://moyer-skinner.net/
31-Dec-2020,NEFT,00.00,"29,718.05","89,154.16",Ddaed446bBefDbd,2317,Alan,Vazquez,Hinton-Abbott,Jaredmouth,Saint Helena,291.621.7200x74949,814.090.0823x1497,belindahuffman@fritz.com,2021-08-08,https://www.holmes.com/
31-Dec-2020,Miscellaneous,"32,413.09",00.00,"121,567.25",6a0ACAe7A7cFd7E,1091,Hannah,Fisher,Horn Ltd,East Traceymouth,Croatia,294-949-2014x47890,(221)421-7569x244,rhull@hardin.com,2020-01-26,https://www.harper.biz/
31-Dec-2020,Reversal,00.00,"13,507.47","108,059.78",cCdc89d3A5f3B0F,8296,Alex,Avery,Mcmillan-Wong,Pattonhaven,Cameroon,201.082.4971,+1-948-588-9574x2827,sergio32@rojas.info,2021-01-21,https://www.barnes.info/
31-Dec-2020,Reversal,00.00,"27,014.95","81,044.83",Ab93Fe8bbfc84cb,9627,Shari,Gregory,Hayden Group,Johnbury,Fiji,+1-775-300-0727x640,8371772943,meredithcurtis@mcgee.com,2020-06-03,http://valenzuela.com/
31-Dec-2020,Bill,"61,109.00",00.00,"142,153.83",eB21cB3D21AD9Bb,4760,Lorraine,Cabrera,Mccoy and Sons,West Kristen,Sweden,001-702-438-9191x1671,001-711-507-6432x750,hensonkerry@cowan.biz,2021-08-03,https://www.branch.com/
31-Dec-2020,Cheque,"113,982.00",00.00,"256,135.83",EfCc34C16E7DBEB,9440,Kurt,Acosta,"Osborn, Crane and Riley",North Dean,Micronesia,941-656-7452x9187,012-330-1018,masonlogan@holmes.com,2020-12-03,http://callahan.info/
01-Jan-2021,Purchase,"193,086.60",00.00,"449,222.43",7A946de4135606e,9274,Raven,Faulkner,Mason-Mata,Ericaview,Portugal,+1-118-641-2818x301,(102)670-5560x51539,greglamb@young.org,2022-02-24,https://robertson-willis.com/
01-Jan-2021,Cheque,00.00,"449,222.43",00.00,Cfc27ef7029D320,1612,Selena,Cohen,"Chang, Bright and Goodwin",Nicolemouth,Thailand,(109)801-8979x01529,001-153-831-0935x56181,erica97@bird.com,2021-11-25,https://www.miller.net/
01-Jan-2021,Interest,"1,989.71",00.00,"1,989.71",bF9309768Ec6fE6,1538,Kaitlin,Cooley,Whitaker LLC,Huynhfurt,Qatar,075.247.0199x0136,+1-775-265-6930x2828,xcisneros@powell-thomas.com,2020-02-27,http://madden-walker.org/
01-Jan-2021,Cheque,00.00,198.97,"1,790.74",B6dBC8370Cbe4aa,1394,Robert,Stark,Mayer Group,West Deannaburgh,Pitcairn Islands,(251)628-2353,8020461341,kimmcguire@estrada.com,2020-04-05,http://www.miranda-mosley.com/
01-Jan-2021,Cheque,"126,449.00",00.00,"128,239.74",4C69642aceA8616,1261,Helen,Walton,Curry Inc,South Shari,Congo,091.789.9992x8451,818.526.8143x8538,proctormarcus@dominguez.org,2021-03-04,http://www.stone.info/
01-Jan-2021,Reversal,00.00,"12,823.97","115,415.77",67BbA4AeC24c1df,3338,Jill,Weaver,Osborn-Conway,Port Selenaview,France,616.617.9060x9554,(697)476-0291x23078,holly76@andrade.org,2021-11-27,http://petersen.org/
01-Jan-2021,Commission,00.00,"14,426.97","100,988.80",dfdb4D3CafBfcde,2732,Nichole,Sosa,"Choi, Flores and Morgan",West Harold,Samoa,9780713652,001-291-967-7030x1344,gvilla@clarke.com,2021-02-11,https://norton-cook.com/
01-Jan-2021,Commission,143.00,00.00,"101,131.80",Da63bffb10feFc2,697,Zachary,Tran,"Shepherd, Greer and Murphy",Kimberlyburgh,Andorra,831.331.8338x3219,145.151.4483x888,lstrong@aguirre.org,2021-02-10,http://parks.biz/
01-Jan-2021,IMPS,00.00,"11,236.87","89,894.93",5Ab3bebbC6dcB3F,7075,Wayne,Gray,Macdonald-Nixon,North Summerview,Montserrat,+1-509-059-2683,471.652.8729x029,jessica55@harvey-reeves.org,2020-04-15,http://www.bolton.org/
01-Jan-2021,Debit Card,60.29,00.00,"89,955.22",abDcdBea7514C4C,179,Tanner,Lopez,Griffith-Brandt,Coreyville,Guatemala,001-953-876-9288,420.220.5122x17134,cowandeanna@house.com,2020-11-24,http://frye.com/
01-Jan-2021,Cheque,"9,707.00",00.00,"99,662.22",80B0AF2E4ca1a5D,6919,Renee,Chapman,"Russo, Buckley and Lang",South Roberto,Bahamas,513.769.7162x69405,+1-649-400-9487x7267,meghanroy@murphy-bennett.com,2020-04-07,https://www.higgins.org/
01-Jan-2021,Cash,"22,607.00",00.00,"122,269.22",5DdFD314FDFe3B1,2756,Natalie,Lynn,Mercado-Sosa,Mathisview,Cote d'Ivoire,+1-547-998-7744x17972,(329)145-4006,yangvictor@munoz.com,2020-03-15,http://bell.com/
01-Jan-2021,Purchase,00.00,"13,585.47","108,683.75",ae37F41D3CDd82d,1731,Kelli,Barron,"Gray, Contreras and Ball",Angelicatown,Macao,128.189.6323x5170,074-693-6371x208,trevor78@beltran.biz,2020-10-09,https://sloan-valencia.com/
01-Jan-2021,Purchase,"260,618.44",00.00,"369,302.19",cbEb6A3Fd9DE268,9370,Sierra,Gray,"Norman, Vasquez and Mcclure",Port Beth,Cook Islands,299.341.2734x155,001-759-991-8409x17388,kentkrystal@hodge.com,2021-09-09,https://www.villa.biz/
01-Jan-2021,Commission,00.00,"92,325.55","276,976.64",1b076CCfF31D7Fe,1358,Diane,French,Osborn-Cordova,Isabellaburgh,Azerbaijan,(710)912-9384,001-026-942-3628,darlene07@randall.com,2021-08-12,http://fletcher.org/
01-Jan-2021,Purchase,00.00,"69,244.16","207,732.48",997d3046BEec43D,9669,Chase,Cannon,"Nielsen, Foster and Decker",West Dominique,Guinea,001-720-992-9009x63385,287-573-5732x47699,ipruitt@faulkner.net,2020-06-26,http://www.kaufman.info/
01-Jan-2021,IMPS,00.00,"41,546.50","166,185.98",7b36eDE996a3bd2,1898,Toni,Robertson,"Russell, Allison and Serrano",Warrenburgh,Bahrain,+1-698-694-8778x193,281-384-1180x45572,gravestasha@sellers.info,2021-07-05,http://www.robinson.com/
01-Jan-2021,ATM,"1,770,190.00",00.00,"1,936,375.98",63FA0cEb1cf0fF2,4886,Tara,Mckay,Branch and Sons,Rogerschester,Japan,001-063-286-9894x889,397.921.0407x83516,vfloyd@dunn-spears.com,2020-12-30,http://morse-lara.com/
01-Jan-2021,Purchase,473.00,00.00,"1,936,848.98",FB9bF1c3ed2bd1D,9835,William,Callahan,"Gill, Ayers and George",Lake Joannbury,Holy See (Vatican City State),(375)325-8218,(157)180-8947x345,andrecastaneda@cook-sweeney.biz,2021-09-06,https://www.cowan-ramirez.org/
01-Jan-2021,ATM,07.00,00.00,"1,936,855.98",c8f62fFE2A0baFE,8067,Alexandria,Hunter,"Norris, Gardner and Schultz",Lake Sandy,Guam,+1-407-227-3453x4521,(000)724-0925x169,michaela49@higgins-sampson.info,2020-08-10,http://www.joyce-gibson.com/
01-Jan-2021,Cash,"29,136.30",00.00,"1,965,992.28",83756137Bba4A42,6202,Rick,Beck,Crane and Sons,Rachelbury,Mayotte,+1-547-208-1278x24175,162-511-6942x64165,bbates@newman.info,2021-06-26,http://gallagher.biz/
01-Jan-2021,IMPS,"109,853.00",00.00,"2,075,845.28",B833deAEfE0fCdb,1076,Roger,Suarez,Golden and Sons,West Latashaside,Luxembourg,383.477.6324x7069,375.948.1480x734,pottsmiguel@crosby.com,2020-05-14,http://www.calhoun.org/
01-Jan-2021,Purchase,"1,818,521.00",00.00,"3,894,366.28",D1E4FCE0DCdAeCe,5578,Sharon,Harrison,Gilbert-Chung,Bobshire,Dominica,+1-193-279-4229x47473,591-306-5342,hudsonkrystal@hernandez.com,2020-07-28,https://bender-reynolds.com/
01-Jan-2021,Cheque,"3,894.00",00.00,"3,898,260.28",f0DAF3e0CCD0f1C,6437,Elijah,Bush,Cuevas Ltd,East Jerome,Ireland,+1-301-827-0954x2343,4884648542,cruzcory@romero.com,2021-12-09,https://www.shelton.com/
01-Jan-2021,Debit Card,00.00,"1,299,420.09","2,598,840.19",BFD257E7a62F43f,622,Bill,Dunlap,"Hoffman, Mccarty and Mcmillan",Peggyfort,Saint Barthelemy,098.661.3555x48646,+1-137-479-0704,nicholsjared@odonnell-weaver.com,2020-08-06,https://moses.net/
01-Jan-2021,RTGS,22.36,00.00,"2,598,862.55",AF6BE2fb8A8584C,2107,Philip,Andersen,"Edwards, Blackburn and Fernandez",South Kathleenborough,Bosnia and Herzegovina,956.892.1458x53645,(928)202-0904x2344,msuarez@galloway.info,2020-10-22,https://www.delgado-hall.info/
01-Jan-2021,Purchase,"3,100.60",00.00,"2,601,963.15",Ad9E80698c5b908,9344,Daisy,Pitts,Patel-Joseph,Gentryside,Somalia,+1-506-458-7905,+1-486-589-0943,bensoncalvin@garrett.com,2022-04-11,https://www.farmer-norris.com/
01-Jan-2021,Transfer,00.00,"433,660.53","2,168,302.62",74B1Ba10d79dDbe,5318,Erin,Spence,Thomas-Chandler,Dennisport,Liechtenstein,998.310.9489x438,(262)895-6370x438,knicholson@berger.info,2020-06-30,http://hardy.info/
01-Jan-2021,Reversal,00.00,"240,922.51","1,927,380.11",C9049ef777eB985,2630,Chloe,Morrow,Arellano and Sons,West Dianatown,Gambia,782.734.2964,6099315942,claireowen@schneider-norman.info,2021-04-21,http://scott.com/
01-Jan-2021,Debit Card,00.00,"385,476.02","1,541,904.09",B5a4DF53afbd3FE,6427,Karla,Trujillo,"Maynard, Knight and Peck",Lake Harold,Guadeloupe,+1-661-232-0029x60054,325-056-4964x8428,mitchelljoseph@cohen.com,2021-09-17,https://www.howard.org/
01-Jan-2021,Cheque,00.00,"513,968.03","1,027,936.06",0d067dbEd7A39eA,6475,Brittany,Jordan,Mathews and Sons,West Collinborough,Algeria,3083702586,640.751.1560x4523,vward@chandler.com,2021-01-04,http://www.phelps-lowery.info/
01-Jan-2021,Purchase,00.00,"146,848.01","881,088.05",8e2Cb63f4FA05B8,2189,Janice,Mills,Jones-Davenport,West Rodneyhaven,Greece,001-036-819-8375,731.201.1266,terri08@donovan.com,2021-04-26,http://www.huerta.org/
01-Jan-2021,Tax,00.00,"97,898.67","783,189.38",0c7485d9394960a,739,Joy,Doyle,Munoz-Barrera,North Christina,Mexico,4114446284,5915755738,valerie26@luna-mccarty.com,2020-08-06,https://hebert.com/
02-Jan-2021,NEFT,"10,275.91",00.00,"793,465.29",4D0407Be283add2,178,Claudia,Woods,Diaz-Rangel,New Angelica,Jamaica,+1-402-413-0629x783,440.385.1482,lonnieguerra@cooke.com,2020-10-17,https://wallace.com/
02-Jan-2021,Commission,220.50,00.00,"793,685.79",cBf502b528ed889,2808,Cameron,Leonard,"Morgan, Santiago and Gaines",Schneiderhaven,Taiwan,613-329-9419,001-825-385-2046,victoriamccullough@joyce-villegas.com,2020-10-21,http://www.rollins.net/
02-Jan-2021,RTGS,"178,914.00",00.00,"972,599.79",cf5EfBBBcF9eDcb,7010,Sandy,Delgado,Pennington Inc,Maciasville,Uruguay,+1-562-318-0154x5624,544.070.9619x9515,mindy57@yu.com,2021-06-04,https://chambers-robertson.com/
02-Jan-2021,RTGS,129.00,00.00,"972,728.79",153AB6DbCE4854c,9297,Yolanda,Haynes,Carr PLC,Port Robertofort,El Salvador,(898)601-9971,433.361.6402,royhouston@parrish.com,2020-05-17,http://tate.com/
02-Jan-2021,Reversal,00.00,"138,961.26","833,767.53",cc4AF4bDAedc57d,1271,Elizabeth,Avery,Maddox LLC,Sarahmouth,Guernsey,739-055-7614x58257,001-480-830-4807x690,joanna87@morales.net,2020-11-12,http://www.faulkner-nielsen.org/
02-Jan-2021,Bill,351.34,00.00,"834,118.87",E2cD6c1C328e61B,5378,Sheri,Hall,Ritter-Holt,Port Michaelamouth,Central African Republic,(229)736-5499x814,001-463-169-5637x306,lisacalderon@pittman.com,2021-12-26,https://galloway-jackson.org/
02-Jan-2021,NEFT,"34,751.88",00.00,"868,870.75",EfB0A49ADfc3246,2565,Dawn,Holden,"Booker, Kennedy and Cooley",Lake Normahaven,Palestinian Territory,021-631-1820x6344,+1-619-236-8750,orozcotravis@underwood.com,2021-11-29,http://anthony.com/
02-Jan-2021,Transfer,00.00,"144,811.79","724,058.96",6DfCf0BBFA5AF2A,5484,Carmen,Wolf,"Cannon, Levy and Pittman",Weberfurt,Turkmenistan,862.600.5924x44611,(052)060-8341x85340,kroach@walton.biz,2020-04-20,http://mcdaniel.info/
02-Jan-2021,IMPS,431.10,00.00,"724,490.06",701EC3F3Aa5EA1b,7262,Arthur,Stokes,Boyer and Sons,Port Rebeccaport,Belarus,001-981-864-7055x101,+1-671-645-9797x29905,clayton77@gilmore.com,2022-05-26,https://www.pollard.com/
02-Jan-2021,NEFT,07.00,00.00,"724,497.06",1B0Dd9AafC99B87,1629,Harold,Short,Cooper Inc,Port Sherry,Turkmenistan,871.875.9449x7697,(633)752-6137,austinbarrett@simon-roberson.com,2021-09-04,https://brewer.biz/
02-Jan-2021,Tax,"1,718,922.00",00.00,"2,443,419.06",78EF2aaEfA71DdD,2929,Cory,Mcintyre,Coleman-Steele,Gracemouth,Brunei Darussalam,001-504-152-3758x45756,001-757-118-4165x545,cameronbrenda@ortega.biz,2020-04-07,http://hodges.com/
02-Jan-2021,Miscellaneous,144.90,00.00,"2,443,563.96",CDF7437bECaCCFE,4717,Alexandria,Ibarra,Acosta-Waters,Terryberg,Thailand,4339893117,1216564766,gaustin@hays.info,2020-04-15,http://www.cochran.org/
02-Jan-2021,Transfer,05.00,00.00,"2,443,568.96",FefddFAd7a6AfD1,4806,Geoffrey,Hammond,Oneill-Lawson,Bridgetton,Nepal,(653)031-5183x20332,+1-975-216-7757x950,shari49@mason-floyd.com,2021-04-05,http://www.black-mercado.com/
02-Jan-2021,Commission,"209,665.00",00.00,"2,653,233.96",1FCc1f1A134119F,8088,Joanne,Mcpherson,Chase-Delacruz,Lake Amber,Namibia,+1-585-460-6565,001-458-055-3774,devonrosales@odom-haley.com,2020-10-05,http://davis.com/
02-Jan-2021,Miscellaneous,00.00,"442,205.66","2,211,028.30",D334ABA9AD73Da1,4579,Jodi,Mcclain,Burns-Torres,Rickeyside,French Guiana,426.647.8383x053,(542)759-2687,lesliedavila@eaton-kane.net,2021-09-28,https://powers.com/
02-Jan-2021,Bill,"20,728.39",00.00,"2,231,756.69",D8BEFBDBC2f37B1,5594,Cheryl,Reilly,Newton-Aguirre,Port Brady,South Georgia and the South Sandwich Islands,+1-583-584-5528x07142,001-568-514-0368x227,blake59@edwards.com,2020-04-13,http://www.barrett.info/
02-Jan-2021,Bill,00.00,"743,918.90","1,487,837.79",3d047e653eFB3DE,8044,Jacob,Morgan,Harvey-Harding,Bernardtown,Japan,(732)163-4949x16873,523.496.4224,anthonyjose@campbell-levy.com,2020-02-28,http://weber-hardy.com/
02-Jan-2021,ATM,00.00,"1,487,837.79",00.00,DFf951FF9Be6FCF,8508,Kaitlin,Valencia,"Petersen, Wilkinson and Cooper",North Savannah,Swaziland,+1-495-698-4425,906.207.2160x0696,dodsonashley@sheppard.org,2020-01-04,https://www.stafford.com/
02-Jan-2021,Interest,"2,450.00",00.00,"2,450.00",Fcd0Ae434dbD7E7,7215,Parker,Wiley,Mcdonald-Blake,New Donna,Solomon Islands,758.576.1186,(619)685-8672x548,reginald41@jacobson.info,2021-12-28,https://klein-morgan.com/
02-Jan-2021,IMPS,"2,061.60",00.00,"4,511.60",AEfAd4c1ea66Fb4,9973,Dalton,Fischer,"Vincent, Wiggins and Perry",South Aliciaville,Angola,(531)376-9227,001-204-122-2408,joannosborn@fitzpatrick.org,2022-04-21,http://www.huang-hamilton.org/
02-Jan-2021,Miscellaneous,00.00,902.32,"3,609.28",F41d606ccbd7F10,717,Nina,Logan,"Zuniga, Callahan and Harmon",Pattymouth,Malawi,+1-603-786-5143x21164,001-210-792-5761x69630,heidi78@parsons.com,2021-06-12,https://www.graves.org/
02-Jan-2021,RTGS,"660,785.25",00.00,"664,394.53",3c8D0CbDaD16ecA,8143,Julia,Stone,Solis Group,North Tasha,Netherlands Antilles,(777)954-3562x282,001-446-852-9763x120,chelsey56@cisneros.biz,2022-02-14,http://mcclain.com/
02-Jan-2021,NEFT,692.96,00.00,"665,087.49",93Dc2FA13F8bab3,149,Casey,Miles,Church-Boyle,Jocelynbury,Italy,(219)384-5940,8480138604,elizabethcopeland@morris-moss.info,2021-09-17,http://bautista.com/
02-Jan-2021,Cheque,"1,224,926.80",00.00,"1,890,014.29",D72c1BAdDAFfECa,2560,Bradley,Richard,Durham-Martinez,Lake Deanna,Korea,001-598-694-3519x215,+1-151-437-1818x9987,sbaxter@burnett.info,2022-02-22,https://weaver.info/
03-Jan-2021,Debit Card,16.87,00.00,"1,890,031.16",b67ae17e6BA1D9e,4544,Lawrence,Little,Mullins-Alvarez,Daisyville,Bouvet Island (Bouvetoya),590.009.0191,279-078-5612x523,sherry20@love.com,2020-05-01,http://www.franco.info/
03-Jan-2021,Miscellaneous,04.93,00.00,"1,890,036.09",5080F7aAbFdf2b2,1164,Darlene,Hart,Rush LLC,New Mitchellview,Niue,+1-750-216-6997x48025,619-648-9032x3705,margaret64@ponce.org,2020-01-25,http://nunez.com/
03-Jan-2021,Debit Card,00.00,"189,003.61","1,701,032.48",Fae7cAFd65F7fBf,1941,Peter,Parks,"Pham, Holmes and Wyatt",Douglasburgh,Tokelau,+1-313-724-4645,117.693.2475x9301,ralphking@mata.com,2021-01-25,https://atkins.com/
03-Jan-2021,Reversal,00.00,"189,003.61","1,512,028.87",B0bba4E0d0FE1DC,912,Nicole,Parker,Whitehead-Carpenter,Hernandezville,Bulgaria,+1-235-384-5758x13467,761-965-3775x62082,eproctor@cain-osborn.org,2020-01-19,https://woodard-hickman.com/
03-Jan-2021,RTGS,17.60,00.00,"1,512,046.47",Cb994EA466ae830,4743,Margaret,Carter,"Walton, Rowe and Hanna",Donaldland,Uruguay,634-283-6940x96754,(749)709-8352x581,cashley@bates.net,2020-11-28,http://www.herman.com/
03-Jan-2021,Tax,00.00,"504,015.49","1,008,030.98",a9A1D703Fec0F35,9109,Donna,Woodward,Bradley-Ponce,Coxbury,Svalbard & Jan Mayen Islands,001-580-548-8845x342,050-899-0590x214,phurley@madden.com,2020-04-11,https://www.pratt.biz/
03-Jan-2021,Purchase,00.00,"168,005.16","840,025.82",eDBe8ceFF4cd853,5413,Shane,Gonzales,Vincent-Hanson,North Miguelville,Macedonia,+1-568-310-9711,001-031-100-9057x119,greggcontreras@hunt-stevenson.net,2020-04-19,http://anthony.net/
03-Jan-2021,IMPS,17.00,00.00,"840,042.82",E2fEF1bA17A5A4B,2454,Drew,Rubio,Daugherty-Cruz,New Melaniefurt,Somalia,0394431738,001-865-775-3311,barrybrittney@ramsey-villegas.com,2020-02-14,http://sandoval.com/
03-Jan-2021,RTGS,00.00,"120,006.12","720,036.70",6a43066D6a73E8C,9217,Marcia,Michael,Schroeder Inc,Mejiaberg,Iran,(768)336-2169x4540,(606)531-7508x91174,huffdaisy@crane-barber.com,2020-06-02,https://www.davidson.org/
03-Jan-2021,ATM,00.00,"720,036.70",00.00,EAfBF262Df9E2fb,4079,Darlene,Horton,Benton and Sons,North Danny,Vanuatu,575.104.9648,220-882-6455,gavinriggs@maxwell.com,2021-08-26,https://www.becker.net/
03-Jan-2021,Interest,06.00,00.00,06.00,6C9c59C9c4CffDC,5966,Daniel,Francis,Fleming Group,New Philip,Bosnia and Herzegovina,534-857-5285x0167,173.866.6431x96642,suttonhector@welch.com,2021-03-25,http://www.gallegos.com/
04-Jan-2021,Cheque,00.00,00.67,05.33,266b2AAb9887Ee0,2087,Kristine,Lane,"Tanner, Mathews and Carson",New Meghanburgh,Vanuatu,812.662.7950,942-421-9038,sydney92@house.org,2020-12-24,http://barton.com/
05-Jan-2021,Interest,00.00,00.76,04.57,815Bcc5e222Afff,2502,Roberta,Mccall,Estes-Welch,Schmittland,Kiribati,4915281375,010-467-4008x90808,craigdalton@strickland.com,2021-02-20,http://hines-mcfarland.com/
05-Jan-2021,Interest,"3,471.00",00.00,"3,475.57",1cBAdC365B1D194,8060,Glen,Payne,"Reyes, Cobb and Newton",North James,Honduras,953-535-4339x2890,931-533-6106x7189,christie61@phillips.info,2021-08-21,http://hays.com/
05-Jan-2021,Miscellaneous,00.00,695.11,"2,780.46",2AdaCF424D7Ab1a,2820,Elijah,Blair,"Roach, Webster and Medina",Alvinbury,French Polynesia,(951)041-6976x05879,(395)398-2747,kennedymarc@sims.com,2020-07-10,http://www.daugherty-hooper.biz/
05-Jan-2021,RTGS,"25,272.00",00.00,"28,052.46",E81BEcaEa302f6E,9582,Gina,David,"Spears, Salazar and Waters",Cristinaville,Tonga,(479)881-4290x17160,(206)691-5565x6023,daryl33@shaffer-liu.net,2020-12-11,https://www.lloyd.biz/
05-Jan-2021,NEFT,"1,875.00",00.00,"29,927.46",fe51ef5bEcb9B3a,9553,Breanna,Moran,"Maddox, Cabrera and Donaldson",Oscarburgh,Honduras,073.104.4157,367.206.8377x7278,jilliandoyle@bridges-walker.biz,2021-08-18,https://www.salinas.com/
05-Jan-2021,Miscellaneous,824.00,00.00,"30,751.46",5aDcF9C8dbAd83D,7515,Ashley,Tyler,Calhoun Inc,West Corey,Bangladesh,001-950-701-2057x47608,001-350-148-2596x493,paula93@hodges.biz,2020-07-11,https://christensen.com/
05-Jan-2021,Cash,00.00,"10,250.49","20,500.97",FC4F3aa4Da936C9,4007,Mckenzie,Kerr,Terry-Durham,East Lee,Brunei Darussalam,(745)679-5351,727.166.5000,kimhill@norman.info,2020-11-04,https://www.chambers.net/
05-Jan-2021,Interest,00.00,"6,833.66","13,667.31",A2DAc64BCE2Cb28,597,Breanna,Riley,Everett LLC,New Anna,Argentina,198-358-3768,+1-958-335-0321,parkstraci@dunlap.org,2020-05-02,https://www.mclaughlin.com/
05-Jan-2021,Transfer,"9,644.05",00.00,"23,311.36",77E31aee6FfE5AB,6782,Lonnie,Butler,Howard PLC,Fieldsmouth,Macedonia,(923)250-6226x441,6397175379,mathewford@irwin.com,2020-06-18,http://davies.com/
05-Jan-2021,NEFT,"167,284.41",00.00,"190,595.77",3afF6b5bcdE5ECF,5953,Karina,Rogers,Webb Ltd,North Noahfort,Taiwan,041.102.0888x430,(059)090-1792,brianna78@parrish-mccann.biz,2021-08-25,https://brock-burgess.net/
05-Jan-2021,Debit Card,00.00,"21,177.31","169,418.46",0e5d94FC6778978,1853,Suzanne,Terry,Richmond PLC,South Elainetown,Angola,818.794.0389x82537,6719858432,sherry54@pitts-greer.com,2022-02-04,http://glenn-levine.com/
05-Jan-2021,Reversal,00.00,"33,883.69","135,534.77",F2E6dB05ACb4e51,4080,Robyn,Randall,"Meadows, Kline and Buckley",East Jesse,Argentina,+1-855-938-4225,991-301-1432x66247,maria83@villanueva-cordova.com,2020-06-11,http://sutton.com/
05-Jan-2021,IMPS,08.93,00.00,"135,543.70",Ea5c0e13f25520D,7348,Glen,Herrera,"Clements, Morrison and Wright",East Sydneymouth,Malawi,189-066-6270x893,(555)039-3934x9581,jackhale@lyons.com,2021-12-05,http://christensen.info/
05-Jan-2021,RTGS,00.00,"45,181.23","90,362.47",ffa51f5D9A3c1B6,8634,Alison,Khan,"Lynn, Curry and Soto",West Lorraine,Uzbekistan,(476)771-5493,4118695896,fbrock@turner-henson.biz,2021-12-19,http://www.king-luna.com/
05-Jan-2021,Cash,00.00,"30,120.82","60,241.65",B77Fde32070A50A,8561,Frederick,Chandler,Cochran-Mercado,Ortizton,Gambia,(708)995-4120x952,001-691-103-6146x3894,joann13@mathis.com,2021-10-23,https://flowers-serrano.com/
05-Jan-2021,Commission,00.00,"6,693.52","53,548.13",061AB1b3530F3Fd,177,Brandon,Browning,Hayes Group,Meyerview,Libyan Arab Jamahiriya,001-366-571-1158x8709,001-830-240-2243,gabriellanorton@robertson.org,2021-04-17,http://www.pena.com/
05-Jan-2021,Interest,00.00,"26,774.07","26,774.06",5dbb4Afcb541F5b,3268,Damon,Singh,"Lara, Dorsey and Horne",Marissaburgh,Papua New Guinea,525-210-9357,(118)695-2962,sydney74@douglas.com,2020-08-21,http://www.buchanan.com/
05-Jan-2021,Cheque,24.00,00.00,"26,798.06",b7Ec34eEED9D32f,2619,Jay,Morton,Simon LLC,Birdbury,Holy See (Vatican City State),001-949-311-3753x541,(694)574-7080x291,ginaberger@riddle.info,2020-03-20,https://douglas.biz/
05-Jan-2021,Transfer,00.00,"13,399.03","13,399.03",6a8d8a2c580681C,9817,Misty,Owens,"Gallagher, Glover and Watson",Alvaradomouth,Suriname,001-501-301-5394x263,+1-572-050-1951x7106,imathews@chaney.com,2020-08-25,https://jones.com/
05-Jan-2021,ATM,"1,570,038.80",00.00,"1,583,437.83",aBcaaa9B6Fe122D,6374,Diamond,Reed,"Glover, Wyatt and Shaw",Brooksburgh,Liechtenstein,124.257.8120,(296)790-0002,pollardamy@parker.com,2022-05-27,https://lindsey-spencer.com/
05-Jan-2021,Miscellaneous,00.00,"527,812.61","1,055,625.22",ce5aB7c9c4B60Ab,203,Norman,Washington,"Ibarra, Hobbs and Mccarthy",Port Marisa,Iraq,001-069-1845,(477)096-7380x952,ariana05@kelly-arellano.com,2021-01-10,http://www.conrad.com/
05-Jan-2021,Cheque,349.00,00.00,"1,055,974.22",757c5420e96dd59,6046,Loretta,Stewart,"Sheppard, Mccormick and Cortez",Port Austin,French Southern Territories,001-424-076-7760x0918,(503)926-1142,dana89@gregory-little.biz,2022-04-22,http://frederick-mckay.com/
05-Jan-2021,ATM,00.00,"105,597.42","950,376.80",36FA5DAD1Dd3C8d,6227,Debra,House,Romero Inc,South Jenniferstad,Uganda,+1-940-044-9397x0828,001-095-244-3120x866,derrickpace@warner.info,2022-04-28,https://pruitt.com/
05-Jan-2021,Bill,00.00,"105,597.42","844,779.38",d6b82c7FFA07DAD,2370,Pam,Buckley,Glover and Sons,East Sheila,Syrian Arab Republic,889.041.8991,763-297-0683x013,jerrydean@oneal.com,2020-07-14,http://www.rhodes.org/
05-Jan-2021,Commission,04.10,00.00,"844,783.48",2E2248a23f853E5,8360,Jesus,Rosario,Andrews-Walker,East Beverlyville,Tokelau,348-505-3775x2174,001-257-721-9913,renee50@villarreal.com,2020-10-06,https://www.miranda.org/
05-Jan-2021,ATM,"160,879.20",00.00,"1,005,662.68",1c08e6dB6FB09B8,8866,Stefanie,Rosario,"Porter, Luna and Christian",Christinaside,Egypt,467-641-7345,1861203167,roachcarly@roy.net,2021-12-26,https://www.gates.com/
05-Jan-2021,Tax,07.30,00.00,"1,005,669.98",deCf41e6dE5A2EE,1288,Antonio,Morrison,Morris-Mora,Julianside,Serbia,001-581-578-3474x71536,001-357-336-9093x902,kochbrendan@walter.biz,2021-05-26,http://arroyo-hayden.net/
05-Jan-2021,IMPS,"2,562.12",00.00,"1,008,232.10",A87ADB9f283fBBC,5774,Sandra,Fitzgerald,Vazquez and Sons,North Carlmouth,Taiwan,(354)535-0766x42008,4789416814,chobbs@richmond.biz,2021-01-29,https://www.ramsey.org/
05-Jan-2021,RTGS,"1,467,818.00",00.00,"2,476,050.10",DFD4d99FfC122ad,3932,Jaime,Hurst,Ball and Sons,New Leonborough,Philippines,(268)578-0555x993,(838)161-6287x15543,lreeves@sutton.com,2020-08-20,https://www.myers-gaines.com/
05-Jan-2021,Purchase,00.06,00.00,"2,476,050.16",2A0f5CFFf389edF,3701,Patty,Cortez,Mccoy Group,Laceyfurt,Isle of Man,586-445-4025x38212,001-557-416-0663x101,vweiss@stokes.com,2021-12-29,https://mendoza.com/
05-Jan-2021,Purchase,41.00,00.00,"2,476,091.16",Ec5Db1e82E09edB,5780,Dominique,Brewer,Hutchinson-Buchanan,North Jim,Liechtenstein,296-935-5166,517-289-8836,gbowers@black.com,2020-08-31,http://prince.com/
05-Jan-2021,Bill,53.26,00.00,"2,476,144.42",2d2E8e0fE60Cd74,9742,Stacey,Deleon,Fletcher LLC,Garnerfurt,Malawi,+1-528-620-6362x4202,001-086-873-3510x59114,erik33@wilson.info,2020-11-30,https://www.cook.com/
05-Jan-2021,ATM,"1,698,885.50",00.00,"4,175,029.92",171D9DEaF3C28CF,9899,Joyce,Fitzpatrick,Collins Inc,Lake Victorhaven,British Virgin Islands,4689688672,(917)842-8210x9324,maxjimenez@yoder-rush.com,2021-03-22,http://buck-haney.com/
05-Jan-2021,Transfer,00.00,"417,502.99","3,757,526.93",37Ea8Ed9Cd5c50d,4253,Kristen,Singleton,"Edwards, Andersen and Richards",South Kaitlinhaven,Morocco,001-748-587-9872x92384,321-708-8423x33208,hwhite@morton-marks.com,2020-06-29,https://rubio-cabrera.com/
05-Jan-2021,RTGS,"27,686.70",00.00,"3,785,213.63",5a173aA3E4d7B6d,3548,Mitchell,Lam,Green PLC,New Kathy,Comoros,(830)780-4690x357,027-025-6101x088,coffeydan@daniels.com,2021-04-16,https://www.clarke-hendricks.info/
05-Jan-2021,Cash,00.90,00.00,"3,785,214.53",7e4116Fd3Cf4a8b,4502,Joanne,Orozco,Mcconnell and Sons,Baileymouth,Uganda,870.485.2365x6794,+1-690-576-2217,csantana@stein.com,2020-06-15,http://horn.com/
05-Jan-2021,Bill,00.00,"630,869.09","3,154,345.44",bbF53eAFa3fc07c,3302,Shelia,Wagner,Humphrey and Sons,Port Jimview,Gibraltar,(620)981-1444x754,108.991.0585,huffmanmichele@kent.com,2021-07-21,http://www.dominguez.net/
05-Jan-2021,Commission,00.00,"1,577,172.72","1,577,172.72",7d4b0cB7f1b07b0,5890,Ronnie,Watkins,Russo-Hines,South Ralphside,Andorra,412.668.0132,8599205667,amandawaters@bentley.net,2020-06-24,http://yoder.com/
05-Jan-2021,Cash,00.00,"225,310.39","1,351,862.33",aDD9391DeBdF839,6972,Malik,Sullivan,Donaldson and Sons,Rosarioport,Montserrat,(926)659-8757,(236)764-9445x027,danielle18@francis.com,2022-01-19,http://snyder.com/
05-Jan-2021,Bill,00.00,"270,372.47","1,081,489.86",e5A4B3DCbBbED8e,7513,Sheila,Dalton,"Kirk, Flores and Osborn",North Marieton,Grenada,939-081-5246,846.754.8987x3779,dyerdillon@bridges.info,2020-11-13,http://mayo.info/
05-Jan-2021,NEFT,00.00,"135,186.23","946,303.63",98Af09C3BfCe2c3,239,Sheri,Arnold,Warren Ltd,Dorothymouth,Haiti,001-959-964-0415x510,881-870-7916x29626,walterfrye@good-boyer.com,2020-04-12,http://christian.com/
05-Jan-2021,Cheque,00.00,"135,186.23","811,117.40",e0A95AAc175f189,847,Margaret,Norton,"Blackwell, Marshall and Summers",Lake Caitlinport,Comoros,521-727-6174x36953,+1-706-892-6648,ucoffey@hoffman-russo.biz,2021-03-18,http://wise.com/
05-Jan-2021,Miscellaneous,00.00,"811,117.40",00.00,B4f75e00EcEdC35,8681,Cheyenne,Arroyo,Barrera-Huynh,New Brandi,Liberia,001-795-834-4538x30390,(618)743-2429,gloriafarmer@bailey-ray.info,2020-12-28,https://herman.org/
05-Jan-2021,Commission,33.70,00.00,33.70,3Df3edCA4c98abD,9971,Shelley,Raymond,Holden and Sons,Port Jennybury,Ecuador,001-840-8597x3036,0045134154,caitlin15@rollins.com,2022-05-29,http://chapman.com/
05-Jan-2021,NEFT,72.86,00.00,106.56,A4BA3935d481bfB,3644,Randy,Davies,"Malone, Larsen and Baird",Oconnorstad,Romania,001-985-438-9835x041,834-412-1122,brandi65@baldwin.org,2020-02-20,http://www.solis-powell.info/
05-Jan-2021,Cheque,"540,286.25",00.00,"540,392.81",E6C47b74D34BfE3,6676,Yvonne,Nash,Fowler-Obrien,West Sarahton,Bouvet Island (Bouvetoya),(318)242-9807x7403,+1-482-767-0257,dlucas@carson.biz,2020-08-22,https://www.brewer.com/
05-Jan-2021,Transfer,293.90,00.00,"540,686.71",f1AEf0D7E5Daed9,7594,Daryl,Blackburn,Mayo-Dudley,East Roy,Djibouti,464.989.5672x42735,+1-722-367-3988x12670,raymondkent@quinn.net,2022-02-21,https://www.whitaker.com/
05-Jan-2021,Bill,36.00,00.00,"540,722.71",B99C38a8cCb3D7e,6280,Darrell,Frazier,"Hess, French and Deleon",North Anthonyside,Bolivia,(507)763-3346x490,436.694.7314x54992,betty09@ramos.com,2022-05-22,https://nunez.net/
05-Jan-2021,Purchase,00.00,"108,144.54","432,578.17",3Df50f93B1504f9,5968,Caroline,Kaiser,"Flynn, Moyer and Charles",West Donnachester,Nepal,751.366.2396x8678,064-238-9158x899,daleyu@donaldson.biz,2020-08-27,http://short-riddle.com/
05-Jan-2021,Debit Card,00.00,"48,064.24","384,513.93",2bAEd7C6cbeb0fD,8573,Cindy,Ritter,Glenn Inc,Bobland,Iran,603.471.0800x11145,841.689.3779x203,gentryperry@hill.biz,2020-11-20,https://www.ibarra.com/
05-Jan-2021,Cheque,"3,023.00",00.00,"387,536.93",d89E71A66cF3E3A,4290,Martha,Mathews,Klein-Pace,Chadhaven,Barbados,139-565-0798x048,046-454-5161,stacey69@barron-hughes.com,2021-01-12,http://www.copeland.biz/
05-Jan-2021,ATM,00.00,"77,507.39","310,029.54",4BaF8E0055792AD,9774,Julie,Hudson,Douglas-Mata,Collinston,Holy See (Vatican City State),403.638.5351,5195198774,emoore@huang-hatfield.com,2020-07-17,https://www.perez.com/
05-Jan-2021,Purchase,00.00,"155,014.77","155,014.77",fFED50f5A906AC7,4942,Mary,Newton,"Huber, Gonzales and Swanson",Pettyberg,Andorra,755-070-5626,376-966-0872x331,fduffy@bonilla.info,2021-05-03,http://orozco.org/
05-Jan-2021,Commission,"2,896.45",00.00,"157,911.22",d83Aaee229805fe,8436,Breanna,Moreno,Hodges Inc,Annashire,Sri Lanka,+1-378-820-4257x621,187.743.1721x143,megan26@avila.com,2020-07-28,http://www.skinner-huang.org/
05-Jan-2021,Reversal,"1,777.00",00.00,"159,688.22",E46e5aC532db578,1470,Roberta,Underwood,Lambert Inc,Prestonville,Antarctica (the territory South of 60 deg S),1457391664,(581)091-6999x3420,steven99@acosta.org,2022-05-06,http://mclean.com/
05-Jan-2021,Reversal,03.72,00.00,"159,691.94",bE13C300faDAE19,7864,Jonathan,Atkins,Zuniga-Lynch,New Jeromeport,Seychelles,(070)902-6164,(832)818-1234x902,alicevelasquez@pena-parker.biz,2020-01-09,http://www.boyle.com/
05-Jan-2021,Interest,"1,974,280.00",00.00,"2,133,971.94",7C81C2daAAAaaC8,4594,Loretta,Ramsey,Leonard-Hall,Burgesston,Moldova,978-272-2550x19043,+1-945-603-3380,barrkeith@cantrell.org,2021-11-24,http://www.calderon.com/
05-Jan-2021,Cash,00.00,"426,794.39","1,707,177.55",AB2EDb72c2AcD24,1335,Kristen,Dunlap,Gordon and Sons,Billyberg,Western Sahara,+1-823-640-1196x567,(091)806-4617,makayla42@carr.com,2021-11-24,https://www.cuevas.info/
05-Jan-2021,Commission,00.00,"284,529.59","1,422,647.96",4E06F1Ea7E072D2,9502,Ana,Dalton,Charles LLC,Rachaelshire,Cuba,(748)418-3424x5194,(862)493-9842x8218,weeksmercedes@stevens-turner.com,2022-02-27,https://www.powers-villa.org/
05-Jan-2021,Cash,00.00,"177,831.00","1,244,816.96",FA1BAa4BabCD83A,4225,Tony,Huang,Abbott-Pena,Boothfort,Syrian Arab Republic,884.384.2903x23861,010-516-8943,michele72@garrett.org,2020-07-04,http://www.newman.org/
05-Jan-2021,Transfer,00.00,"311,204.24","933,612.72",c58Ae51282CB929,9366,Alejandro,Orozco,Carlson and Sons,Joseville,Korea,056.536.4448,001-864-337-6510x9043,donovanjaime@farmer-cochran.com,2022-02-12,http://www.brock-lozano.com/
05-Jan-2021,Tax,00.00,"466,806.36","466,806.36",27980Ea6fDfe0ed,2080,Belinda,Buckley,"Joseph, Fritz and Lin",Port Joan,Angola,(288)504-2804,392.031.9185x31100,ihensley@buck.com,2020-02-06,http://www.long-strong.com/
05-Jan-2021,Tax,00.00,"116,701.59","350,104.77",dE03Ad0E6Ca4aB5,3975,Edward,Case,Glenn Group,Thorntonland,Antigua and Barbuda,(515)552-0218x6175,794-978-8373x2998,meltonangelica@everett-leonard.net,2022-05-25,http://www.barnett.info/
06-Jan-2021,Reversal,"152,957.00",00.00,"503,061.77",b19bCAF021ecE2C,6538,Amber,Nguyen,"Abbott, Sampson and Huynh",Brendanland,Albania,751-762-9417x80561,(557)201-2638x9992,shelley60@ryan-rosario.com,2020-06-11,http://www.santana.com/
06-Jan-2021,Transfer,00.00,"55,895.75","447,166.02",b4Fd62e2cC113df,3712,Hayley,Steele,"Alvarado, Drake and Molina",Carlberg,Angola,841.534.8981,205-718-0628x521,chase92@mcfarland.com,2022-04-23,http://www.lucas.com/
06-Jan-2021,Debit Card,00.00,"49,685.11","397,480.91",28BfC92daC1EFAd,7738,Tyler,Carey,Key Group,Snyderville,Eritrea,531-787-4331,(586)967-5842x06412,vobrien@allen.biz,2021-10-06,https://www.chavez.com/
06-Jan-2021,Tax,00.00,"132,493.64","264,987.27",Bc9Cda3AAEED2DA,434,Kristi,Dixon,Kim Inc,South Rodneystad,Palau,(523)214-3540,001-614-536-6394,lindsaymiranda@atkinson.info,2021-12-04,https://wiggins.com/
07-Jan-2021,Bill,00.00,"66,246.82","198,740.45",5ED5a0B6118d0DA,4712,Steve,Foster,Olson-Ingram,Jesusburgh,Antigua and Barbuda,(287)762-8610x610,(561)082-6006,sheilarogers@parks.org,2021-01-05,http://avery.com/
07-Jan-2021,Debit Card,00.00,"22,082.27","176,658.18",d52E11eD497ee4d,525,Tommy,Hancock,Bender-Holloway,Lake Shelby,Micronesia,228.715.0816x6277,0845557495,arthur83@solomon.biz,2021-03-16,http://www.finley.com/
07-Jan-2021,Bill,"1,794.59",00.00,"178,452.77",1DeA9ff7bC60be0,9238,Mindy,Ball,"Avery, Robbins and Ross",Perryburgh,Saint Martin,001-571-725-7413,+1-650-907-8691x23600,kbrooks@meyers.com,2020-07-11,https://www.white-burton.com/
07-Jan-2021,Cash,00.00,"22,306.60","156,146.17",0DBBfcBd1e88F5D,3534,Jody,Mooney,Richard-Warren,West Tim,Palau,633-570-0780x60794,+1-519-071-3379x998,pattyhunter@davies-shelton.com,2020-04-24,https://garza-valdez.com/
07-Jan-2021,Cash,"160,413.72",00.00,"316,559.89",EBf46DBa0d72C47,1603,Cristian,Stevenson,Gibbs Group,Port Xavier,Colombia,(644)040-6505,133-459-4871,jorgesampson@roach-hull.com,2020-05-19,https://barnett-reed.biz/
07-Jan-2021,Bill,00.00,"35,173.32","281,386.57",3E7cE125CFAf8db,7641,Connor,Conley,Matthews Inc,Larsonport,Zimbabwe,652-680-0839x464,215-102-2215,mccoysally@jenkins.com,2022-04-16,https://robbins.com/
07-Jan-2021,Reversal,00.00,"46,897.76","234,488.81",6C9c59C9c4CffDC,5966,Daniel,Francis,Fleming Group,New Philip,Bosnia and Herzegovina,534-857-5285x0167,173.866.6431x96642,suttonhector@welch.com,2021-03-25,http://www.gallegos.com/
07-Jan-2021,Debit Card,00.00,"29,311.10","205,177.71",9fDC942618dF0cb,3957,Jody,Jacobson,Bennett-Vang,Shariside,Sao Tome and Principe,+1-669-799-2435x91609,(431)613-1377,chadzhang@hancock.com,2020-06-02,https://www.madden.org/
07-Jan-2021,ATM,47.78,00.00,"205,225.49",cD7a3fE5AffeFa8,4277,Tom,Bailey,King Inc,Lake Christineville,Iran,681-977-1685,904.773.9453,eduardo39@bass.com,2021-01-20,http://www.howe.com/
07-Jan-2021,Transfer,00.00,"205,225.49",00.00,Ac0edeD9D6d5e0A,4228,Shawn,Cervantes,"Blankenship, Mcdowell and Hayden",Jeffreyside,Congo,(921)701-6557,417.437.6674,heidi97@morgan.com,2020-10-14,http://gallagher.biz/
07-Jan-2021,Reversal,06.00,00.00,06.00,5faDDad87B098f7,2221,Collin,Flynn,Nguyen-Ryan,New Carol,Angola,(738)353-2672x25311,001-122-957-8137,xpham@banks.com,2021-03-21,https://caldwell-schmitt.net/
07-Jan-2021,NEFT,02.90,00.00,08.90,3bcBa3CBB7EF52c,42,Mario,Moreno,Robles and Sons,Cathyview,United States Minor Outlying Islands,001-044-197-2628x678,001-592-920-6308x2332,marisa13@hickman.com,2022-02-12,https://www.gillespie.biz/
07-Jan-2021,RTGS,"2,048.20",00.00,"2,057.10",E4d3aCaF4be3BDF,4766,Brandon,Rogers,"Nguyen, Harris and Thornton",Rubenland,Guatemala,(982)992-3408,2254622139,mikaylaclay@berry-melendez.com,2022-03-30,http://www.grimes.com/
07-Jan-2021,Cheque,00.00,205.71,"1,851.39",2BDb52292Aac5fe,6718,Shawn,Haney,Aguilar-Blair,Swansonville,Nauru,584-654-5737,(620)767-2190x7400,saralara@brady.com,2021-10-26,http://www.mercer.com/
07-Jan-2021,RTGS,176.00,00.00,"2,027.39",A5BC21eAB190AFE,7446,Henry,Miranda,"Cameron, Williamson and Price",Haroldfurt,Macao,+1-456-415-7502x5762,859-412-7415,jvilla@moody.com,2021-06-08,http://www.odom-carlson.info/
07-Jan-2021,Cheque,"1,233,779.00",00.00,"1,235,806.39",03dDeF0a6206bCd,1506,Jermaine,Hayden,Carr-Chung,Jorgefurt,Libyan Arab Jamahiriya,+1-794-570-4578x177,723.774.6444x37947,lsimmons@chavez-silva.com,2021-03-24,https://ellis.com/
07-Jan-2021,Commission,00.00,"247,161.28","988,645.11",82A64F4BffBC8D0,4110,Isabella,Washington,Taylor and Sons,Dicksonshire,Netherlands,001-606-930-0114x500,+1-021-380-3389x1414,umoody@sheppard.com,2020-06-20,https://figueroa.org/
07-Jan-2021,Interest,"1,155,076.50",00.00,"2,143,721.61",e3CA7aED67FBB0E,4970,Kathy,Rhodes,Spears-Rivas,Port Amanda,Jersey,724.509.7219x5759,001-518-408-1780x4999,caleb96@proctor.com,2020-09-28,http://www.stevens.com/
07-Jan-2021,Reversal,00.00,"428,744.32","1,714,977.29",8d8E4EB4211a2CB,941,Gail,Haynes,Lyons-Wilkerson,Lake Alejandro,Malta,839-774-9671x52599,+1-804-727-8453,bob22@mendez.com,2021-01-07,https://www.simpson-parrish.info/
07-Jan-2021,Reversal,00.00,"1,714,977.29",00.00,AEee37Bb80cd75a,8231,Jane,Chambers,"Henry, Brooks and Malone",North Brendashire,Bolivia,+1-795-073-9423x42121,646.784.6266x56110,sharonschmidt@brooks-jefferson.org,2021-09-06,http://www.dalton-nixon.com/
07-Jan-2021,IMPS,29.00,00.00,29.00,2a0d76703e918Dd,7842,Terry,Mueller,Downs-Vance,Bradyport,Spain,+1-671-148-4910x9099,026-992-2013x94498,ychandler@spencer.info,2020-07-01,https://mccarthy.com/
07-Jan-2021,Debit Card,00.00,07.25,21.75,Dcae5D501C9adD3,1857,Monique,Alexander,"Small, Fox and Lamb",West Shellyview,Bolivia,001-999-291-7401x8115,775-142-8391x19212,arthurwang@pittman-foster.com,2021-07-03,https://www.johns.com/
07-Jan-2021,Transfer,00.00,10.88,10.88,4d88a544Fb359e5,1277,Kurt,Richard,Osborn-Kramer,Wayneberg,Liberia,(606)129-2097x4912,586.949.9890x876,mcdanielkylie@mullins-fletcher.com,2021-07-12,https://www.santiago-richards.biz/
07-Jan-2021,Tax,01.10,00.00,11.98,4248a5584EC671b,2877,Natalie,Camacho,Mcdonald Group,South Mary,Martinique,(206)628-9654,001-323-000-5761x0056,brandon84@gilmore-lester.net,2022-01-17,https://www.hansen-vance.org/
08-Jan-2021,IMPS,00.00,03.99,07.99,16e30af2efbd892,5559,Neil,Castro,Perry LLC,Kimborough,Hungary,+1-838-474-6768x6751,789.948.2000x10108,inorris@crane.com,2020-10-03,https://www.floyd.com/
08-Jan-2021,Interest,"52,299.00",00.00,"52,306.99",946E6faF3c22a9C,9568,Beverly,Chung,Sims PLC,Houstonfurt,Lebanon,(072)076-8034x9717,(590)759-3528,bradleyyolanda@mccullough.info,2020-03-09,http://www.golden-cobb.com/
08-Jan-2021,NEFT,84.60,00.00,"52,391.59",31ab71788D43Adc,5708,Cole,Lam,Schaefer-Barnes,West Shaun,Cape Verde,001-548-541-5116x4452,+1-919-821-4524x0064,chooper@huffman-braun.com,2020-10-28,http://riddle-cuevas.com/
08-Jan-2021,Commission,00.00,"5,239.16","47,152.43",DBD3Bc5ceEbc63f,9735,Kirsten,Kramer,Howard Inc,Port Moniquemouth,Dominican Republic,363.922.7514x111,427-280-0530x82528,hhouse@fields.com,2020-07-06,https://parker-reilly.info/
08-Jan-2021,RTGS,00.00,"4,715.24","42,437.19",270E139f371deD0,3720,Tony,Gould,Mack-Braun,Darrellstad,Vanuatu,006.409.4821,275-954-4639x8716,daltonalvarado@campbell-thompson.net,2022-04-10,http://www.marquez.org/
08-Jan-2021,Miscellaneous,"15,884.00",00.00,"58,321.19",D42D9D73bcc6236,5916,Erika,Mcpherson,White-Vazquez,Lake Sydneyville,Cocos (Keeling) Islands,1518182343,620-291-3514x9265,andres23@hartman-adkins.info,2021-12-30,https://www.kerr.net/
08-Jan-2021,Commission,00.00,"19,440.40","38,880.79",5fcb4b2EAb8A38c,7874,Zoe,Cochran,Harrington Ltd,New Alexisburgh,Tuvalu,308.604.9871,669.993.2856x91657,leonardcalhoun@edwards.biz,2022-02-19,http://velasquez.com/
08-Jan-2021,ATM,01.86,00.00,"38,882.65",660D2B16f85dCAe,5401,Max,Ford,Vaughan Group,Port Aaron,Poland,(409)218-0392x3525,494.388.9026x934,dbird@robles-palmer.com,2022-03-03,https://osborne.biz/
08-Jan-2021,Reversal,"568,882.75",00.00,"607,765.40",84d3FaE8D176217,32,Danny,Mayer,"Serrano, Carr and Hurst",West Bernardbury,Niger,+1-232-090-7002x568,(764)539-0967x909,mindy15@fuentes.org,2020-07-15,http://perkins.com/
08-Jan-2021,Tax,00.00,"607,765.40",00.00,69c0Abbba9c1CFC,5433,Oscar,Fletcher,Avila-Barrera,Jesseton,Burkina Faso,(098)116-4019x187,+1-631-034-4825x362,evelyn37@shah.com,2021-07-28,http://www.higgins.com/
08-Jan-2021,Cheque,"26,415.10",00.00,"26,415.10",dEEAAcaDC0E69e0,8661,Gloria,Hess,Valenzuela-Lowe,Tapiatown,Slovakia (Slovak Republic),001-765-344-6006x022,001-246-705-4677x1947,kherrera@mccullough.com,2020-08-23,http://www.cordova.com/
08-Jan-2021,Debit Card,30.00,00.00,"26,445.10",66fcc960E6728A7,529,Colleen,Mcpherson,Waters PLC,Moralesbury,Burkina Faso,+1-914-039-1522x43899,667-355-8269x14996,nicolemacdonald@horn.net,2020-11-27,http://benson.org/
09-Jan-2021,Interest,00.00,"4,407.52","22,037.58",f7499ED48026efa,1141,Christopher,Douglas,Riddle Inc,Hunterborough,Panama,3840922823,+1-052-483-7675x4287,epierce@ray.com,2022-02-12,https://www.landry.com/
09-Jan-2021,Interest,"50,145.44",00.00,"72,183.02",ecE4bD5De9eA143,4359,Carl,Avila,Ortega Group,West Brittneystad,Zimbabwe,(855)559-8654x7472,001-376-468-1084x2625,terri66@ortega-york.info,2022-03-07,https://www.horne-novak.com/
09-Jan-2021,RTGS,875.00,00.00,"73,058.02",B6bdB2dEB14314e,6261,Cynthia,Ayers,"Riggs, Blevins and Ingram",South Joannaburgh,Cote d'Ivoire,553-496-1686,001-998-346-9650,chelseydurham@archer.info,2021-07-01,http://harding.com/
09-Jan-2021,IMPS,00.00,"7,305.80","65,752.22",CAeaC9Ac43faf92,2671,Alexandria,Hurley,Estrada-Bernard,West Candice,Vanuatu,425-087-3263x360,245.259.4696x445,mirandatimothy@larson.org,2021-06-06,https://www.franklin-cox.com/
09-Jan-2021,Reversal,"3,339.24",00.00,"69,091.46",8a9a10BD9D46b9A,4545,Felicia,Abbott,Wood-Hinton,North Trevorbury,New Zealand,526.367.2552,+1-375-609-2802x5394,tarajones@rios-humphrey.com,2021-07-07,http://www.douglas.info/
09-Jan-2021,RTGS,"19,914.10",00.00,"89,005.56",A3aAabCdAe9A1da,1370,Gabriella,Osborne,George-Stout,New Lorettatown,Bouvet Island (Bouvetoya),001-156-113-9798x196,001-560-779-0245x408,hollyhensley@hunter-mata.info,2020-05-15,http://shaw.com/
09-Jan-2021,Purchase,00.00,"17,801.11","71,204.45",FdF7F6e6D49739a,7420,Jorge,Maddox,Hodge LLC,West Francistown,Faroe Islands,(820)794-9460,(472)778-2822x628,adrienneescobar@gardner.com,2020-05-02,http://www.davenport-gray.com/
09-Jan-2021,Transfer,22.40,00.00,"71,226.85",40E1B3Ed51B65ab,7625,Jon,Weeks,Singleton Inc,Carneymouth,Maldives,494-534-5320x87809,(819)813-8961x4472,cindy98@evans.com,2020-09-09,http://werner.net/
09-Jan-2021,Cheque,24.56,00.00,"71,251.41",b2BDA178e8DDE2c,1121,Oscar,Bush,"Hayden, Woodard and Arnold",Matthewfurt,Peru,+1-212-463-4605,(539)758-6391x3930,ichang@schmitt.com,2021-10-17,http://goodman-morrison.info/
09-Jan-2021,Cheque,"13,159.00",00.00,"84,410.41",4bBEcA2CDCc12Ce,6828,Hunter,Huber,Merritt-Atkins,Desireehaven,Guernsey,+1-999-107-6131x65363,+1-061-775-9142x942,tara21@meyers-garrison.com,2020-12-02,https://benson.com/
09-Jan-2021,Interest,"24,558.30",00.00,"108,968.71",25b867D7ADcdbc8,9391,Denise,Berry,Mcintyre-Lawrence,Lake Meghan,Cyprus,300.729.6290x9467,(218)580-8525,eileen81@prince.net,2021-05-14,http://pineda.com/
09-Jan-2021,Miscellaneous,247.00,00.00,"109,215.71",C2f62DB8E8e0fAB,74,George,Long,"Cochran, Sweeney and Miles",Damonborough,Cote d'Ivoire,292.292.1103x0768,(252)863-4103x848,yolanda69@rosario.com,2022-01-09,http://www.blankenship.com/
09-Jan-2021,Reversal,00.00,"21,843.14","87,372.57",E6eECBCdb9Db2aC,8247,Martha,Salazar,"Kirk, Clay and Schmitt",Laurenton,Serbia,001-960-731-8882,001-113-255-3700x213,crawforddaniel@norman.org,2022-05-11,https://www.yang.com/
09-Jan-2021,NEFT,00.00,"21,843.14","65,529.43",09cc751fF83BE5e,2235,Geoffrey,Archer,Bartlett and Sons,Lake Cliffordstad,Bosnia and Herzegovina,001-474-746-0361,(496)069-9291,gmorales@bauer.com,2021-06-23,https://www.conley.info/
09-Jan-2021,Miscellaneous,00.00,"9,361.35","56,168.08",BE352a8cB4F8d86,347,Bridget,Porter,Wyatt Group,Levinehaven,Uganda,266.436.0582x2195,001-165-696-3031,buckleyperry@herring.com,2020-03-06,http://roberson.info/
09-Jan-2021,Transfer,03.90,00.00,"56,171.98",f6dEdeeDa2Bf8e5,6115,Evelyn,Kirk,"Graham, Chen and Moreno",West Neil,United States of America,(277)866-3064,(603)003-5119x327,christian01@aguilar.info,2020-01-10,http://www.gibson-riley.com/
10-Jan-2021,Interest,00.00,"9,362.00","46,809.98",Fa1bf4A5aDb3AE6,9042,Laurie,Blackburn,"Holt, Meyers and Sharp",Beckytown,Argentina,7275517486,230-110-7181x574,chenselena@cochran-fuller.info,2021-03-31,https://washington-brewer.com/
10-Jan-2021,Interest,00.00,"11,702.50","35,107.48",ccdeE8EBFaD872D,6313,Edward,Sawyer,Stevens Inc,Steventon,American Samoa,(835)769-9706,(697)463-3120,manueldowns@dodson-wilkerson.com,2021-12-24,http://ryan.org/
10-Jan-2021,Commission,453.70,00.00,"35,561.18",0baBa8a3e0a46Ab,1769,Edwin,Winters,Grant LLC,Bridgetland,Uzbekistan,(594)874-7501,+1-534-915-3908x91188,fordantonio@adkins-krueger.info,2020-08-10,http://www.frazier.com/
10-Jan-2021,Transfer,"123,936.10",00.00,"159,497.28",EDF84b2D3f452d7,1848,Lisa,Norton,"Beck, Sharp and Waller",Bentleyland,Maldives,681.119.3503x195,064.571.4165,jherring@gates.com,2021-04-13,https://www.butler.com/
10-Jan-2021,Reversal,00.00,"159,497.28",00.00,3Df3CCADcbFaC7C,8859,Destiny,Travis,"Hobbs, Santos and Phillips",West Lindseyton,Martinique,315-697-0779,001-153-092-4802x19632,shariconrad@watts-miranda.com,2021-09-10,https://www.erickson.org/
10-Jan-2021,Purchase,"244,914.00",00.00,"244,914.00",00bcE7218Abf9ae,8496,Dennis,Collins,Gallegos-Grimes,Arthurchester,Mozambique,6607178773,+1-015-419-8529x96690,kristybarry@chaney.net,2020-10-03,http://wang.net/
10-Jan-2021,Debit Card,428.94,00.00,"245,342.94",4581DB97bE63646,2126,Christie,Maddox,Page-Sosa,South Judithview,Barbados,126.280.9489,326.155.8972,kweeks@hudson-vargas.info,2020-01-20,https://www.steele.org/
10-Jan-2021,Commission,00.23,00.00,"245,343.17",2301b8bD9afAfA2,8053,Mandy,Cortez,"Wood, Garner and Sandoval",Dannymouth,Oman,556-007-2782,(083)404-4832,pughjeffery@bauer.com,2021-10-14,http://www.mcneil.com/
10-Jan-2021,IMPS,00.00,"40,890.53","204,452.64",78ef6B3B256BaF2,4347,Xavier,Stanton,Singleton PLC,Tammieview,Lesotho,+1-964-303-7859x5992,620.349.2774x951,waynejacobson@kidd-terry.org,2021-09-05,https://velazquez-spencer.com/
10-Jan-2021,Interest,00.00,"34,075.44","170,377.20",fCDecCAAf3c0b17,5618,Kathy,Cook,"Chase, Washington and Mora",New Cindy,Palau,0239473510,634.317.6429x452,cole55@drake.com,2021-11-14,https://tyler.info/
10-Jan-2021,Reversal,00.00,"18,930.80","151,446.40",25AA85EefA355CA,7670,Katherine,Bond,"Cochran, Strickland and Hobbs",Davidshire,Norway,001-309-984-6582x495,(406)994-5478x39344,charlesbryant@vaughn-osborne.org,2020-09-06,http://www.villarreal.com/
10-Jan-2021,Transfer,44.00,00.00,"151,490.40",Dc9fab1C577FdAB,116,Daryl,Mejia,"Atkins, Huerta and Wolf",West Cristian,Bermuda,564.315.9882x76632,651.345.8376,beckyshaw@bradley-booth.com,2021-07-23,http://cortez-cooper.com/
10-Jan-2021,Reversal,00.00,"25,248.40","126,242.00",eD96b58cbf4aAC5,9057,Autumn,Sims,Guerrero and Sons,Lake Rebekahchester,Sierra Leone,+1-352-652-3975x765,(844)463-4376,qmccormick@walter.com,2021-12-13,http://wood-orozco.com/
10-Jan-2021,Reversal,323.77,00.00,"126,565.77",785DCedCAEBBb10,1015,Janet,Higgins,"Parks, Cardenas and Hodge",Elizabethhaven,Iraq,+1-250-992-3766x193,(816)949-9202x99378,isaiahknox@mcgee.com,2022-05-15,https://thompson.com/
10-Jan-2021,Transfer,"14,944.25",00.00,"141,510.02",c1DbDb64C5447F5,7494,Donna,Donaldson,Ramsey Group,Lake Christianport,Hong Kong,690.474.3421,985.499.9109,powellkarl@craig.com,2021-06-24,https://nash.org/
10-Jan-2021,IMPS,"857,282.00",00.00,"998,792.02",fA5FF5fbE098ea7,2261,Randy,Rivas,Hurst-Hatfield,North Duaneport,Norway,+1-297-625-1797x302,(559)493-2694x331,andrewyoder@powers.com,2020-01-18,http://www.christian-bruce.net/
10-Jan-2021,RTGS,00.00,"998,792.02",00.00,953eBB9D79Ec1da,3209,Bruce,Baldwin,Bishop-Marshall,Port Sherryport,Fiji,189.127.6559,000.910.4961,whunt@walter.com,2020-02-16,http://www.michael-garrett.info/
10-Jan-2021,Cash,39.00,00.00,39.00,9CA366fCacA18Be,142,Ryan,Sanford,Olson Ltd,New Shariton,Japan,(647)928-7424x1503,001-944-292-0891x5355,peggy95@park.info,2021-05-18,https://www.donaldson-norman.com/
10-Jan-2021,Bill,02.07,00.00,41.07,01EDd3AEFF849Ea,3135,Sue,David,"Harding, Hamilton and Lopez",North Javierville,Saint Vincent and the Grenadines,911-062-2766,521-714-8114,isaiahvillarreal@bishop.com,2021-10-02,http://gilbert.com/
10-Jan-2021,RTGS,00.00,20.54,20.54,b0Ed3bb9ACbfCC0,2941,Lindsay,Hendricks,Wiggins-Shea,East Annette,Haiti,(378)228-2412x81618,618.652.4679x8151,collincase@santos.info,2021-05-02,http://www.bright.com/
10-Jan-2021,Cash,00.00,04.11,16.43,1dfBCfbbab0B7f7,6483,Jesus,Cortez,Carey-Acevedo,Wesleytown,Gabon,(076)600-9054x77352,651-649-7033,alishablevins@bell.com,2021-07-05,https://www.benson.net/
10-Jan-2021,NEFT,00.00,02.74,13.69,3Df3edCA4c98abD,9971,Shelley,Raymond,Holden and Sons,Port Jennybury,Ecuador,001-840-8597x3036,0045134154,caitlin15@rollins.com,2022-05-29,http://chapman.com/
10-Jan-2021,Commission,"577,606.25",00.00,"577,619.94",67f68E6E6193c84,5768,Richard,Livingston,Sampson-Summers,South Hector,Norfolk Island,646-114-9951,+1-306-086-2819x0375,williamsricardo@glenn.com,2021-11-21,http://www.dawson.com/
10-Jan-2021,Miscellaneous,19.00,00.00,"577,638.94",DCe8F3b47d47693,6561,Regina,Malone,Villa-Rangel,Benjaminburgh,Malaysia,(656)696-1669x7617,+1-853-557-1014x18653,gsilva@quinn.biz,2022-02-09,https://www.griffin.com/
10-Jan-2021,NEFT,00.00,"57,763.89","519,875.05",BaAce9F46E567D3,7624,Joanne,Bell,Bowman-Le,Port Andrea,China,(813)511-9184x98713,3959441879,qgallegos@dodson.info,2020-01-25,https://www.oliver.com/
10-Jan-2021,NEFT,00.00,"74,267.86","445,607.19",bB1CB8F5af3dAE4,3512,Whitney,Fleming,"Adkins, Mckinney and Hayden",Dickersonborough,French Guiana,001-624-082-1188,7696015538,iandouglas@acevedo-norman.com,2020-06-15,https://mercer.com/
10-Jan-2021,Interest,00.00,"55,700.90","389,906.29",d6b82c7FFA07DAD,2370,Pam,Buckley,Glover and Sons,East Sheila,Syrian Arab Republic,889.041.8991,763-297-0683x013,jerrydean@oneal.com,2020-07-14,http://www.rhodes.org/
10-Jan-2021,NEFT,00.00,"194,953.15","194,953.14",965f2BAd3BF213c,4362,Sarah,Mccall,Dominguez-Coleman,Sampsonberg,Nicaragua,643-972-5976x6490,(826)838-0085x82411,ericchase@hudson-schmidt.com,2020-07-09,https://www.fischer.net/
10-Jan-2021,Cheque,00.00,"64,984.38","129,968.76",C0a64b1b6ecFC1b,4945,Savannah,Garcia,Sosa Inc,Kendraton,Norway,007-066-9574x8716,655.061.2342x313,darin04@graves.info,2021-11-07,http://www.kent.biz/
10-Jan-2021,Reversal,"6,434.82",00.00,"136,403.58",CD752A01Dc8428B,7579,Kellie,Carr,Pitts Ltd,South Erinberg,Kenya,001-060-302-4416x6526,001-154-369-6052x36817,nina32@atkins.com,2020-10-06,https://ponce-ochoa.net/
10-Jan-2021,Reversal,01.88,00.00,"136,405.46",Ea3D9cee9Aa56Fa,6028,Stacey,Wright,Hess-Parker,Atkinsonmouth,Montenegro,001-537-964-0581x15971,050-130-1063x4601,madeline28@holder-conner.com,2021-08-25,http://www.walls-daugherty.com/
10-Jan-2021,Transfer,00.00,"22,734.24","113,671.22",4E3E63ea298ac36,9025,Dennis,Galvan,Burke-Merritt,Merrittshire,Denmark,(163)039-4045x36238,+1-634-669-4713x0140,paige61@hayden.com,2021-02-22,https://www.bridges.net/
10-Jan-2021,Miscellaneous,04.40,00.00,"113,675.62",8eB5B93C47dc00e,3501,Kristina,Swanson,"Esparza, Obrien and Guerrero",Mirandaville,Finland,(494)007-4732,001-265-716-5116x6447,clayton25@webb.com,2020-12-01,https://sims-oliver.com/
10-Jan-2021,ATM,00.00,"12,630.62","101,045.00",7d83c9362c7ADfA,6392,Daisy,Osborn,"Compton, Johnston and Morgan",Billyland,French Guiana,001-069-787-9975x715,162-926-1607x80553,kari72@castillo.com,2021-03-14,https://www.giles.com/
11-Jan-2021,RTGS,"13,963.00",00.00,"115,008.00",cC0cBBa88DEe269,8931,Grant,Frost,"Rodgers, Washington and Key",Joanmouth,United Kingdom,351-660-8868x687,001-704-828-7421,clementsleon@sexton.com,2020-01-28,https://www.boyle-barnett.biz/
11-Jan-2021,Purchase,00.00,"38,336.00","76,672.00",Fab5EfEf821BbE6,6914,Dale,Lamb,"Glass, Chan and Daugherty",East Hayden,Libyan Arab Jamahiriya,852.344.2897x99870,730-403-1843,franklin20@cox-stokes.org,2022-03-18,http://phillips-figueroa.com/
11-Jan-2021,Tax,06.20,00.00,"76,678.20",9EBDc5A06dF5EAC,6831,Gregg,Johnston,Irwin Ltd,Bernardfort,Korea,001-243-591-3118x430,8962531839,tcowan@sutton.com,2022-01-28,http://www.sheppard.com/
11-Jan-2021,Cheque,00.00,"8,519.80","68,158.40",ACA2e3859aBF202,683,Alexandra,Neal,"Todd, Moran and Garrison",Bobview,Australia,993-968-2676,937.026.3465,schmittautumn@glenn.com,2020-05-01,https://hanson.com/
11-Jan-2021,Transfer,07.20,00.00,"68,165.60",BAf0b23B79ABFD4,1550,Tammie,Parrish,Bradshaw-Ellis,New Jeff,Sierra Leone,462.665.3624,251.370.7478,gibsonderek@fields.info,2021-09-12,http://jacobs.com/
11-Jan-2021,IMPS,"124,292.50",00.00,"192,458.10",2dC6c713601d4Ed,1454,Larry,Roberson,Cruz-Frost,New Cassandra,Montenegro,+1-149-247-4169x12324,027.256.2154x46824,marissa75@lewis.biz,2021-10-10,https://www.matthews-evans.com/
11-Jan-2021,Cheque,00.00,"64,152.70","128,305.40",cc4AF4bDAedc57d,1271,Elizabeth,Avery,Maddox LLC,Sarahmouth,Guernsey,739-055-7614x58257,001-480-830-4807x690,joanna87@morales.net,2020-11-12,http://www.faulkner-nielsen.org/
11-Jan-2021,Debit Card,"21,222.59",00.00,"149,527.99",e7EedbE1Efe2de2,770,Kendra,Richards,"Valenzuela, Marks and Carr",New Peter,Uruguay,(517)200-4749,001-248-837-3036,douglas18@ewing-fuller.com,2020-08-23,https://www.stephens.biz/
11-Jan-2021,Transfer,252.40,00.00,"149,780.39",F0AeB1FaEcA9f12,1258,Jesse,Hanson,Velez Inc,West Kristi,Martinique,(552)396-3653x799,(574)377-2734,cherylpalmer@weber-gates.com,2021-06-14,http://tucker.com/
11-Jan-2021,Bill,00.00,"49,926.80","99,853.59",2F68A4eC5abEDba,7631,Angela,Crawford,Bray-Wells,Chloemouth,Benin,(303)873-3384x0115,+1-224-099-9940x3117,ymarquez@santiago-mayer.com,2021-05-28,http://www.fowler.com/
11-Jan-2021,RTGS,39.40,00.00,"99,892.99",07b84cc0992C54D,3238,Rebecca,Harvey,"Baxter, Navarro and Good",Sallyhaven,Yemen,332.163.1031,360-390-1490x245,steelecurtis@chase-hurley.biz,2020-09-01,https://www.davenport-gonzalez.com/
11-Jan-2021,Purchase,268.20,00.00,"100,161.19",Df28686ae94CB87,8182,Dorothy,Craig,Madden-Snyder,South Colton,Honduras,(849)090-3081x329,(118)926-3633x5209,jlester@butler-beasley.com,2020-11-02,https://suarez-pena.info/
11-Jan-2021,Debit Card,00.00,"12,520.15","87,641.04",b2BaCACeab2be0A,8861,Julie,Wheeler,"Henry, Wilkins and Cervantes",Lake Ashleeville,Cuba,8723292156,8432508902,kirbymeagan@obrien-rosales.com,2020-02-01,https://burnett.com/
11-Jan-2021,Reversal,00.00,"21,910.26","65,730.78",c90Ab5BA65aCDbB,337,Cassidy,Conner,Huerta-Hobbs,Lake Sandychester,Uganda,(817)425-7030,001-713-480-0518x892,jacobrojas@cummings-kelly.com,2021-06-21,http://www.love-higgins.com/
11-Jan-2021,IMPS,"192,646.72",00.00,"258,377.50",A561A1Dad20de31,7122,Misty,Mullen,"Reynolds, Mullins and Stuart",West Kristopherville,Norfolk Island,+1-896-335-7040,(761)948-0969,christieperez@long-briggs.net,2020-04-17,http://juarez-carney.com/
11-Jan-2021,Cash,00.00,"28,708.61","229,668.89",aB8dEb7cF7F338C,3839,Katrina,Dunlap,"Cunningham, Berg and Hughes",New Sheri,Honduras,148.243.7554,760-310-5308x529,miguel93@hendricks.biz,2021-03-23,https://hodges.com/
11-Jan-2021,Transfer,00.00,"45,933.78","183,735.11",8271eEAC7a4bF48,9186,Hunter,Walter,Duke PLC,Caitlinside,New Zealand,+1-890-156-3735x1915,(950)629-7414x8259,jeanettehill@huff.com,2020-09-05,http://hinton.biz/
11-Jan-2021,Debit Card,"62,200.60",00.00,"245,935.71",a005CC1161448E3,4547,Leon,Arnold,Drake Ltd,Romerohaven,Vietnam,041-668-7794x6042,(002)816-4058x22880,krivera@haley.com,2021-04-05,http://carney.info/
11-Jan-2021,Interest,31.90,00.00,"245,967.61",Ad89CaCdfDbCEbd,449,Ricardo,Pena,Kelly-Duncan,Port Marvinton,Saudi Arabia,5639394528,155-580-4863x3801,elizabethhobbs@parker.com,2021-08-21,http://cline.info/
11-Jan-2021,ATM,00.00,"35,138.23","210,829.38",f058359eC0bD6db,1695,Rhonda,Banks,Swanson Ltd,South Lonnieberg,Gambia,249-710-4526x417,(789)126-0563x301,tristansingleton@marks-fitzpatrick.info,2020-12-05,https://price.info/
11-Jan-2021,RTGS,07.00,00.00,"210,836.38",3DcCaBb218383a6,321,Kristopher,Bailey,"Estrada, Hendrix and Molina",Joyceburgh,United States Minor Outlying Islands,879-651-6578,565-294-1559x715,marco90@friedman-franco.net,2021-06-16,http://romero.biz/
11-Jan-2021,Commission,07.00,00.00,"210,843.38",dD0AFa0092C39Ba,7285,Kurt,Schneider,Morton-Swanson,Harrisonbury,Mauritius,871-651-6029,(524)041-1404x458,bestmarcia@carrillo-mccarty.com,2021-01-18,https://www.harmon.com/
11-Jan-2021,Interest,"256,439.00",00.00,"467,282.38",D4EEa2EF8f1be34,3994,Kathryn,Nash,Willis-Nash,South Kristiemouth,Tajikistan,648.326.7734x6222,324-377-9718x42327,shaunbryan@payne.net,2022-05-10,http://moreno.com/
11-Jan-2021,Purchase,00.00,"116,820.60","350,461.78",f0D30a989eDCEeB,8665,Latasha,Vazquez,Watson Group,Tiffanyfort,Jamaica,+1-534-520-9598,630.654.3068x334,hendersonalison@berger.com,2020-08-22,http://chaney-wall.biz/
11-Jan-2021,ATM,09.70,00.00,"350,471.48",a7bC3Adcf6af7BC,8801,Marie,Walter,Dawson-Farley,Chrisfurt,Peru,776-593-6747,(619)745-2977,gmcdowell@mathews.com,2020-04-02,http://warner-calhoun.info/
11-Jan-2021,Reversal,00.00,"70,094.30","280,377.18",BedfbB8AEADF1D5,6557,Jimmy,Abbott,Black Ltd,New Veronicaside,Indonesia,485.570.2703,951-656-8620x96343,zachary01@anderson-forbes.com,2020-01-10,https://www.everett.com/
11-Jan-2021,Debit Card,314.09,00.00,"280,691.27",fB4721c508CA58d,4960,Gilbert,Gates,"Lam, Irwin and Moreno",West Mistychester,Guinea-Bissau,943.793.4076x517,(674)443-1542x4999,barrywyatt@little-chang.com,2021-01-31,http://www.steele-huerta.com/
11-Jan-2021,NEFT,"29,668.00",00.00,"310,359.27",5DdFD314FDFe3B1,2756,Natalie,Lynn,Mercado-Sosa,Mathisview,Cote d'Ivoire,+1-547-998-7744x17972,(329)145-4006,yangvictor@munoz.com,2020-03-15,http://bell.com/
11-Jan-2021,Cash,00.00,"77,589.82","232,769.45",DEbD6eAd8F2bba4,287,Phillip,Mccarty,Ritter-Kelley,Jefferyton,Malta,456.256.7271x9394,001-871-819-5138x94278,shirleybeasley@hurley.info,2020-08-15,https://www.arellano.biz/
11-Jan-2021,Tax,42.00,00.00,"232,811.45",9c35f1B9C8caAdc,3598,Benjamin,Patel,Moran-Esparza,North Alexander,Tajikistan,+1-042-370-6484x013,(070)904-2725x250,bobby84@mcgrath-massey.biz,2021-06-16,http://www.russell-rosales.com/
11-Jan-2021,Tax,10.95,00.00,"232,822.40",AaA1c4aB0ffFDeA,6269,Levi,Bird,Copeland Group,Jeromeview,Timor-Leste,995.629.7685,(255)860-6798x733,bryanmelanie@chambers.com,2020-12-02,https://pugh-griffith.net/
11-Jan-2021,IMPS,00.00,"46,564.48","186,257.92",caC38c227BEbbe0,2885,Samuel,Hooper,Rollins-Bentley,West Sabrina,Saint Pierre and Miquelon,015.284.5098x6156,230.902.1263x5200,gwendolyn36@cline.com,2020-03-03,http://rowe.com/
11-Jan-2021,Commission,04.10,00.00,"186,262.02",7a619E93F0cA947,5922,Leonard,Reid,"Vega, Carroll and Bell",East Michelle,Dominica,+1-301-236-6777x1811,753.267.0061x585,georgehayley@freeman-freeman.org,2020-05-09,https://www.crane-hamilton.net/
11-Jan-2021,Cheque,"1,380.00",00.00,"187,642.02",9258759c6b6EADD,4527,Theresa,Daniel,Maxwell-Whitehead,Katiefort,Libyan Arab Jamahiriya,(158)633-9797,+1-727-881-5038x528,mcintoshmarvin@blankenship-manning.com,2020-01-25,https://www.keith.com/
11-Jan-2021,Bill,"64,598.60",00.00,"252,240.62",3240aC3deefc4e4,7198,Jerome,Hernandez,Moreno LLC,Eatonberg,Tuvalu,+1-854-348-2422x127,(287)660-3264,gina88@cowan-howell.com,2021-02-06,https://www.young.com/
11-Jan-2021,Cheque,00.00,"252,240.62",00.00,8255AdCBD23349F,4742,Darius,Jennings,Santana Group,Lake Angel,Nepal,373.642.6306x41726,+1-280-879-0754x9437,brandyewing@barron-hawkins.com,2020-11-29,https://www.wheeler.com/
11-Jan-2021,Tax,488.10,00.00,488.10,0eA62bA1bB689eF,7004,Ethan,Rodgers,David-Holden,Dianeport,Pakistan,136.006.3734,(009)985-3000x4264,daltonjulie@wolfe-figueroa.com,2022-03-25,https://www.rasmussen-braun.com/
11-Jan-2021,ATM,64.00,00.00,552.10,f10E51c5F0A7dE1,9679,Stephanie,Valdez,Atkinson Ltd,Mikeport,Albania,467-015-5746x018,033.460.5745x4505,lmoran@bailey-hines.com,2021-10-09,https://www.beasley.org/
11-Jan-2021,RTGS,00.00,69.01,483.09,faacFEEfFD78eaC,9304,Erin,Branch,"Cooke, Mccormick and Donaldson",Cannonbury,South Africa,001-124-944-1053,(154)347-2169,lameugene@freeman-mills.org,2021-05-17,https://koch.net/
11-Jan-2021,Reversal,339.06,00.00,822.15,0981B1089c4FeEA,7929,Brandon,Roach,"Green, Carpenter and Dudley",Nguyenville,Seychelles,583.552.9419,9806411292,larry23@lozano-whitney.net,2022-03-23,http://www.meyer-weaver.com/
11-Jan-2021,Transfer,00.00,91.35,730.80,ca0D2F74aEF9Ae0,981,Clifford,Stone,"Stevenson, Becker and Hammond",Port Summer,Syrian Arab Republic,(879)264-9279,125.525.3983,qheath@serrano.info,2021-11-18,http://www.rosales-valentine.com/
11-Jan-2021,Miscellaneous,00.00,81.20,649.60,A35A5CdBE8168b2,2243,Kristie,Hendricks,Orr-James,Houstonborough,New Zealand,+1-110-196-0828x66952,344-958-4525,jackhicks@henry-blackwell.com,2022-04-25,http://www.mosley-oconnor.biz/
11-Jan-2021,NEFT,00.00,129.92,519.68,70C2e8CaA0eD49C,521,Brent,Boone,Allen PLC,Sherriborough,Monaco,049-665-4976x48016,(781)456-6785,breannachapman@small.com,2020-01-20,http://www.hull.info/
11-Jan-2021,Cash,"387,128.50",00.00,"387,648.18",11d171cC26b7CeE,5906,Annette,Cooper,Rose-Graves,East Ian,Malawi,+1-054-273-4822x456,654-994-3222,meghan21@ramirez.com,2021-07-12,https://shaw.net/
11-Jan-2021,ATM,00.00,"38,764.82","348,883.36",77C5CdE91De7cf1,2730,Zachary,Hunter,"Carson, Marks and Montgomery",Port Joy,Madagascar,001-635-311-4172x673,(424)437-6773x131,maddoxdanielle@cantu.com,2020-05-17,https://www.waller.org/
11-Jan-2021,IMPS,"174,706.00",00.00,"523,589.36",eE803B9eF6F8e8B,7620,Miguel,Walter,Fry Ltd,Aliceberg,Norfolk Island,+1-034-326-9194x883,+1-011-643-9978x6458,littlemichael@villanueva.com,2022-03-24,http://www.ramos.biz/
11-Jan-2021,Transfer,00.00,"104,717.87","418,871.49",1c5DaDFbC06Ed43,7179,Adriana,Mckenzie,"Humphrey, Bradford and Cooley",West Sabrinaville,Croatia,764-438-7914x3609,(674)430-4491x981,sergiomccullough@hart.com,2020-02-20,http://berg.com/
11-Jan-2021,Cash,"163,682.40",00.00,"582,553.89",deEfc43CaB3bB49,6043,Crystal,Cortez,Hays Group,Whitakerland,Grenada,(599)960-0048x42784,493-174-4405,jasminebrennan@cochran.info,2020-03-23,http://www.white-sharp.net/
11-Jan-2021,RTGS,00.00,"83,221.98","499,331.91",7C88B7c5d1a4dEB,4856,Patty,Levine,Sims PLC,Nicholasburgh,Iraq,(981)728-9756x549,021.624.2276x9137,kendrarodgers@waller-farrell.com,2021-04-09,https://mills-nelson.biz/
11-Jan-2021,Debit Card,00.00,"49,933.19","449,398.72",1ceAFc50CEbD37B,9901,Laura,Burton,Dickson PLC,New Mollyshire,Puerto Rico,276-417-1795,001-325-059-6759x30537,kirkharding@ortega.com,2020-12-16,https://howell.com/
11-Jan-2021,RTGS,04.90,00.00,"449,403.62",70fe1B9BF7deFaf,700,Max,Blair,"Lucas, Walsh and Mercer",Hensonborough,Jordan,0913948757,001-225-032-0959,gmcgrath@mercer.com,2020-06-08,https://www.wilson-sloan.com/
11-Jan-2021,Cheque,00.00,"56,175.45","393,228.17",E5e903Eb61ECcef,403,Elizabeth,Logan,Peck PLC,Geoffreymouth,Paraguay,633.088.3844,8980732697,kirkbradford@ibarra-bradford.info,2020-04-17,http://mueller-carpenter.com/
11-Jan-2021,NEFT,00.00,"43,692.02","349,536.15",Fd48683cC1c7f45,5648,Henry,Dickson,Baird Inc,South Diamondville,South Georgia and the South Sandwich Islands,491.915.6303x638,001-430-460-8857x96134,laurenraymond@lozano.com,2021-01-22,https://ali.com/
11-Jan-2021,IMPS,00.00,"349,536.15",00.00,fE3defBFAfEaa69,6560,Doris,Cline,Galvan-Phillips,North Evelynshire,Montenegro,037-792-1649x3723,001-916-100-5569,lisa11@olsen-daugherty.com,2021-01-12,http://velez-mann.com/
11-Jan-2021,NEFT,01.51,00.00,01.51,AD58Ca8eAEeCaE9,8169,Jeanne,Baldwin,"Zuniga, Vasquez and Wagner",Lake Stephanie,Dominica,438.966.1907,868.693.7684,haley74@liu-bowman.com,2021-12-26,https://www.nguyen.com/
11-Jan-2021,RTGS,182.20,00.00,183.71,e4d7aD9D753a35b,3736,Julia,Bates,Gill Inc,Lambfort,Russian Federation,2864821224,694-037-3123x6369,molly59@alvarado.info,2020-10-11,https://www.harrington-reyes.biz/
11-Jan-2021,Miscellaneous,00.00,26.24,157.47,C56b5c53DfF8471,6819,Sonia,Logan,"Higgins, Warren and Kemp",West Marisa,Macedonia,(555)904-9179,001-929-188-3781x65192,terrence99@rush-goodman.com,2020-04-06,https://www.lyons.org/
11-Jan-2021,Purchase,00.00,15.75,141.72,a494bCcff7cAB4f,8059,Derek,Warren,Garcia-Brandt,Oscarchester,New Zealand,1073146041,+1-308-097-9668x0278,darlenewalls@cantu.com,2020-08-02,https://glass.biz/
11-Jan-2021,Reversal,"1,003.00",00.00,"1,144.72",ec9e0bdEe620C7b,5044,Bernard,Hines,Little Group,South Gavin,Benin,(995)517-9344x544,+1-381-350-8836,tara28@le.com,2020-11-24,https://www.horton.biz/
11-Jan-2021,NEFT,13.14,00.00,"1,157.86",9f5F1F351A36013,8707,Chad,Hobbs,Underwood Group,Johnstonberg,Russian Federation,001-566-834-0485x244,+1-655-702-1910,dorseynathan@moore.com,2021-10-30,http://www.colon.com/
11-Jan-2021,ATM,00.00,231.57,926.29,CC9B6713dc46eA7,3221,Jerry,Howard,Cain-Chavez,East Erica,Norway,600.564.6533x789,683.517.7956x324,leroyvilla@peck.com,2021-05-22,http://vazquez-dudley.com/
11-Jan-2021,Tax,00.00,115.79,810.50,30D3De9E82eDB6D,8304,Bobby,Maynard,"Howard, Hendricks and Tapia",Elizabethchester,Ecuador,232.183.9588,001-307-590-3776x70863,candicelowery@mills-beltran.info,2022-02-24,https://duran-cantrell.com/
11-Jan-2021,Purchase,00.00,405.25,405.25,2900d28b0bAEFC2,3844,Jesus,Oneal,"Maddox, Sanders and Burns",Charleneborough,Cook Islands,+1-033-633-4264x1125,6357255607,ginairwin@mcclain-ramsey.com,2020-11-06,http://waters.com/
11-Jan-2021,Reversal,00.00,405.25,00.00,7BfBA1C9B9Fdba8,9527,Alec,Howell,"Villarreal, Leach and Avila",North Whitney,Cayman Islands,+1-689-853-2832x6285,069.998.2474x3320,monique22@robbins-saunders.com,2020-02-01,http://www.lutz.com/
11-Jan-2021,Purchase,466.60,00.00,466.60,eF99aE70bc0bAeC,1966,Jared,Sanders,Singleton Group,Duranfort,Lebanon,623.014.3632x0688,165-503-1515x697,ocarrillo@hall.net,2021-12-03,http://www.sutton.com/
11-Jan-2021,NEFT,02.90,00.00,469.50,e1a02caEc142cA6,2498,Kirsten,Schmitt,"Hammond, Salinas and Perez",West Cameronville,Lao People's Democratic Republic,(483)291-3354,056.080.5821x461,tatemia@bates.net,2021-03-27,https://moore.com/
11-Jan-2021,IMPS,00.00,234.75,234.75,9147889b361D6BB,4584,Shelby,Burton,"Perkins, Blevins and Miles",Pooleshire,Northern Mariana Islands,(749)657-7812x8832,001-613-241-7444x4533,odomteresa@byrd.net,2022-04-02,http://www.calderon.info/
11-Jan-2021,Cash,"2,206.00",00.00,"2,440.75",F3Ef8F0aa4F978e,1226,George,Watkins,Zamora-Bray,South Brandimouth,Spain,749-030-3666x77253,001-805-171-0988x092,donald86@crawford.com,2021-02-08,http://www.taylor.com/
11-Jan-2021,Commission,116.80,00.00,"2,557.55",dD0EC1e6D50ec2f,1212,Isaac,Perez,Perez-Barron,New Jaredmouth,Bosnia and Herzegovina,806-065-4290,668.020.1441x099,mckenziecasey@riley.com,2021-06-12,http://bird.net/
12-Jan-2021,Cheque,"712,148.00",00.00,"714,705.55",cfDF24BE81fE1F0,6617,Kristy,Hopkins,Heath-Macias,South Lynnburgh,Timor-Leste,+1-711-884-9926,+1-934-144-7817x894,ana45@roth.com,2021-08-11,https://quinn-wilkins.com/
12-Jan-2021,IMPS,00.00,"79,411.73","635,293.82",f5F8CAFa0D8eFc9,6117,Benjamin,Juarez,Sparks LLC,Sheilafort,Morocco,369-099-3833x385,001-311-050-2840x1727,costapaula@mayo.com,2020-06-28,https://buckley-acosta.com/
12-Jan-2021,Tax,19.00,00.00,"635,312.82",0eFf84b706a8DdB,100,Aimee,Sims,"Lara, Leon and Montoya",East Jeanneside,Grenada,(570)770-4667x7987,001-511-768-2295x52680,anthonyzuniga@tucker.com,2021-07-27,http://moran.com/
12-Jan-2021,Bill,05.40,00.00,"635,318.22",0CB6b49D995cB6a,3707,Taylor,Pittman,Hodge-Ramos,Karinaside,Fiji,(478)414-7283,664.162.7535x2124,ryansherri@collier-ritter.com,2020-03-16,https://www.brennan.org/
12-Jan-2021,Bill,02.35,00.00,"635,320.57",578B08Ff2feeE0e,5281,Brent,Sandoval,"Lowery, Bray and Adkins",Nicoleshire,Cape Verde,423.451.4105,563.848.0492x898,mcdonaldherbert@griffith-castillo.biz,2022-02-13,http://www.murray.com/
12-Jan-2021,Cheque,"17,274.00",00.00,"652,594.57",0c4597b8DC6A7CD,3280,Cory,Carr,Morris PLC,Paceside,Montenegro,7912045790,+1-686-883-2057x06271,sally15@hood-delgado.biz,2021-10-11,http://www.delgado.com/
12-Jan-2021,ATM,"1,701,008.50",00.00,"2,353,603.07",2BdA1E11E3c0cc0,5069,Cathy,Hernandez,"Peterson, Jackson and Holt",Yangville,Iraq,001-351-562-4488,+1-260-522-7161x9943,danacain@ruiz.info,2021-11-25,https://www.michael-coffey.net/
12-Jan-2021,Miscellaneous,06.90,00.00,"2,353,609.97",5c4BC033ac4Efab,1062,Leonard,Macias,"Nielsen, Macias and Webster",West Seanborough,Thailand,001-776-128-9104,+1-666-258-5190,lvasquez@webb.org,2020-04-20,https://www.butler-lowe.com/
12-Jan-2021,Purchase,"82,473.25",00.00,"2,436,083.22",7346C2DFc1EcE72,6694,Gary,Odonnell,"Abbott, Holder and Hoover",East Michaelview,Puerto Rico,526.236.6696,(785)570-4978x67963,cummingsselena@mcdonald.com,2021-08-05,https://www.warren.com/
12-Jan-2021,IMPS,473.40,00.00,"2,436,556.62",BE0E1c7FD8d54D9,6285,Maria,Bean,Nixon-Walters,West Charleneburgh,Vietnam,815-225-4166x1872,+1-952-402-5101,lauragriffin@dennis.info,2022-02-09,http://www.henry-gomez.com/
12-Jan-2021,ATM,00.00,"304,569.58","2,131,987.04",b05eD2cf6bf55C3,1736,Jeanette,Sullivan,"Hartman, Craig and Rivas",West Stephen,Tunisia,3744069356,228-615-5615x3046,bennettjoseph@cisneros.com,2021-05-22,http://www.schmitt.com/
12-Jan-2021,Tax,"1,866.40",00.00,"2,133,853.44",c99c594b57E321A,7029,Ashlee,Parks,"Castro, Calhoun and Frey",Medinachester,Uruguay,279-959-3973x9439,584.372.5492x4067,abigailhahn@boone.org,2022-01-04,http://www.jarvis.com/
12-Jan-2021,NEFT,00.00,"213,385.34","1,920,468.10",4D1eECDBad8dbaC,3357,Tammie,Burgess,Gregory Ltd,Sandraside,Greenland,318-273-3032,001-419-621-1529x4012,helen01@rosales.com,2021-08-25,https://www.pope.info/
12-Jan-2021,Cash,00.00,"320,078.02","1,600,390.08",D3c3bcBEeD5FFFe,3638,Fernando,Hogan,Young-Boyle,East Darrellbury,Vietnam,+1-381-509-8285,+1-390-729-4715x650,unolan@white-key.biz,2020-09-13,https://www.mitchell.com/
12-Jan-2021,Purchase,"1,549.95",00.00,"1,601,940.03",DCFfe9Afb7c021E,2438,Andres,Mcclain,"Pruitt, Campos and Michael",North Charlotte,Tuvalu,(950)523-5640x859,215.140.3308,xmyers@forbes.info,2020-05-17,https://wu.biz/
12-Jan-2021,Miscellaneous,00.00,"533,980.01","1,067,960.02",e263060dCDD13c3,8204,Molly,Kaufman,Mullen-Esparza,Copelandfort,Isle of Man,001-382-631-9739x00067,+1-856-552-9193x660,mkrause@sutton.info,2020-05-01,https://www.middleton.info/
12-Jan-2021,IMPS,00.00,"266,990.01","800,970.02",AFBd06F16e8DF6f,3955,Kent,King,"Chan, Simpson and Wiggins",South David,Malaysia,288.173.6385x5023,998.124.8877x6867,velasquezray@sloan.com,2021-11-05,https://griffin.net/
12-Jan-2021,Tax,"11,215.70",00.00,"812,185.72",B0BFd5Db9A9461E,8726,Jay,Cortez,Huang-Rangel,New Ebonystad,Azerbaijan,(505)872-9800,493-636-7890,brendanparks@sexton-mccall.com,2020-02-28,http://www.brooks.org/
13-Jan-2021,Reversal,"702,209.50",00.00,"1,514,395.22",bd2eeD1aB601AF1,4885,Alisha,Hudson,Calderon Inc,Port Christinaburgh,Botswana,108.991.5728x293,(151)632-3663x0150,abuck@holder.com,2020-04-11,https://lutz.com/
13-Jan-2021,Bill,391.77,00.00,"1,514,786.99",D44EaEf1226b4ae,1742,Keith,Raymond,Bauer Ltd,Port Jerometown,Lebanon,(831)006-3484x1816,(119)562-7626x3507,harry87@terrell.net,2020-11-02,http://navarro-preston.com/
13-Jan-2021,Transfer,00.00,"302,957.40","1,211,829.59",5F86FcFDcCCfCDf,6924,Deanna,Schaefer,"Cooper, Carrillo and Kim",East Maurice,Slovenia,(006)974-3444x1024,001-336-277-5135x6325,prestonpace@cardenas-mckay.biz,2021-10-11,https://alexander-frazier.info/
13-Jan-2021,Transfer,00.00,"121,182.96","1,090,646.63",db3F7Bd8eA85106,6721,Jackson,Ho,Huerta-Dillon,North Greggbury,Palestinian Territory,+1-159-746-3842x53553,(984)783-1446x956,sherrygolden@beck.com,2020-04-05,https://www.cameron.org/
13-Jan-2021,Purchase,"1,774,012.50",00.00,"2,864,659.13",fa48c8Fb8fc0eAd,2786,Kyle,Nielsen,Mclean PLC,New Maurice,Algeria,156-036-2034x750,+1-620-909-9042x49872,markscheyenne@camacho.com,2020-07-27,https://dillon.com/
13-Jan-2021,Cheque,62.32,00.00,"2,864,721.45",6eA0979dA445FAA,1692,Jessica,Carney,Gallegos Group,Weissfort,France,759.269.3995x076,8269936424,zlarsen@zimmerman.com,2020-06-22,http://www.gross.com/
13-Jan-2021,Commission,"7,599.00",00.00,"2,872,320.45",cF8c6f8D074CaCa,7500,Jeremy,Marsh,Lyons LLC,Lake Leahfurt,Portugal,431.664.0930,437.992.9240x53705,terry65@ferguson.com,2020-09-24,http://www.mcmillan.org/
13-Jan-2021,RTGS,02.40,00.00,"2,872,322.85",4Bc94A2499eedaB,2991,Sergio,Joyce,"Serrano, Mcneil and Watson",Foleychester,Faroe Islands,5054168756,2297392464,bairdalex@holder.net,2020-02-16,https://erickson.com/
13-Jan-2021,Bill,"97,027.00",00.00,"2,969,349.85",08758848B79B0F9,7318,Latoya,Bailey,Yang and Sons,West Danielle,Micronesia,062-685-2032,207.753.4163x025,pwilkins@blankenship.com,2020-02-16,http://rodriguez.net/
13-Jan-2021,RTGS,183.00,00.00,"2,969,532.85",a9bd2EB0fD014ab,8597,Cheryl,Salas,Figueroa-Nichols,Huangburgh,Vanuatu,(041)233-4706x253,+1-523-510-0710x13153,gilbertsheila@irwin.biz,2021-08-23,http://roy-krause.com/
13-Jan-2021,Miscellaneous,"266,337.00",00.00,"3,235,869.85",B21DeEaC7f6Cab9,2997,Cassie,Gonzalez,Rollins and Sons,Brittneytown,Saint Lucia,791.136.7606,+1-441-857-9225x6964,emaxwell@arias.info,2020-08-29,http://www.crawford.com/
13-Jan-2021,Tax,184.00,00.00,"3,236,053.85",E563A64593EB29A,3674,Jesse,Bradshaw,"Gallagher, Patrick and Hawkins",Chandlerhaven,Saint Lucia,738.524.0433,642-230-6500,dillonhiggins@mejia-lutz.com,2021-08-11,http://butler.com/
13-Jan-2021,Interest,00.00,"3,236,053.85",00.00,113052eb0D869B4,8278,Jillian,Huber,West Ltd,Hensleybury,Cuba,164-133-8401x07555,361-077-9122x17370,marklyons@thomas.biz,2022-05-09,https://www.little-stein.com/
13-Jan-2021,ATM,62.90,00.00,62.90,2ddfD4bCBaca7Ae,3270,Sheri,Sandoval,Hayes and Sons,Gardnerburgh,South Georgia and the South Sandwich Islands,3000351722,(104)446-7784x502,kirbydwayne@hines.com,2020-08-06,http://hatfield.org/
13-Jan-2021,Commission,00.00,20.97,41.93,ffFeE0cc3b4bBb1,6664,Vanessa,Chandler,Vaughn-Dickerson,West Gregorytown,Tanzania,5704215740,611.123.5791,wwalker@mcdonald.com,2021-07-20,http://www.johnston.com/
13-Jan-2021,IMPS,"8,410.00",00.00,"8,451.93",b03ff12dAA1E252,8329,Christopher,Salinas,Mack-Schultz,North Stephenmouth,Azerbaijan,6207393927,001-238-901-3407,bowerslonnie@rodriguez-giles.biz,2021-10-24,http://holloway.org/
13-Jan-2021,Cash,02.46,00.00,"8,454.39",6C3b6B6D0AfCeCf,7867,Elijah,Fleming,"Spence, Mccormick and Jacobs",Lake Gabriellamouth,Somalia,682-867-3865,494-172-7750x711,tristansherman@wang.com,2020-07-11,https://clements-paul.info/
13-Jan-2021,Purchase,"1,575,869.25",00.00,"1,584,323.64",0aeF1F37663e82E,2556,Terrance,Davies,"Pineda, Brennan and Shah",Lake Harold,Congo,625-498-5195x120,083.283.1209x7662,bradfordlaurie@figueroa.net,2021-06-01,http://reid-nguyen.com/
13-Jan-2021,RTGS,00.00,"226,331.95","1,357,991.69",cBe7A74Ba85a6bd,538,Darlene,Haney,Hughes-Sanchez,West Joyceside,San Marino,001-318-878-3519x90125,+1-957-916-6199x1636,ricardo33@tran.info,2021-01-08,https://www.ali.net/
13-Jan-2021,Tax,00.00,"135,799.17","1,222,192.52",AE48ee79ec26Dc0,7713,Beth,Mclean,"Mullen, Dominguez and Walsh",Codymouth,Argentina,001-805-197-9254x709,2633055655,ygilbert@cameron.com,2021-02-03,http://www.petty.com/
13-Jan-2021,Tax,"321,768.00",00.00,"1,543,960.52",Bb762FB670aFc3f,8116,Guy,Mora,Rosales and Sons,Charlesview,Trinidad and Tobago,(133)395-3565x80090,(824)002-5691,jwelch@ibarra.info,2020-08-03,https://hansen-serrano.net/
13-Jan-2021,Debit Card,09.00,00.00,"1,543,969.52",ECBC129D0d0C6B8,3368,Diana,Monroe,Washington and Sons,Port Suzanneton,Saint Martin,001-023-454-5016x5952,(287)573-3895x59250,gwade@sosa.com,2022-04-06,http://www.rodgers.info/
13-Jan-2021,NEFT,414.00,00.00,"1,544,383.52",572b3fD672ffAb5,8033,Ruben,Campbell,"Parsons, Howard and Hamilton",North Kristinabury,Comoros,+1-269-216-5764x5145,356.488.4590x9104,sbradford@burke-velez.net,2021-12-07,https://www.shelton.org/
13-Jan-2021,Cheque,00.00,"154,438.35","1,389,945.17",7662Aee114DE1b1,520,Christian,Hansen,"Cohen, Zavala and Hodge",Russelltown,Thailand,875-297-1537x6615,465.146.2449,annettedavid@mcintyre.com,2021-10-08,http://blair.com/
13-Jan-2021,Purchase,00.00,"154,438.35","1,235,506.82",7662Aee114DE1b1,520,Christian,Hansen,"Cohen, Zavala and Hodge",Russelltown,Thailand,875-297-1537x6615,465.146.2449,annettedavid@mcintyre.com,2021-10-08,http://blair.com/
13-Jan-2021,RTGS,"185,612.41",00.00,"1,421,119.23",A87ADB9f283fBBC,5774,Sandra,Fitzgerald,Vazquez and Sons,North Carlmouth,Taiwan,(354)535-0766x42008,4789416814,chobbs@richmond.biz,2021-01-29,https://www.ramsey.org/
13-Jan-2021,ATM,577.65,00.00,"1,421,696.88",7d3FA7522B4fc29,4680,Zachary,Mendez,Boyer Inc,Pennyview,Lithuania,(964)477-9472x253,001-510-031-3085,bberry@delgado.com,2020-01-01,http://monroe-lam.com/
13-Jan-2021,IMPS,"289,009.00",00.00,"1,710,705.88",Aa7F96BAfa82C24,4178,Faith,Bradley,Knapp-Riley,Santosmouth,Jordan,668.755.3655,(826)709-5149,kaylanelson@lucas.com,2022-05-11,http://www.jefferson-porter.com/
13-Jan-2021,Cash,00.00,"342,141.18","1,368,564.70",aaDdB8bD9aEc74C,8505,Shannon,Duncan,Waller LLC,New Howard,Timor-Leste,697-936-5998,701.195.2540x146,michael05@gibbs-salazar.net,2020-04-18,https://www.reese.com/
13-Jan-2021,ATM,"2,401.32",00.00,"1,370,966.02",5e883ac5731A48f,266,Terrence,Frye,Ali LLC,Julianfort,Malta,067.961.9175x3047,3368534602,bradley72@fowler-durham.org,2021-03-10,http://www.ryan-curtis.com/
13-Jan-2021,RTGS,"17,872.00",00.00,"1,388,838.02",D3A7AbAF4c9FbDD,4537,Gail,Little,Lloyd-Santos,Tristanfort,United Kingdom,+1-795-193-4933x6597,+1-560-506-4234x91348,cproctor@watts-frey.com,2020-09-14,http://turner.org/
13-Jan-2021,Purchase,00.00,"694,419.01","694,419.01",Ed753e4CcceEC7D,3757,Shawna,Odonnell,Wells Inc,North Phyllistown,Guinea-Bissau,(899)118-2294x13390,+1-978-682-9977,lorettanorman@hunter-mcdaniel.com,2021-06-21,http://pena-hayden.com/
13-Jan-2021,Purchase,00.00,"694,419.01",00.00,FbBDaFb4B4E71Ac,2315,Connor,Ford,Whitehead Group,West Katelynview,Faroe Islands,+1-849-973-3305,+1-351-397-5170x576,jackson51@edwards-hale.com,2020-05-23,http://mendez.com/
13-Jan-2021,Transfer,"32,382.00",00.00,"32,382.00",ad211Ff2f681dE3,4062,Brianna,Petersen,"Bridges, Sanchez and Booker",New Susanburgh,Guernsey,+1-733-192-1507,768.736.7555,rthompson@farrell.com,2021-12-05,http://logan-lindsey.com/
13-Jan-2021,Miscellaneous,00.00,"3,598.00","28,784.00",ecC0FbdA05FaecF,157,Kevin,Fowler,Cantu Inc,Coffeyborough,Lesotho,2405097513,001-569-099-4222x141,katie93@norris.biz,2020-08-27,https://www.whitehead.org/
13-Jan-2021,NEFT,"1,498.90",00.00,"30,282.90",5eFC3E915B0FC4D,4410,Melissa,Newton,Zhang and Sons,West Dalefort,Puerto Rico,200-172-7254x6513,373.330.0545,bobwood@terry-travis.com,2021-08-21,https://www.holden-pugh.net/
13-Jan-2021,Miscellaneous,"18,920.30",00.00,"49,203.20",6a7f5CCaBc6D76f,4182,Ruth,Ward,Mendoza Inc,Hesterborough,Bosnia and Herzegovina,353.686.7557x32460,953.087.6111,jamie79@dalton-byrd.com,2020-09-24,https://www.baird.com/
13-Jan-2021,Commission,00.00,"6,150.40","43,052.80",fCdECB3e0Dbc23F,9785,Sophia,Haynes,Ramsey-Gentry,Robbinsfort,Saint Vincent and the Grenadines,(214)101-8043x586,9691354314,lmoyer@bentley-lucas.com,2020-04-08,http://www.bryant.com/
14-Jan-2021,Commission,00.00,"10,763.20","32,289.60",A92C5f21f8Dff50,708,Collin,Brandt,Cain and Sons,Lake Lauriemouth,Reunion,(693)532-0778x036,542.347.1810x55614,fconley@orozco-rasmussen.com,2021-05-13,http://west.org/
14-Jan-2021,Debit Card,20.10,00.00,"32,309.70",AFfcf8CFA19F5CA,7135,Mackenzie,Summers,Wilkins LLC,Walterfurt,Finland,+1-785-182-3455,(050)868-4564,selenashields@hopkins-proctor.com,2020-08-26,http://www.perkins-reeves.net/
14-Jan-2021,NEFT,05.60,00.00,"32,315.30",8B6ED5b3Aca7fCD,2024,Glenn,Petty,Gamble Inc,South Virginiamouth,Senegal,908.253.3077,+1-514-525-4825x578,cwalter@francis.info,2021-05-05,https://www.harrington.com/
14-Jan-2021,NEFT,00.00,"4,616.47","27,698.83",fAcabaBab61992d,2094,Maria,Khan,Chavez LLC,South Shawnton,Saint Martin,884.791.1649,(440)597-9229x8001,rkane@stark.com,2020-11-03,https://www.le.com/
14-Jan-2021,Reversal,00.00,"6,924.71","20,774.12",d3cCC3C94bfA15d,270,Martha,Molina,Cooper-Richards,East Jonathanborough,Fiji,916-950-6485x5931,723-255-8755,pratthector@ferrell.info,2021-08-07,http://www.knight-weiss.com/
14-Jan-2021,Cash,"131,743.60",00.00,"152,517.72",55Ef2BcDaAEDCC5,6609,Latoya,Lang,Gross LLC,Leonport,Japan,(431)863-8882x521,+1-641-493-4318x05652,roblesselena@huber-arroyo.com,2021-07-31,http://chan-donaldson.com/
14-Jan-2021,Commission,00.00,"38,129.43","114,388.29",a688D8adAfEbaBB,4809,Terri,Black,Boyle-Bailey,Bradfordhaven,Syrian Arab Republic,3349796397,360-589-4895,idrake@jensen-sweeney.net,2022-03-29,http://www.vincent.com/
14-Jan-2021,Bill,00.00,"57,194.15","57,194.14",b98867CF24E4085,5483,Brett,Guerra,"Nguyen, Travis and Clark",East Shawn,Cote d'Ivoire,673.200.6865x9166,434-121-4007x1125,iyates@colon.info,2022-04-15,https://lowe-clay.com/
14-Jan-2021,Cheque,"16,574.00",00.00,"73,768.14",50BFD76fEF370B9,4909,Alejandra,Parker,"Boyle, Cox and Blake",Port Christown,Mexico,491-521-0261x56343,012.528.2400x035,suedeleon@silva.com,2021-02-19,http://www.holmes.org/
14-Jan-2021,IMPS,00.00,"9,221.02","64,547.12",ed6DC10517aa65C,8784,Tyrone,May,"Tran, Weiss and Wilkerson",West Soniaton,Belgium,247.713.0222x5116,823-075-1211,benjamin26@lopez-krause.com,2020-03-16,http://www.andrade-benton.com/
14-Jan-2021,Interest,224.00,00.00,"64,771.12",C14abbce3eCfEDf,119,Charles,Daniel,English Inc,West Shawna,Lithuania,5777723656,+1-840-334-4067x391,ckhan@underwood.net,2020-03-25,https://www.chase.info/
14-Jan-2021,Bill,06.53,00.00,"64,777.65",ebd25dbbdEFe520,1752,Francis,Hatfield,"Rose, Kaiser and Hinton",West Bailey,Kyrgyz Republic,(630)742-2703,+1-478-990-4022x121,nicholsjasmin@sloan.org,2022-01-29,http://snyder.info/
14-Jan-2021,NEFT,00.00,"12,955.53","51,822.12",Cd56797fb695A5D,9152,Katelyn,Shea,Best-Johnson,West Angie,Wallis and Futuna,+1-493-172-0823x969,795-785-7163x231,martha49@schultz.com,2022-02-16,https://ibarra-rivera.com/
14-Jan-2021,Commission,"163,032.34",00.00,"214,854.46",6fadD74c35B4028,9753,Erin,Francis,"Everett, Baxter and Ponce",Lake Julian,Anguilla,392.421.2646,(508)370-4265,rknox@pruitt.org,2020-08-06,http://morris-lucero.net/
14-Jan-2021,Tax,00.00,"21,485.45","193,369.01",dfcC122F9aeDD48,8112,Darrell,Irwin,"Andrews, Hunt and Snow",Joannestad,Guatemala,(642)756-1033x43938,+1-893-713-6908x42001,ologan@berry.org,2020-06-27,http://www.everett.com/
15-Jan-2021,Purchase,00.00,"24,171.13","169,197.88",ba362eE7A41eD4B,8948,Spencer,Washington,"Wood, Jackson and Neal",Marilynmouth,Guadeloupe,(710)755-3103x832,742-024-1246x67037,stevensonwillie@rich.com,2021-10-16,http://www.pitts-case.com/
15-Jan-2021,NEFT,02.52,00.00,"169,200.40",c9bA43eCA39448c,508,Dave,Hurst,Hansen-Wong,Port Cole,Guam,588.287.3496x133,580.179.1232x88980,molly84@hutchinson-bishop.biz,2020-04-26,https://munoz.com/
15-Jan-2021,Reversal,548.30,00.00,"169,748.70",e5FDAEA1df1D7b3,1539,Wyatt,Ryan,Larson-Jimenez,Kiddfort,Swaziland,+1-848-934-9310x200,001-135-007-0021x6952,mauricesnyder@maynard-compton.biz,2020-11-15,https://www.olsen-hopkins.com/
15-Jan-2021,ATM,"1,769,243.50",00.00,"1,938,992.20",70e9dE1206A6289,655,Cory,Hill,Shields-Goodman,Carlburgh,French Guiana,776.162.9236x1407,001-084-040-9669,sethstuart@wheeler.com,2021-12-30,https://singleton-huber.com/
15-Jan-2021,Purchase,00.00,"969,496.10","969,496.10",FdFD7F0C69a77ff,7464,Christina,Carpenter,"Melendez, Charles and Choi",New Shirleytown,Vanuatu,722.924.4386x89008,(958)330-0453,clinton04@jordan-hernandez.com,2020-07-05,http://www.adams-mitchell.com/
15-Jan-2021,Interest,"40,676.62",00.00,"1,010,172.72",57DAB79F18FCe13,2551,Summer,Jensen,"Russo, Myers and Thornton",Paulastad,Qatar,(988)392-8023x8671,(408)765-1927x65252,imorrison@garner.com,2021-06-21,https://www.estes.com/
15-Jan-2021,Miscellaneous,00.00,"1,010,172.72",00.00,DAFE4aEB6c2eD69,4876,Kaitlyn,May,"Guerra, Washington and Mcfarland",Port Sheliaberg,Benin,(121)530-1014x978,451-217-2296x76566,jimmyanderson@casey-liu.com,2020-09-01,http://www.terrell.biz/
15-Jan-2021,Cash,44.00,00.00,44.00,aeC137FcAaeeB9e,3426,James,Chavez,Todd-Richmond,East Destiny,Pakistan,376.088.5916,(017)620-9288x8870,grodriguez@braun.com,2020-12-08,https://dorsey-hancock.com/
15-Jan-2021,Reversal,05.70,00.00,49.70,eA21ec3eF72E62D,6861,Tricia,Meyers,Brooks Group,Myerston,Samoa,7131496881,001-804-469-2007x7025,ashleycharles@blackwell.com,2021-05-03,http://duffy.com/
15-Jan-2021,Purchase,03.90,00.00,53.60,381b9252Ae24bBD,1616,Tasha,Vang,Wells-Blackburn,Port Meaganmouth,Hong Kong,2143191110,176.924.5226x68644,martingilbert@short-munoz.info,2020-04-04,https://www.mcmillan.com/
15-Jan-2021,Interest,00.00,10.72,42.88,ff1a40cA96beB0F,7209,Sherry,Kent,"Craig, Herrera and Benton",North Johnathan,Reunion,699.766.2169x702,+1-761-068-9064x31331,egill@payne.com,2020-09-01,http://petersen.com/
15-Jan-2021,ATM,02.30,00.00,45.18,97Bc909c7909956,332,Courtney,Christensen,Mcbride-Kennedy,New Candaceside,Azerbaijan,+1-251-376-4175,+1-081-267-7340x98949,shannonevans@watkins.com,2021-09-04,http://www.ingram.info/
15-Jan-2021,Reversal,"689,441.25",00.00,"689,486.43",ba6023F7Ae638c5,9631,Carrie,Owens,Irwin LLC,Francestown,Afghanistan,156-040-2286,532.107.6362,mercedes87@brady.com,2021-05-19,https://barber.com/
15-Jan-2021,ATM,00.00,"86,185.80","603,300.63",94cBBcACcafe18A,6299,Shane,Frey,"Duran, Dennis and Henson",Alexisberg,Monaco,593.066.6419x0837,(495)879-0555x923,sally81@herring.biz,2020-03-05,https://santiago-west.net/
15-Jan-2021,Cash,"745,934.75",00.00,"1,349,235.38",3A07e8De138d1aD,6078,Mandy,Duran,Richmond-Owens,Jordanport,Burkina Faso,932.180.5749x1651,035-130-0860x498,hunterlynch@sexton.info,2021-01-03,https://www.lee-beck.com/
15-Jan-2021,Debit Card,00.00,"674,617.69","674,617.69",CbbC851e4dc35B9,3868,Alison,Arellano,Fowler-Goodman,Daltonview,British Indian Ocean Territory (Chagos Archipelago),001-792-784-5969,687-685-7672x76300,darrell44@le.info,2022-02-23,http://www.french-maddox.net/
15-Jan-2021,Cheque,"1,610.80",00.00,"676,228.49",cfDB96C0EaD9550,5956,Erica,Andrews,Blackwell-Dennis,Balltown,Palau,001-379-361-8902x7493,+1-840-218-7459x8742,wanda09@yang.net,2021-06-29,http://www.trujillo.com/
15-Jan-2021,RTGS,"30,565.60",00.00,"706,794.09",6cECa992bEbaAe3,5743,Christine,Huff,Valentine LLC,Port Sarafurt,Guinea-Bissau,001-972-229-3143,252-179-2938,reneecampos@nielsen-reese.com,2020-12-02,http://glenn.info/
15-Jan-2021,NEFT,00.00,"70,679.41","636,114.68",05d930eBbfaEaDa,4220,Roger,Peck,"Weber, Adkins and Zavala",North Dakota,India,260-888-8420,+1-980-462-2878x3843,xnash@norton.com,2020-06-16,https://fleming-stafford.com/
15-Jan-2021,Bill,00.00,"63,611.47","572,503.21",A2c96CaA635d2c2,9879,Jay,Ayala,"Navarro, Chang and Zhang",New Edwinview,Saint Barthelemy,+1-492-642-5639x4603,685.191.2673x53308,whitesherry@joseph.info,2021-06-26,http://www.harper-keith.info/
16-Jan-2021,Interest,25.80,00.00,"572,529.01",1ceAFc50CEbD37B,9901,Laura,Burton,Dickson PLC,New Mollyshire,Puerto Rico,276-417-1795,001-325-059-6759x30537,kirkharding@ortega.com,2020-12-16,https://howell.com/
16-Jan-2021,Interest,00.00,"63,614.33","508,914.68",bADeB15D0B717cb,126,Warren,Fuller,Higgins-Barajas,West David,Croatia,741.103.1635,761-178-0428x49721,orice@drake.com,2020-10-04,http://tapia-davis.com/
16-Jan-2021,Debit Card,00.00,"127,228.67","381,686.01",7aD25ca2caA1c37,4012,Sue,Tanner,"Rowland, Barker and Cruz",East Jean,Latvia,741.638.5816x46148,278-560-4439x9798,leviflynn@barr-myers.biz,2022-04-30,https://www.mckee.org/
16-Jan-2021,Cash,01.72,00.00,"381,687.73",CD752A01Dc8428B,7579,Kellie,Carr,Pitts Ltd,South Erinberg,Kenya,001-060-302-4416x6526,001-154-369-6052x36817,nina32@atkins.com,2020-10-06,https://ponce-ochoa.net/
16-Jan-2021,Interest,"1,753.30",00.00,"383,441.03",61DbE2f2f4CfA55,1785,Emma,Douglas,Mccullough-Harrison,Jeffhaven,Tonga,(447)750-0364,(925)023-5928x97748,jermainesherman@weeks.com,2022-01-13,https://www.mcclain.com/
16-Jan-2021,Tax,06.61,00.00,"383,447.64",DADE73d661aac56,396,Erin,Boyer,Krause-Maldonado,Gallagherstad,Heard Island and McDonald Islands,(031)356-5581x111,(645)854-3522x9465,leslie12@pitts-holland.com,2020-03-16,https://www.meyer.biz/
16-Jan-2021,Miscellaneous,"5,268.97",00.00,"388,716.61",b23a87eA5AEAc2f,3749,Dave,Anthony,Baird-Greene,North Kirk,Saint Pierre and Miquelon,735.303.8646x729,+1-541-339-0282x6921,dillonterri@perkins.com,2021-05-30,http://harris.com/
16-Jan-2021,Cash,03.53,00.00,"388,720.14",Cf5b3E6bDe2a93c,4693,Duane,Macdonald,Nolan PLC,Kaufmantown,Cyprus,(985)098-9066x2265,0718533231,yquinn@galloway-kelly.org,2022-05-09,http://www.singh-stark.info/
16-Jan-2021,RTGS,00.00,"55,531.45","333,188.69",696c6A3aDE5Cc08,8521,Carla,Gamble,"Weaver, Harrell and Hanna",Sethfurt,Vanuatu,313-205-1196x6372,954.346.0670x911,ethanbush@waller-andersen.com,2020-09-16,https://neal-bullock.net/
16-Jan-2021,Tax,00.00,"166,594.35","166,594.34",74962aB79cCeb5F,2101,Julie,Russell,"Paul, Melendez and Ritter",East Chloe,Ireland,001-673-692-5097x58951,1969950864,robin82@burnett-ware.org,2020-07-27,https://www.shelton-contreras.com/
16-Jan-2021,ATM,659.00,00.00,"167,253.34",3D03b3E0D5d87cd,9763,Jamie,Dennis,Glass and Sons,Port Brad,Macedonia,612.651.0439,001-038-833-7766,odickerson@terrell.info,2020-06-20,http://www.humphrey.com/
16-Jan-2021,Commission,00.00,"16,725.33","150,528.01",cEF6414E79bCECB,1729,Theresa,Wilkerson,"Mack, Hall and Leon",Lambury,Mali,941-087-8168x6014,132-872-9629,grant00@chang.com,2020-07-26,https://www.durham-walls.net/
16-Jan-2021,Reversal,00.00,"18,816.00","131,712.01",06AF19AafaCf17F,3170,Jasmine,Solis,"Rowe, Mueller and Steele",Delgadoborough,Cape Verde,108.977.7724x68950,2564221570,elizabeth48@rosales.com,2020-04-18,http://patterson.com/
16-Jan-2021,ATM,00.00,"21,952.00","109,760.01",8433db2E07A145E,8808,Claudia,Molina,Chung-Morales,North Vanessashire,Azerbaijan,(123)787-6755x4934,2903775984,powellterri@wiley-knight.biz,2020-05-09,http://reynolds.com/
16-Jan-2021,Purchase,00.00,"27,440.00","82,320.01",C5FbA08308f596b,7982,Melinda,Fields,Vang-Ochoa,Dixonton,Montenegro,034-808-3993x2357,546.919.6522x77779,cody03@webster-vance.com,2021-12-02,https://www.kelly.com/
16-Jan-2021,Reversal,"774,259.50",00.00,"856,579.51",A425ace78C9Bf03,7345,Colton,Durham,"Morton, Cantu and Conley",Grantfort,Ecuador,(330)649-8299x019,704-915-7161x18640,traciethompson@patterson.biz,2020-11-19,https://kaiser.com/
16-Jan-2021,Bill,00.00,"171,315.90","685,263.61",Fd8CD3d6946EE58,4748,Virginia,Baird,"Powers, Jarvis and Carpenter",West Robynmouth,Hungary,608.539.3742x01943,(607)144-2981x66078,marvincordova@buck.com,2020-10-05,http://www.chandler.info/
16-Jan-2021,Bill,"1,626,877.00",00.00,"2,312,140.61",c56a23Af743b6BE,928,Beth,Chaney,Santos Group,Hensleyburgh,Sudan,926.656.1870,2758606986,penningtonpam@wade.com,2020-04-02,http://murphy.com/
16-Jan-2021,Transfer,00.00,"2,312,140.61",00.00,aeA1De2cFBC364C,7247,Angelica,Beck,Velazquez-Lawson,West Whitneyfort,Sao Tome and Principe,001-560-395-1863x3749,0883733493,raymonddestiny@banks-benitez.com,2020-12-09,http://benitez.com/
16-Jan-2021,NEFT,"26,748.00",00.00,"26,748.00",94CbE8f4DBdbaB2,4639,Derrick,Galloway,Dunlap-Hunt,Holmesmouth,Ghana,3097084700,484-480-3025x4949,jonathan39@potts-barber.com,2021-08-03,http://www.lawson.com/
16-Jan-2021,Tax,00.00,"6,687.00","20,061.00",6cBFcA8D33C5ae7,8930,Xavier,Cuevas,Macdonald-Weaver,Lake Damonburgh,Mayotte,4544952912,464-661-0858,isabel33@adkins.com,2021-12-14,https://bautista.com/
16-Jan-2021,IMPS,00.00,"2,229.00","17,832.00",FEfC56aEeFD575d,5898,Charlotte,Escobar,Mullen PLC,Lake Marissamouth,Switzerland,534.998.5416,4754829550,frobles@rhodes-gamble.com,2020-01-23,http://hanson.com/
16-Jan-2021,Transfer,00.00,"1,783.20","16,048.80",bdbA1F0053EDA7A,9993,Jennifer,Haynes,Alexander-Bass,Mcconnellland,Cayman Islands,001-346-519-8104,538.504.5143,jbeard@oneal.org,2020-12-19,http://brandt-gill.net/
16-Jan-2021,Bill,48.30,00.00,"16,097.10",b95f5fFaba722AC,4980,Casey,Schmidt,Marks-Manning,West Candacebury,Cook Islands,+1-485-518-1094x63757,262.397.8388,nashross@hebert.com,2021-07-14,http://gibbs.com/
16-Jan-2021,Transfer,50.10,00.00,"16,147.20",0D9602ABc1B63c7,9200,Marilyn,Middleton,Chang-Avery,Daisyborough,Egypt,598-002-6630,771-335-4352x303,kylie10@schmidt.com,2021-12-23,https://esparza-guerrero.com/
16-Jan-2021,RTGS,00.00,"1,614.72","14,532.48",BbcfFd9D29685BA,1711,Roger,Jimenez,Sims-Mckenzie,South Haydenville,Lebanon,747-121-4101,(421)754-9282,amy85@banks-russell.com,2021-03-01,https://www.landry.com/
16-Jan-2021,ATM,"1,324,519.00",00.00,"1,339,051.48",Fc0aB845dC093e6,7918,Harold,Jensen,Navarro PLC,West Maureentown,Turks and Caicos Islands,001-370-331-1504x5993,647.638.7159x1444,mario03@mayer.org,2020-02-10,https://steele.org/
16-Jan-2021,Miscellaneous,"656,068.00",00.00,"1,995,119.48",2EF6Fb53BAbcA2C,3096,Martha,Baird,Newman and Sons,West Marcusborough,Germany,625.061.1019,(252)827-1582x491,caseymatthew@mullen.com,2021-07-19,https://ritter.com/
16-Jan-2021,Tax,00.00,"249,389.94","1,745,729.54",3391cafEF197744,905,Taylor,Sheppard,"Moss, Schaefer and Wood",North Darlene,Greenland,001-516-304-1235,060.106.6735x2813,bethanymccann@townsend-huerta.com,2021-02-06,https://berg-chaney.com/
16-Jan-2021,RTGS,00.00,"249,389.93","1,496,339.61",93e6f8bDCb4D1AC,2116,Chad,Nguyen,Mccann LLC,New Gracebury,Mauritania,492-075-5960,(785)636-2008x449,isaac73@hood.com,2021-04-03,https://forbes-garrett.net/
16-Jan-2021,Tax,00.00,"149,633.96","1,346,705.65",f6d0e764A524fEb,8705,Dennis,Sutton,Buchanan-Mcclain,Cannonport,Liberia,2877514403,934.656.2993,lfuentes@levy-atkins.biz,2021-05-10,http://cain-mayer.info/
16-Jan-2021,IMPS,"27,072.50",00.00,"1,373,778.15",FCfbDF05Bc7a7c6,539,Andres,Kennedy,Conner Group,Port Kirsten,Falkland Islands (Malvinas),(482)286-3803,001-313-359-6200,kristen16@mcdonald.com,2022-02-16,https://aguirre.com/
16-Jan-2021,Tax,"16,481.49",00.00,"1,390,259.64",ccdeE8EBFaD872D,6313,Edward,Sawyer,Stevens Inc,Steventon,American Samoa,(835)769-9706,(697)463-3120,manueldowns@dodson-wilkerson.com,2021-12-24,http://ryan.org/
16-Jan-2021,IMPS,"78,077.00",00.00,"1,468,336.64",9F3EF2B86c3ea30,1815,Jackson,Huerta,"Villarreal, Fernandez and Winters",Ballchester,Moldova,199-288-2506,(070)063-9219x741,tara33@solis-rojas.com,2020-05-15,http://www.noble-raymond.org/
16-Jan-2021,Interest,00.00,"183,542.08","1,284,794.56",B9Cd4d6725CC3de,7050,Erin,Patterson,Carr Inc,South Cindychester,Malta,+1-457-903-5438x0399,(994)973-9323x893,steinariana@kane-gonzales.com,2020-07-18,http://www.jimenez.net/
16-Jan-2021,NEFT,00.00,"321,198.64","963,595.92",E311a1f2E7dBABb,3369,Phillip,Travis,Richard-Fleming,Maxwellmouth,Luxembourg,+1-241-475-1726,(708)201-9142x230,qrubio@bean.net,2022-03-26,https://guerra.org/
16-Jan-2021,Cash,00.00,"137,656.56","825,939.36",8Acb14a4FBB1F42,7383,Tammie,Good,"Jordan, Bradshaw and Barber",South Jayhaven,Djibouti,001-626-577-9248x0032,382-920-2668x05668,chaselarsen@holland.info,2020-02-03,https://www.bright.com/
16-Jan-2021,IMPS,00.00,"82,593.94","743,345.42",16e8f82E1BdD8bd,279,Tiffany,Bruce,Joseph-Lyons,East Alishaport,China,451-922-4817x107,+1-720-469-0819x964,latashaburch@woodward.com,2021-10-24,https://levy.org/
16-Jan-2021,Transfer,"230,135.97",00.00,"973,481.39",7335A7a9c34cFcA,8434,Leslie,Mcmillan,"Randolph, Mcneil and Glenn",South Tyrone,Azerbaijan,3437387070,+1-804-482-3152,margaret56@green.com,2021-05-23,http://ray-herrera.org/
16-Jan-2021,Debit Card,00.00,"973,481.39",00.00,15D7F67f2f1bd14,9388,Debra,Pugh,"Gomez, Benson and Romero",South Erinland,Albania,+1-650-332-1312x80381,1027356361,deniserussell@khan-haley.info,2021-10-22,https://www.lamb.com/
16-Jan-2021,Transfer,"3,740.00",00.00,"3,740.00",550c41F8764B16E,425,Ashlee,Koch,"Lawrence, Cox and Terry",South Whitney,United States of America,(832)608-7152,9888960958,mooreian@arias-lloyd.org,2021-04-28,http://www.chen.net/
16-Jan-2021,RTGS,04.00,00.00,"3,744.00",9F4971EFb502c27,5499,Kelsey,Morris,Collins PLC,Belindaview,Moldova,001-516-947-2216x1645,001-492-514-4137,awinters@lara.com,2021-09-07,https://www.phelps-powers.org/
17-Jan-2021,Bill,00.00,936.00,"2,808.00",f9D6e9069d6a17c,6566,Jade,Noble,Mcintyre Inc,New Caitlyn,Philippines,(156)784-2167x806,001-787-959-1394x80579,stanley30@mcfarland.com,2021-01-14,https://morton-townsend.org/
17-Jan-2021,Miscellaneous,"2,045,424.50",00.00,"2,048,232.50",B4e11acb4C6E79c,2612,Vernon,Weaver,"James, Rice and Proctor",South Latasha,Hong Kong,001-882-369-1608x05683,056.805.6977,caindennis@silva.com,2020-04-02,https://www.dodson.com/
17-Jan-2021,Miscellaneous,00.00,"256,029.06","1,792,203.44",Acd12b7aD21dFFc,9830,Stacey,Zavala,Mccall Group,Johnathanburgh,Cayman Islands,(052)462-7647,001-074-194-7170,knorton@leach.com,2022-05-21,https://www.lowe.com/
17-Jan-2021,Miscellaneous,00.00,"448,050.86","1,344,152.58",20DDAe8acC17dcF,9684,Victor,Bautista,Cortez Group,Escobarbury,Heard Island and McDonald Islands,685-717-6205,(183)386-9956,moniquegibson@maldonado.org,2021-02-19,https://richards-cameron.org/
17-Jan-2021,Commission,23.00,00.00,"1,344,175.58",eCEE08Fb05B4BBE,8455,Bryce,James,Bean Group,West Kristen,Syrian Arab Republic,001-448-418-6568x822,001-866-900-5528x295,davidmcdowell@wheeler-burgess.org,2020-06-25,https://stuart-hunt.biz/
17-Jan-2021,IMPS,00.00,"448,058.53","896,117.05",2CAd93D8b0F918a,5089,Charlene,Riggs,"Buck, Tucker and Sandoval",Andreshire,Northern Mariana Islands,001-872-577-8305,001-849-332-5779x6191,jmcconnell@collins.org,2021-03-11,https://mcfarland-hughes.com/
17-Jan-2021,RTGS,00.00,"149,352.84","746,764.21",CFfBC4Ea521BcAD,3886,Terrance,Bean,House Group,Deborahview,Cameroon,(745)081-1569x998,279-999-5543,bianca83@camacho.com,2021-08-26,http://www.glover-bishop.biz/
17-Jan-2021,Bill,00.00,"93,345.53","653,418.68",aB2DF335fBDBecF,8127,Ray,Lynn,"Russell, Drake and Chung",Hardinchester,American Samoa,879.938.8706x029,+1-090-708-9866x67442,zhale@horton-jimenez.com,2020-06-20,https://www.clarke-mercer.org/
17-Jan-2021,IMPS,"29,980.90",00.00,"683,399.58",bFBdC1cf26cecdF,1525,Darren,Murillo,"Martinez, Mccormick and Gilbert",Victoriaview,Kazakhstan,449.315.4450,+1-433-875-0164x46367,cassidykent@green.com,2021-05-15,http://roberson-gonzales.org/
17-Jan-2021,Commission,00.00,"97,628.51","585,771.07",d83Aaee229805fe,8436,Breanna,Moreno,Hodges Inc,Annashire,Sri Lanka,+1-378-820-4257x621,187.743.1721x143,megan26@avila.com,2020-07-28,http://www.skinner-huang.org/
17-Jan-2021,Cash,00.00,"195,257.02","390,514.05",c31288Ca04429b5,5686,Cheyenne,Randall,"Butler, Wheeler and Schultz",Port Herbertberg,Hong Kong,+1-605-838-9276,077-710-5858,mikewilliamson@cardenas-davidson.com,2021-01-11,http://fernandez.com/
18-Jan-2021,Purchase,29.74,00.00,"390,543.79",e815681eb913Ef5,7332,Shelia,Terry,Briggs Inc,Deckertown,Mauritius,115-529-4046x804,4903074483,herrerajerry@yang.com,2020-03-22,http://washington.com/
18-Jan-2021,Cheque,00.00,"97,635.95","292,907.84",3bde170d4Be6b91,8295,Jo,Mckinney,Padilla-Riddle,Tonyburgh,American Samoa,239-623-1250,(353)883-4443x349,orandolph@russell.com,2020-10-08,http://www.todd.biz/
18-Jan-2021,RTGS,14.16,00.00,"292,922.00",aD305A14D9f676b,6106,Alfred,Richards,Weiss-Medina,Jeanettehaven,Solomon Islands,294-071-8361x65833,9349122054,brucedonovan@torres.com,2021-12-08,http://brandt.com/
18-Jan-2021,Cheque,00.00,"146,461.00","146,461.00",Df12bAEF5EE5baf,3966,Autumn,Galloway,Keller-Quinn,Port Lori,Maldives,001-908-885-5126,714-532-9173x425,gordonabbott@carson-robles.com,2020-09-06,http://perkins.com/
18-Jan-2021,Purchase,896.00,00.00,"147,357.00",380f4DdDC06fa82,2424,Grant,Snyder,Buckley LLC,Mortonmouth,Ecuador,006.798.9180x5770,689.541.4149x06592,breweredgar@aguirre.com,2021-02-01,https://krause.info/
18-Jan-2021,Cash,60.39,00.00,"147,417.39",Ad75ABfC6baDb08,8122,Tamara,Rios,Randolph-Arnold,Cantuport,Malawi,(344)727-1430,993.031.6146x5369,campbellkristy@carter.com,2021-12-31,https://www.massey-golden.com/
18-Jan-2021,Cheque,00.00,"16,379.71","131,037.68",c0F56ea6411D6B7,469,Faith,Flores,Smith LLC,South Marcus,Guernsey,+1-890-354-6542x581,+1-107-204-6659x94816,eric18@avery.com,2020-01-12,https://www.powers.net/
18-Jan-2021,NEFT,"21,131.32",00.00,"152,169.00",819D61Ab24EEc54,8973,Deanna,Butler,Burnett PLC,Grimesshire,Lesotho,+1-595-216-0434x984,166-118-6035,jocelyn46@beard.net,2020-04-09,http://holloway.com/
18-Jan-2021,Bill,00.00,"76,084.50","76,084.50",a5b4D563dcddAEa,6430,Isabel,Sheppard,"Walton, Frost and Hunter",Johnathanchester,Burkina Faso,927.933.9786,+1-045-632-6607x733,rickholt@pena.com,2020-08-19,https://www.carlson-moreno.biz/
18-Jan-2021,Transfer,00.00,"38,042.25","38,042.25",1F08cfc8b04Ad1c,4756,Isabel,Mccall,"Baldwin, Patterson and Hatfield",South Shawn,Sierra Leone,(208)592-3315x159,148.860.0450x5700,iriley@west.com,2020-08-22,http://www.forbes.com/
18-Jan-2021,NEFT,02.80,00.00,"38,045.05",638A174040f3ef0,9974,Lance,Bullock,Kane-Hamilton,Victorstad,Maldives,+1-405-388-9089x060,(946)058-7598x02917,srussell@pace-ferguson.biz,2021-03-29,https://www.schroeder-odom.info/
18-Jan-2021,Interest,"171,774.90",00.00,"209,819.95",2ff13b914edaA07,4658,Isabella,Short,Lee LLC,Manuelberg,Turkey,611-949-0743x9394,658-497-5501x1179,kchristian@greer.biz,2021-01-07,http://king.com/
18-Jan-2021,IMPS,00.00,"41,963.99","167,855.96",ccC0ddeBF9b1cbe,4432,Tina,Hood,Benton-Ferguson,New Travisbury,Greenland,9170749340,132-472-7322,daryl70@rodgers.com,2020-11-29,https://blair.biz/
18-Jan-2021,Reversal,00.00,"55,951.99","111,903.97",EdA994fF036bB4b,4493,Carl,Michael,Gordon LLC,Watersfort,Central African Republic,7000347398,994-486-7276,luiswelch@pugh.com,2021-02-27,https://www.hughes.net/
18-Jan-2021,Debit Card,"995,186.50",00.00,"1,107,090.47",d2adD39063FfDFA,4482,Janice,Hart,"Mcconnell, Buckley and Hawkins",West Ivanberg,Suriname,(991)324-1380x56561,3983976026,howardvictoria@blake-sandoval.com,2020-09-11,http://obrien.biz/
18-Jan-2021,NEFT,00.00,"221,418.09","885,672.38",32B7A0Fa103c698,1143,Earl,Ferguson,"Harrington, Carr and Stanton",Laurachester,Lao People's Democratic Republic,(555)257-9307,6161653556,beasleyjoel@rasmussen-guerrero.info,2021-06-01,http://www.pineda-davis.com/
18-Jan-2021,Commission,"1,455,628.00",00.00,"2,341,300.38",b4f8F1D3Cb5F7cf,6633,George,Gonzales,"Bowman, Allen and Rhodes",North Madison,Guadeloupe,732-028-3480x6134,717.168.8758x3994,staffordnatasha@shields.net,2020-02-08,http://www.harding.com/
18-Jan-2021,ATM,00.00,"2,341,300.38",00.00,7662Aee114DE1b1,520,Christian,Hansen,"Cohen, Zavala and Hodge",Russelltown,Thailand,875-297-1537x6615,465.146.2449,annettedavid@mcintyre.com,2021-10-08,http://blair.com/
18-Jan-2021,Commission,"2,068.00",00.00,"2,068.00",6c925e307a5E149,6816,Logan,Lucero,Best-Compton,South Elaine,Solomon Islands,(995)906-2540x998,785.192.8557x801,brichmond@adkins.com,2021-03-22,https://www.keith-allison.net/
18-Jan-2021,Commission,03.60,00.00,"2,071.60",7DcEd0B283DEcF6,7989,Collin,English,Moody Inc,South Troy,Zambia,6687464191,287-986-4620x6583,sdickson@dunn.info,2021-02-10,https://stanley.biz/
18-Jan-2021,RTGS,00.00,517.90,"1,553.70",BDcF546acEC0D00,7154,Deborah,Bolton,"Cardenas, Mcknight and Mitchell",Latashabury,Malawi,001-408-376-7398x926,(471)198-1184,cole11@gallagher.com,2020-07-09,https://www.coffey-huber.com/
18-Jan-2021,Commission,07.80,00.00,"1,561.50",E8c0e0a7C7DEF59,6945,Kelsey,Mullins,Mosley-Kennedy,South Marioview,New Zealand,084-311-5017,001-537-420-7489x740,trevinobreanna@murphy.com,2020-05-09,https://www.singh.com/
18-Jan-2021,Interest,"178,505.10",00.00,"180,066.60",89adEe03fBdCe2b,5039,Kelly,Romero,Vega-Hayes,North Shannonside,Zimbabwe,+1-872-424-0701,001-491-901-1829x0683,snyderblake@jackson.biz,2021-10-16,https://farmer-lowe.com/
18-Jan-2021,Cash,00.00,"25,723.80","154,342.80",3B002Ca124e6a04,7192,Bridget,Branch,"Daugherty, Howell and Poole",Port Toni,Trinidad and Tobago,201.050.4291x408,(385)378-0018,julianmorse@castaneda-juarez.net,2021-10-01,https://warren.com/
18-Jan-2021,Debit Card,00.00,"30,868.56","123,474.24",7ca1dbE1BFCd7f7,7358,Amy,Arellano,Cervantes and Sons,West Shelly,Ireland,6299810481,001-729-285-7425,ralph21@braun.org,2021-08-20,https://anderson-anthony.org/
18-Jan-2021,Cash,07.00,00.00,"123,481.24",CB9Ee7105dCbc26,1262,Krystal,Mayer,Hogan Group,Carrieberg,Timor-Leste,239.061.8278x142,640.351.9188x96150,ronaldbullock@cain-watkins.biz,2020-05-04,http://davila.biz/
18-Jan-2021,Cash,06.30,00.00,"123,487.54",FDf385eFBfA3e1e,6835,Sandra,Mcintosh,Potter-Meadows,Mckayshire,American Samoa,149-765-7021x0721,8956532266,nallison@mcmillan.biz,2020-03-04,http://www.castro.com/
18-Jan-2021,Miscellaneous,00.00,"12,348.75","111,138.79",f20Cac39a9bB582,6727,Kristi,Mitchell,"Carr, Parsons and Weaver",West Sheena,British Indian Ocean Territory (Chagos Archipelago),053.650.9093,001-407-106-2390x5626,agilbert@abbott-patrick.org,2021-03-23,http://rogers.com/
18-Jan-2021,Cash,00.00,"12,348.75","98,790.04",c7d5Dfe797f015F,4271,Cassie,Barnett,Rivas PLC,Glennmouth,Kuwait,001-096-769-8732x8053,(956)096-1441,uzimmerman@chang-levy.info,2021-01-04,http://ochoa.com/
18-Jan-2021,Purchase,00.00,"24,697.51","74,092.53",e1Fd5F5eef4ce3D,731,Rachael,Gentry,"Bradshaw, Cooley and Martinez",Jenniferport,Jordan,820-110-7293x8051,001-593-704-3130x1384,jle@ewing.org,2021-03-18,http://greene.com/
18-Jan-2021,Tax,00.00,"9,261.57","64,830.96",270E139f371deD0,3720,Tony,Gould,Mack-Braun,Darrellstad,Vanuatu,006.409.4821,275-954-4639x8716,daltonalvarado@campbell-thompson.net,2022-04-10,http://www.marquez.org/
18-Jan-2021,Interest,00.00,"21,610.32","43,220.64",dEA1EeBCC2dEDce,6182,Misty,Burnett,Mckee PLC,Lake Keithshire,El Salvador,777.559.4856x821,531.836.8691,valerie18@estrada-tran.info,2020-08-09,https://www.stuart.com/
18-Jan-2021,Miscellaneous,02.47,00.00,"43,223.11",fFd6116411d77eF,1635,Ricardo,Kirk,"Underwood, Mendoza and Stephenson",Mccannville,New Zealand,+1-499-734-2552x685,(826)656-4958,jimenezbrad@mcgee.com,2020-08-26,https://www.frye.com/
18-Jan-2021,Tax,00.00,"8,644.62","34,578.49",C200893A8b4De2a,4107,Kristin,Shields,Dennis-Castillo,West Janiceview,Puerto Rico,286-279-2716,+1-939-517-0285,gmiranda@bird.com,2022-05-25,https://atkins.net/
18-Jan-2021,Purchase,03.00,00.00,"34,581.49",d9B98A7D4E6116F,3919,Lonnie,Spencer,"Bradford, Harrell and Clark",North Lydia,Yemen,565-578-6054x495,(230)834-9833x35140,kristi94@estes-silva.com,2021-01-21,https://www.cantrell.org/
18-Jan-2021,Reversal,146.96,00.00,"34,728.45",F7c6EFB87beeF1B,3461,Robin,Jones,Banks-Barnett,North Wandachester,Fiji,602.324.8275,001-876-081-7620x5027,iyoung@turner.com,2021-05-05,http://white.com/
18-Jan-2021,Debit Card,"8,471.50",00.00,"43,199.95",AFb3dA721E03F48,2811,Karina,Charles,Lamb-Parks,North Gwendolyn,Ecuador,711-331-4378,(680)264-3276,ehaley@hampton.com,2021-02-20,https://phillips-summers.biz/
18-Jan-2021,Commission,00.00,"43,199.95",00.00,Bf8d80EAC5E490E,4504,Howard,Dudley,"Garner, Randolph and Koch",Crawfordfurt,Dominican Republic,199-975-6348,989.757.2558x2526,schwartzkathryn@maldonado.net,2020-07-27,http://blevins-silva.com/
18-Jan-2021,NEFT,03.00,00.00,03.00,2E0426557Ac4817,695,Latasha,Arnold,Keith Inc,New Jill,Thailand,172.345.7181x51172,805-142-6870x89496,bernardmelinda@huerta.biz,2021-10-17,https://forbes.com/
18-Jan-2021,Interest,"23,190.00",00.00,"23,193.00",44efF0B1C42Ea7A,909,Betty,Crane,"Stone, Peters and Petersen",Mikaylaside,Yemen,452-010-6155x74965,425-030-1153,linda70@shepherd.net,2021-07-13,http://graves.com/
18-Jan-2021,Bill,25.00,00.00,"23,218.00",92E817f48CaE609,4116,Vickie,Holt,Dorsey-Klein,Lake Andre,Russian Federation,8035819501,001-364-205-3674x44600,gene05@bird.com,2021-03-08,https://www.walker-rice.com/
18-Jan-2021,Debit Card,00.00,"11,609.00","11,609.00",B335254C5C2a481,9839,Garrett,Barrett,Weeks-Molina,North Sonyashire,Macedonia,(227)988-7586x3407,601.901.9968,isaiah94@malone.net,2022-05-05,https://www.duffy.info/
18-Jan-2021,Cheque,"79,450.00",00.00,"91,059.00",E1abaEB221Fc958,8293,Kathy,Gilbert,"Haas, Guzman and Hicks",South Katrina,Isle of Man,904.385.5514,042-210-6358,rdavidson@noble-glover.com,2020-03-22,https://www.bridges.biz/
18-Jan-2021,Tax,39.00,00.00,"91,098.00",149D9deeb0C4c7E,5942,Willie,Skinner,"Bradford, Buck and Mcguire",North Jillland,Antarctica (the territory South of 60 deg S),(808)323-8081x84538,(234)629-8730,tammy35@hoffman.org,2022-04-13,http://www.tapia.info/
18-Jan-2021,Bill,10.00,00.00,"91,108.00",deEfc43CaB3bB49,6043,Crystal,Cortez,Hays Group,Whitakerland,Grenada,(599)960-0048x42784,493-174-4405,jasminebrennan@cochran.info,2020-03-23,http://www.white-sharp.net/
18-Jan-2021,Cash,"3,310.70",00.00,"94,418.70",1c08e6dB6FB09B8,8866,Stefanie,Rosario,"Porter, Luna and Christian",Christinaside,Egypt,467-641-7345,1861203167,roachcarly@roy.net,2021-12-26,https://www.gates.com/
18-Jan-2021,Commission,00.00,"23,604.68","70,814.02",Bf3Bc19ed8deBe2,7054,George,Terrell,"Brandt, Torres and Stein",South Hailey,French Guiana,(879)372-8159,(971)947-5740x619,curtisshepard@wiggins.com,2020-02-25,http://www.dalton-leonard.com/
18-Jan-2021,ATM,"1,441,874.20",00.00,"1,512,688.22",56c4fac2d6f002f,2957,Derrick,Reilly,Heath and Sons,Port Kent,Cote d'Ivoire,+1-267-780-2709,+1-039-186-2940x35560,fbest@pierce.com,2021-11-28,https://www.king.com/
18-Jan-2021,Commission,00.00,"189,086.03","1,323,602.19",3D155ccdA67A0d8,9307,Dillon,Bass,Massey and Sons,Manuelton,Chad,191-711-7985,001-114-801-2855x6100,carl79@reid-moore.com,2020-08-06,http://www.noble.com/
18-Jan-2021,Cash,00.00,"441,200.73","882,401.46",Cb1cCdB8cc0C6CA,5460,Kaylee,Hardin,"Mosley, Johnson and Weeks",Bradyfort,Lebanon,001-729-803-3682x91674,161.996.0536,rsummers@paul.org,2020-04-12,http://peck.biz/
18-Jan-2021,Transfer,00.00,"441,200.73","441,200.73",CCCB188A1Cb6687,9293,Kylie,Hayden,"Larson, Beck and Bean",Ralphfurt,Mongolia,9241820464,(837)182-8303,miranda40@nichols.info,2021-09-06,https://www.ochoa-yates.com/
18-Jan-2021,Interest,00.00,"44,120.07","397,080.66",e4AF5c2D25FC332,7517,Stefanie,Dixon,Hayes PLC,West Jasminmouth,Mayotte,6942792539,(985)745-5912x0268,kramerguy@jones.org,2020-02-16,https://www.curtis.com/
18-Jan-2021,IMPS,"10,175.23",00.00,"407,255.89",AcBbeCc0A66D2C1,1366,Samantha,Church,Woodard Group,North Ginashire,Holy See (Vatican City State),196-578-5878x7522,(517)947-0113,wclayton@carroll.org,2021-07-23,http://sampson-cooke.com/
18-Jan-2021,RTGS,381.40,00.00,"407,637.29",BAf22D8FEFe1Cac,2389,Bryce,Cook,Meadows PLC,West Darius,Chad,+1-028-972-8580x0939,001-844-060-6445,klandry@sellers-fields.biz,2021-08-28,http://rivas.com/
18-Jan-2021,Transfer,"3,491.30",00.00,"411,128.59",CBcfFC286FDc461,356,Rebekah,Barnes,Arias-Montgomery,Bethanytown,Pakistan,(472)810-4201,306-531-6684x302,christianmata@gates.com,2021-02-17,http://patel.biz/
18-Jan-2021,Transfer,00.00,"411,128.59",00.00,E8ACEA62adD4b1f,7316,Julian,Sawyer,Wheeler LLC,Ebonystad,Sierra Leone,001-901-075-8072,(634)849-7913,gene24@mcclain.org,2021-02-09,https://www.graves-nolan.com/
18-Jan-2021,Bill,"15,369.40",00.00,"15,369.40",9B0f8934A212c78,5334,Jonathon,Garcia,Mcdowell-Davies,West Janiceberg,Burundi,528.839.2580,001-388-875-5886x704,ckramer@logan-reeves.com,2020-02-29,http://www.odonnell.com/
18-Jan-2021,ATM,00.00,"2,195.63","13,173.77",EF2ae2Fc40fBAef,2309,Elizabeth,Burton,Kennedy Ltd,Alejandroton,Cambodia,342-750-6258x604,001-547-407-9743x7194,lauren40@chaney-delacruz.org,2020-09-15,http://www.cooley.com/
18-Jan-2021,Tax,51.40,00.00,"13,225.17",Eba37be7cFc9abf,1317,Judith,Hardy,Liu and Sons,South Makayla,Korea,822-114-1488x08789,(324)290-9078,colemanjennifer@colon.net,2022-03-12,https://juarez.com/
18-Jan-2021,Bill,"1,303,131.25",00.00,"1,316,356.42",e6FaA0b330bb4AF,7469,Makayla,Wang,"Lucero, Wu and Mcclain",Cherylberg,Tajikistan,+1-773-495-9752,2294826048,marshallisabel@li-porter.com,2021-12-27,http://www.drake-nunez.com/
18-Jan-2021,Commission,00.00,"164,544.55","1,151,811.87",A3da9023cAFfF41,5187,Elizabeth,Schmitt,Romero-Walsh,West Judith,Mali,053-698-9506,(497)556-9032,jermaineleach@hester.info,2021-11-08,https://blake.com/
18-Jan-2021,RTGS,721.70,00.00,"1,152,533.57",FC4EDBc20Cfb8e5,7567,Diane,Rivas,Duffy Ltd,West Christieshire,Ethiopia,001-388-744-7046x9352,(860)761-8474,travismaurice@calhoun.info,2021-09-21,http://kramer.com/
18-Jan-2021,Interest,"35,134.80",00.00,"1,187,668.37",09CC9EbAF60F26E,5480,Rose,Tate,"Shea, Benitez and Davies",Kristinmouth,Nauru,+1-562-662-8749x2482,794.137.2690,umeza@mcbride.net,2020-12-08,https://www.schroeder-valencia.com/
18-Jan-2021,Cash,00.00,"118,766.84","1,068,901.53",0A3d0Bf5D2d67d6,7182,Rachel,Singh,"Horton, Curry and Chung",Port Jackside,Holy See (Vatican City State),631-511-5101x27245,001-294-063-4233x0469,ipetty@navarro-little.com,2022-03-16,http://rodriguez.net/
18-Jan-2021,NEFT,126.00,00.00,"1,069,027.53",39B3b72eA60759a,3134,Cesar,Hansen,Robinson-Kemp,Port Emma,Wallis and Futuna,283-592-7552x364,696.896.1928,isaunders@booker.com,2020-03-24,https://www.li.com/
18-Jan-2021,Purchase,00.00,"1,069,027.53",00.00,C6b62Ed169d0f4F,6748,Mark,Stephenson,"Greene, Moon and Allen",Duartemouth,Finland,427-519-7457x27731,072-969-4884x707,alexandermorgan@conley-fischer.org,2020-07-18,https://www.austin.com/
18-Jan-2021,Bill,75.00,00.00,75.00,Eedaa2Cf4efa503,2297,Sarah,Alvarado,"Crosby, Bates and Conrad",Lake Beverly,Denmark,530-197-5883x65749,1876708892,jim59@townsend.info,2020-07-06,http://www.harrell-murray.com/
18-Jan-2021,Debit Card,03.00,00.00,78.00,30A2f62BE3dEbCE,8572,Dan,Mccarty,Moody-Strong,Lake Donna,China,5667491071,415.971.9242x225,rodriguezclaire@watson-moran.biz,2021-04-17,http://villarreal.com/
18-Jan-2021,Miscellaneous,53.90,00.00,131.90,F884B5F5C06b83F,838,Shelby,Huynh,"Banks, Wright and Montgomery",Manningville,Kazakhstan,(449)603-6483x775,+1-206-262-0110,meghan36@aguirre.com,2022-01-09,http://yu.info/
18-Jan-2021,Transfer,00.00,18.84,113.06,36c67dEBCaFF9aF,112,Dustin,West,"Mitchell, Pierce and Barry",Curtisborough,Estonia,(916)855-7231x9708,001-688-505-3003,patrickfelicia@goodwin.org,2020-12-29,https://henson.net/
19-Jan-2021,NEFT,"1,776,588.00",00.00,"1,776,701.06",7Cbfb6Cd73CAbeF,8944,Kellie,Cortez,"Singleton, Hayes and Diaz",East Eduardostad,Czech Republic,001-741-839-1507x1520,+1-523-669-0880x223,ymorrow@stanton.com,2020-09-20,https://www.shannon-shaw.org/
19-Jan-2021,Commission,"2,984.00",00.00,"1,779,685.06",Ddf706eEF9aF53A,621,Molly,Barr,"Cameron, Munoz and Rogers",Codyport,Palau,407.938.5239,953.542.0604x22105,raven50@zavala-shepherd.com,2020-02-02,http://farrell.com/
19-Jan-2021,ATM,00.00,"177,968.51","1,601,716.55",8b7dd3663ca8210,986,Earl,Reid,"Singh, Miller and Golden",West Lancestad,El Salvador,(304)401-6534,(579)946-4417x338,wayne62@jennings-burnett.com,2020-09-16,http://www.salas-gross.biz/
19-Jan-2021,Interest,"3,345.25",00.00,"1,605,061.80",A60B00ABddD66dD,4552,Gilbert,Ritter,Burns Group,West Vickie,Malawi,274.566.3324x21147,195-049-0364,sergio92@hansen-moss.info,2020-09-21,https://www.koch.com/
19-Jan-2021,Bill,00.00,"321,012.36","1,284,049.44",0905bE9447B27ac,2720,Malik,Terrell,Hammond-Burke,Markside,Dominica,5790815793,+1-163-026-5766x5603,claire76@peterson-french.com,2020-04-19,https://hernandez-jacobs.com/
19-Jan-2021,IMPS,"30,180.90",00.00,"1,314,230.34",ECD05B505Ba76ec,1079,Renee,Lang,Daniel Inc,East Steven,Philippines,+1-515-849-4431,195.887.3616x453,clogan@estes.com,2020-09-18,http://www.mclaughlin.biz/
19-Jan-2021,Reversal,26.50,00.00,"1,314,256.84",F2Df24e6C6e8f3D,4703,Beth,Sharp,"Zhang, Gardner and Ramos",Lake Ravenland,Kazakhstan,441-782-4311x5993,+1-858-563-4071,gibbsjon@fletcher-mccann.com,2022-04-16,http://randolph-pitts.biz/
19-Jan-2021,Transfer,04.00,00.00,"1,314,260.84",2Dbea9dBC2FE0D3,9209,Luke,Whitaker,Hanson LLC,Carlaport,Venezuela,001-912-230-0189x07363,001-046-870-8180x5047,mariamoreno@flores-thompson.com,2020-07-05,http://weeks.com/
19-Jan-2021,Miscellaneous,00.00,"146,028.98","1,168,231.86",4096c18Ffe12d1f,6977,Tanya,Peters,Brock and Sons,Graceburgh,Korea,+1-907-371-1962x6132,347-011-0000x66073,jillian40@patel-banks.com,2020-06-18,http://suarez.com/
19-Jan-2021,Reversal,00.00,"1,168,231.86",00.00,4e672dC1b89757F,2995,Darius,Khan,Baxter-Patterson,North Jennyburgh,Monaco,(184)895-3535x492,001-494-887-2358,dyermegan@liu.org,2020-09-26,https://ellison-colon.biz/
19-Jan-2021,Debit Card,441.50,00.00,441.50,83E1Cdf25ADa2b7,5209,Miguel,Hall,Kramer PLC,South Courtneyland,Mali,(095)504-5605x14163,+1-567-900-1813x58461,alyssaponce@ayala-valentine.net,2020-05-07,http://reynolds.net/
20-Jan-2021,ATM,00.00,110.38,331.12,fCBFFE1D1D7EbFf,82,Wanda,Cowan,Cherry-Yates,North Nathanielton,Brunei Darussalam,001-205-431-0213x5471,(917)935-2327x3320,qlarson@berry.biz,2021-09-24,http://www.potts-conrad.com/
20-Jan-2021,Bill,"45,431.69",00.00,"45,762.81",A4A70B6eAA39A6c,3435,Jocelyn,Mooney,"Hinton, Werner and Gaines",Singletonville,Saint Kitts and Nevis,001-378-668-6482x5512,001-190-955-6308x37871,fli@brewer.com,2021-05-03,https://duncan.com/
20-Jan-2021,Purchase,00.00,"15,254.27","30,508.54",e586A2D67bcdB48,12,Sara,Shaffer,"Dudley, Coleman and Green",Orrland,Gambia,4229986278,001-028-824-7381x56737,gabrielaleach@rose.net,2021-04-07,https://www.hoffman-rubio.com/
20-Jan-2021,Reversal,00.00,"15,254.27","15,254.27",196DcfDd1ABDeCa,9923,Aaron,Berg,"Wells, Dodson and Rhodes",Lake Gerald,Mozambique,+1-022-635-2617,(038)321-0452,fmedina@kramer-munoz.biz,2020-10-16,http://aguilar.biz/
20-Jan-2021,RTGS,219.50,00.00,"15,473.77",6C36De54ecD7FEc,1474,Sean,Shah,Friedman-Kramer,Reeseview,Cote d'Ivoire,900.217.6798x4176,140.763.0157x96196,jackpalmer@pugh.biz,2021-08-17,https://woodard.org/
20-Jan-2021,Cash,"502,520.50",00.00,"517,994.27",0Cb63b5E6857ceE,3201,Bethany,Oliver,Moss Group,South Aaronside,Turks and Caicos Islands,(207)027-8662x6792,(700)220-2308x980,vvelez@coleman-rice.biz,2020-07-12,https://morse.net/
20-Jan-2021,Tax,00.00,"57,554.92","460,439.35",5fe1294Eee679cf,2437,Brad,Leblanc,Luna-Lozano,Port Diamondtown,Tajikistan,506-162-8927,952.433.9570x810,uhicks@arias.info,2021-12-17,http://www.kelley-acosta.biz/
20-Jan-2021,Cheque,00.00,"153,479.78","306,959.57",70F2fF9bAb889d0,2926,Joseph,Benitez,Watkins-Schmitt,Villarrealstad,Lao People's Democratic Republic,981-859-0715x6229,(638)912-7588,oscar35@ortega-calhoun.biz,2021-07-11,https://www.haynes.com/
20-Jan-2021,Commission,03.00,00.00,"306,962.57",cecEcB86fd8fe2a,4335,Shannon,Jenkins,Vang Group,Port Fernando,Korea,(437)767-0545,3843960784,vancelori@mcdowell-gray.org,2021-12-30,https://mccarthy.com/
20-Jan-2021,Cheque,"140,755.50",00.00,"447,718.07",5ECC46c9E8cBCaD,3542,Perry,Gutierrez,"Middleton, Sanders and Armstrong",Adamport,Guadeloupe,+1-720-408-1555x905,482-738-1076x035,imedina@sanders.org,2022-04-21,http://www.berry.com/
20-Jan-2021,IMPS,"386,547.25",00.00,"834,265.32",EA662a32D6C9ABB,7781,Kyle,Dougherty,Cardenas PLC,Antonioville,United States of America,001-661-863-9962x6445,+1-998-694-2623x52996,ericazimmerman@hahn.net,2021-12-16,https://www.contreras.info/
20-Jan-2021,Bill,"1,321.18",00.00,"835,586.50",3D03b3E0D5d87cd,9763,Jamie,Dennis,Glass and Sons,Port Brad,Macedonia,612.651.0439,001-038-833-7766,odickerson@terrell.info,2020-06-20,http://www.humphrey.com/
20-Jan-2021,Miscellaneous,327.00,00.00,"835,913.50",520fEc82d6FC65f,4687,Howard,Jarvis,Mcfarland Group,New Graceborough,India,656-493-9413,220.992.3081,maurice95@cooper.com,2020-04-16,http://www.stephenson.biz/
20-Jan-2021,Tax,"796,750.00",00.00,"1,632,663.50",39AfAab3dEf0cc5,5036,Tammie,Glenn,"Petty, Franco and Oconnell",Susanstad,Bahrain,(467)659-0848,860-606-6266x3708,jane10@west-stone.biz,2020-11-23,http://www.cain.com/
20-Jan-2021,NEFT,"5,496.80",00.00,"1,638,160.30",d4FdDfcC7c8DA05,8466,Clifford,Hutchinson,"Ferguson, Crosby and Collins",Dicksonland,Liberia,9714393670,(513)863-4404x782,gordonjade@gilmore-dougherty.org,2021-02-16,http://hooper.biz/
20-Jan-2021,NEFT,00.00,"163,816.03","1,474,344.27",33a4dDc2287eDC0,3291,Victor,Middleton,Mosley and Sons,Louisview,Anguilla,047.136.2632x37904,0618417074,jennarodgers@farmer.com,2021-10-04,http://summers-coffey.com/
20-Jan-2021,Purchase,00.00,"163,816.03","1,310,528.24",6Ec5FDc2fD52065,8917,Clayton,Reeves,"Best, Jenkins and Dickerson",Port Tammieborough,Spain,985.171.2891,(212)378-9005,shirley09@moore.com,2021-10-23,http://www.beltran.org/
20-Jan-2021,Cash,00.00,"655,264.12","655,264.12",abF564950aaddbE,4770,Jocelyn,Buchanan,Munoz-Macias,Lake Perrymouth,Honduras,001-202-160-8632x8457,705-444-2110,byrdkim@guerrero.com,2020-04-22,https://www.lyons-baker.info/
20-Jan-2021,Bill,"24,420.40",00.00,"679,684.52",E3b1bFE8360D13D,3432,Marcus,Novak,Stark-Cox,South Larryview,Austria,944.429.9191x7196,508-360-6426,lellis@esparza.com,2022-05-29,http://rhodes.biz/
20-Jan-2021,Reversal,05.80,00.00,"679,690.32",EF0Bbad286c34Ab,4616,Kristen,Hill,Ellison PLC,Gabrielaborough,France,5591223818,739-578-4901x501,wandahaley@park-gross.com,2020-07-26,https://woodward-doyle.com/
20-Jan-2021,Miscellaneous,"2,443.00",00.00,"682,133.32",b0fd5F30cf65A2c,8491,Sandy,Beck,Ryan-Morton,South Robinside,Solomon Islands,+1-975-516-3824x6205,(550)122-8468x121,jcisneros@marquez-herring.org,2020-08-28,https://gallagher-miles.info/
20-Jan-2021,Reversal,00.00,"75,792.59","606,340.73",eEc4ceEfE930ff0,9860,Jennifer,Chaney,Rowe-Velasquez,Bradfort,Portugal,426-211-8241x0098,001-668-345-3440,shepherdxavier@franco-kane.biz,2022-01-25,https://www.davenport.com/
20-Jan-2021,Debit Card,00.00,"121,268.15","485,072.58",1DB39e7Ae3Dc555,2544,Patrick,Huffman,"Acosta, Cordova and Adkins",Devonshire,Costa Rica,(526)396-2570x655,(421)555-4713x403,jwebster@ellis.com,2020-08-30,https://www.harmon.com/
20-Jan-2021,ATM,00.00,"60,634.07","424,438.51",eEeacBeD3EeAdc3,5887,Jo,Spears,Campos Group,Jackton,Benin,(656)726-3890,285-420-4420,grichards@mason-sheppard.net,2022-03-14,http://www.murray-ballard.com/
21-Jan-2021,Purchase,00.00,"47,159.83","377,278.68",e7EEB79Becdaa19,1767,Robin,Choi,Mason Inc,West Beverlyborough,Honduras,001-751-436-5472,608.680.5837,jordanhernandez@spears.com,2020-06-16,http://christensen.org/
21-Jan-2021,RTGS,"16,981.99",00.00,"394,260.67",feABEd13C7DcEDD,93,Collin,Jackson,"Floyd, Moyer and Hodges",Damonside,Greece,(106)631-6431x8449,+1-440-944-1793x91144,carpenterkylie@chambers-frost.com,2021-02-11,http://henry.com/
21-Jan-2021,IMPS,472.00,00.00,"394,732.67",30cFbF2cdeA99EF,6292,Gabriela,Branch,"Rasmussen, Daniels and Rogers",New Gilbert,Mexico,0933663417,704-665-7790x8983,dawn45@burke.com,2021-12-08,https://boyle-browning.com/
21-Jan-2021,Commission,00.00,"39,473.27","355,259.40",64d1a85d2A3efBC,6063,Lee,Blevins,Porter-Harrison,Port Caseyburgh,Solomon Islands,497-601-4038,162-766-7794,greertricia@hendricks.com,2021-12-30,http://howe.info/
21-Jan-2021,Cash,00.00,"39,473.27","315,786.13",A74e90b1839b58B,265,Karen,Campbell,Aguilar-Bautista,New Oscar,Liberia,787-930-1013x256,205-372-8502,rachaelking@silva-choi.com,2021-07-24,https://www.turner.net/
21-Jan-2021,IMPS,00.00,"52,631.02","263,155.11",9B61aAfD6fb6594,6389,Bethany,Mayer,Cohen PLC,West Joshuamouth,Mexico,(033)422-2165x5846,(513)811-1948,jpark@luna.biz,2021-07-28,https://www.phelps.com/
21-Jan-2021,Cheque,00.00,"65,788.78","197,366.33",FB358C9e5bC0E12,2188,Jackie,Becker,"Ramos, Bryant and Goodwin",West Shane,Brazil,001-911-744-0581,001-070-356-5674x587,haguirre@cherry.com,2021-01-13,http://www.reese.com/
21-Jan-2021,Purchase,00.00,"21,929.59","175,436.74",3E4C5EE4C4faaD9,2089,Blake,Jefferson,Carey-Cabrera,Haleyfort,Reunion,976-557-3507,366.638.5594,emalone@monroe.com,2022-01-07,http://lawson-bowman.info/
21-Jan-2021,RTGS,08.00,00.00,"175,444.74",67F626A797EB79E,8211,Jonathan,Ramirez,Bautista Inc,Dudleyton,Lebanon,(945)351-5693,(726)398-3717x30453,emily41@monroe.com,2020-06-02,https://kennedy.org/
21-Jan-2021,IMPS,00.00,"21,930.59","153,514.15",E96429d2cD7164E,513,Richard,Adams,Porter-Davis,Hughesbury,Svalbard & Jan Mayen Islands,001-589-054-6902,001-927-608-3560x4883,ambermora@myers-joyce.biz,2021-05-29,http://mcclure.com/
21-Jan-2021,Miscellaneous,00.00,"15,351.42","138,162.73",F47934cb9b80133,7564,Kyle,Mills,Elliott-Becker,Port Frances,Saudi Arabia,001-831-990-2887x7156,278.878.4154x6222,stephaniebarker@franklin-horne.com,2022-05-24,http://vance.org/
22-Jan-2021,Commission,"24,686.00",00.00,"162,848.73",Fe9fDBdaDdFAeA2,6463,Jeremiah,Cardenas,"Ibarra, Mercer and Tyler",South Francismouth,Turkmenistan,140.450.4364,549-485-4985x333,victor89@strong-barber.com,2020-02-28,https://shaw.com/
22-Jan-2021,RTGS,"202,730.00",00.00,"365,578.73",1EF98D8f597a6EB,5989,Donna,Barker,"Hodges, Wang and Wiggins",Kaylabury,Cook Islands,001-702-800-8528,001-764-196-7590x926,toni89@briggs-harmon.info,2021-03-13,https://www.mayer.com/
22-Jan-2021,Reversal,00.00,"60,929.79","304,648.94",6Ab34FdcE8E5e02,2566,Brandy,Ferrell,Bishop and Sons,Janicemouth,Spain,8696057153,049.867.1095,cameron24@blanchard.info,2020-02-26,http://ford.com/
23-Jan-2021,Miscellaneous,00.00,"43,521.28","261,127.66",9DAde3E31ef84A1,5905,Tracy,Manning,Miles LLC,South Jason,Chad,257.154.4479x1851,+1-956-736-8308,mckenzie01@wiggins.com,2021-07-06,https://www.frye.com/
23-Jan-2021,NEFT,"163,073.00",00.00,"424,200.66",aEdFcA1C1E34CaD,6003,Helen,Ashley,Waller-Manning,West Dustin,Senegal,+1-667-629-5768,3046008204,gallegosolivia@pittman-gould.com,2021-03-27,http://www.nolan.com/
23-Jan-2021,Cheque,"230,372.70",00.00,"654,573.36",C21Bee1d4ff1baf,2788,Kirk,Marshall,Sims-Buckley,Blackwelltown,Zambia,(174)780-4846,280.214.6493,morgan62@krause.com,2020-01-21,http://estrada.net/
23-Jan-2021,ATM,41.00,00.00,"654,614.36",0A082ccDCB6ee2E,7727,Kerry,Holland,"Hahn, Navarro and Burns",Aliciamouth,Gabon,346-197-3482x69796,001-339-187-7180x131,jdurham@short.com,2020-02-22,http://caldwell.com/
23-Jan-2021,Reversal,"889,227.00",00.00,"1,543,841.36",0a2917dFFcCF4aF,9215,Maxwell,Ferrell,"Frey, Koch and Waters",Lawrenceside,Australia,122-011-8412,6738388819,isolis@garrison.com,2021-12-12,https://donaldson.com/
23-Jan-2021,Cash,"472,629.00",00.00,"2,016,470.36",42cAf3a641e2Aa0,3414,Lonnie,Hardin,Martinez PLC,Schroederburgh,Benin,(084)501-9810,(384)263-8987x099,crossjaclyn@benton.com,2022-02-22,http://baldwin.biz/
23-Jan-2021,Purchase,"1,744,793.00",00.00,"3,761,263.36",39C3B95bD6e0B04,503,Eileen,Holden,Shepard-Wells,Teresabury,Burundi,100-973-1145,+1-466-376-5355x08019,nichole01@clarke.com,2020-01-15,https://www.fuller.org/
23-Jan-2021,NEFT,"73,172.80",00.00,"3,834,436.16",E12Be8Ba78d8E00,9898,Erica,Waters,"Washington, Arroyo and Chaney",Fergusonland,French Polynesia,780-522-4396,565.563.2255,irwinjon@hall-dillon.net,2022-03-06,http://marsh.com/
23-Jan-2021,Miscellaneous,342.90,00.00,"3,834,779.06",7dA0735F026Fa62,5299,Reginald,Benitez,Turner LLC,Port Sandy,Sierra Leone,(707)101-0650,650-893-6599x8792,nicholasmills@davis.net,2022-04-15,http://www.morrow.org/
23-Jan-2021,Interest,"27,080.00",00.00,"3,861,859.06",AcbfEB5c35e8AE2,9657,Theodore,Ramos,Ward-Horne,North Makaylaside,Afghanistan,+1-251-874-4055x390,001-442-735-1726x242,karl75@burgess.com,2020-04-05,https://george.com/
23-Jan-2021,NEFT,00.00,"772,371.81","3,089,487.25",cEdC6f6E93Ef381,6166,Sheryl,Schneider,Casey Group,South Lonnieside,Cocos (Keeling) Islands,(999)611-7551x6916,(690)145-4591x26126,xshepard@stevenson.com,2022-04-25,http://www.fischer.org/
23-Jan-2021,Tax,"1,991.02",00.00,"3,091,478.27",d4f5CAB9d31aFbd,5727,Jaclyn,Rubio,Carlson-Hickman,West Alec,Cameroon,331.567.7816x7213,3345007581,bradley28@morrow-shannon.com,2020-04-07,https://www.kane-sosa.com/
23-Jan-2021,Cheque,00.00,"3,091,478.27",00.00,E59DbFb64DdBF1a,845,Shannon,Choi,Diaz LLC,Strongmouth,Niue,1052080206,(503)305-1945x3592,ajohnson@howard.biz,2021-01-30,https://huber-christian.biz/
23-Jan-2021,Purchase,"168,173.38",00.00,"168,173.38",1bD34DFB3Ebb9db,267,Cristina,Sanchez,Carney-Chavez,North Alexanderburgh,Cape Verde,001-627-353-0917,538-624-2296x017,matthew67@irwin-mcknight.info,2021-08-01,http://benjamin-houston.com/
23-Jan-2021,ATM,"18,121.50",00.00,"186,294.88",f0bb2a55Ad3Aa69,1389,Tara,Taylor,"Bullock, Arroyo and Kidd",East Gordon,Seychelles,(480)550-3577,128-371-7541,mckenzie40@schmitt.net,2020-07-08,http://www.choi.biz/
23-Jan-2021,Interest,00.00,"62,098.29","124,196.59",f8dddbf9CD6FF92,14,Glen,Hammond,"Schaefer, Chung and Lin",Pamelatown,Netherlands,001-887-543-3745x055,001-955-888-1987x09071,lweeks@hooper.org,2022-03-03,https://bush-huynh.org/
23-Jan-2021,Bill,00.00,"17,742.37","106,454.22",68AEaA6B9EfDE2f,4710,Ricardo,Morrow,Woodard Inc,East Max,Heard Island and McDonald Islands,789.882.5400x7795,(159)073-9653x1469,jenna90@clements-allison.biz,2021-07-23,https://quinn-davis.biz/
24-Jan-2021,NEFT,00.00,"26,613.56","79,840.67",31F579d9ACB8cEE,5283,Gavin,May,Erickson LLC,South Lonnie,Luxembourg,001-871-531-7752x721,341.126.7060,haasgrant@duncan.net,2021-06-24,https://key.info/
24-Jan-2021,Cash,00.00,00.00,"79,840.67",5DdFD314FDFe3B1,2756,Natalie,Lynn,Mercado-Sosa,Mathisview,Cote d'Ivoire,+1-547-998-7744x17972,(329)145-4006,yangvictor@munoz.com,2020-03-15,http://bell.com/
25-Jan-2021,Bill,00.00,"26,613.56","53,227.11",4e9b31EE98db96b,7829,Anna,Melton,Lowe-Hays,Franklinville,Marshall Islands,005-286-6210,001-525-368-6677,mayerkristie@castaneda.com,2022-02-28,http://www.gay.net/
25-Jan-2021,Purchase,"3,203.20",00.00,"56,430.31",faacFEEfFD78eaC,9304,Erin,Branch,"Cooke, Mccormick and Donaldson",Cannonbury,South Africa,001-124-944-1053,(154)347-2169,lameugene@freeman-mills.org,2021-05-17,https://koch.net/
25-Jan-2021,ATM,"2,231.56",00.00,"58,661.87",D64bf9154BbDFe9,2568,Jamie,Valencia,"Kim, Potts and Baker",Port Billyshire,Latvia,(453)614-8336x012,617-011-7031x4014,claytonmeghan@sparks-nelson.info,2021-04-11,https://www.morgan-spence.com/
25-Jan-2021,Cash,06.09,00.00,"58,667.96",6dFcF60cB2DA9De,643,Ebony,Gonzales,Duarte-Wong,South Virginiafurt,Spain,355-373-1819x6860,862-802-6369x8299,qbrock@patrick.biz,2021-12-23,http://www.wright-giles.com/
25-Jan-2021,Interest,00.00,"14,666.99","44,000.97",Aa31dDC99911aFE,8879,Carla,Richard,"Pratt, Cowan and Grimes",Kristinemouth,Italy,(665)813-4793x9528,+1-162-345-7801x926,guerrerokaylee@curry-briggs.com,2021-11-29,https://www.avery.com/
25-Jan-2021,RTGS,"67,267.28",00.00,"111,268.25",86B8Ab6DE9438A7,9348,Christie,Jennings,Stokes-Cross,Lake Jon,Spain,803-190-5394,117-833-5577,krystalbenjamin@levy-sandoval.org,2021-03-13,http://www.elliott-erickson.net/
25-Jan-2021,Interest,00.00,"27,817.06","83,451.19",31349F0a8a1EA7b,2500,Denise,Chen,"Hurley, Guerrero and Mullen",Klineside,Congo,(246)162-9025,966-875-0268x5836,zunigamarc@ruiz-parks.com,2020-04-13,https://nelson-gordon.info/
25-Jan-2021,Miscellaneous,"30,396.87",00.00,"113,848.06",Cb1cCdB8cc0C6CA,5460,Kaylee,Hardin,"Mosley, Johnson and Weeks",Bradyfort,Lebanon,001-729-803-3682x91674,161.996.0536,rsummers@paul.org,2020-04-12,http://peck.biz/
25-Jan-2021,Reversal,395.00,00.00,"114,243.06",daa6Bf5Bd16F8d8,8600,Claire,Brown,Henson-Buchanan,North Terrence,Aruba,575.134.6096x707,551-985-8329x43096,desireeduncan@benton.com,2022-01-04,http://www.meadows.com/
25-Jan-2021,Tax,00.00,"11,424.31","102,818.75",8744bE6af573DfE,1057,Summer,Parker,"Ruiz, Underwood and Guerra",Xavierland,Guatemala,(927)415-6001,+1-610-646-1606x4610,arielhuynh@townsend.com,2022-01-04,https://warren-reed.com/
25-Jan-2021,Reversal,"23,861.36",00.00,"126,680.11",d5BbcEE7E4da8ae,7343,Cheryl,Meza,Thomas-Perry,East Feliciaview,Guadeloupe,(971)398-3742,(918)085-6470x6678,alexamiddleton@golden.org,2020-07-24,https://weiss.info/
25-Jan-2021,ATM,271.00,00.00,"126,951.11",27AAC601f7DCD4F,9562,Henry,Chavez,Daniels-Potts,Moodyhaven,Nicaragua,(295)988-6474x070,+1-108-622-5179x454,boyertina@waller.info,2020-08-26,https://www.pacheco.net/
25-Jan-2021,Miscellaneous,00.00,"18,135.87","108,815.24",Aebc40cce20eAF8,8947,Peggy,Cervantes,"Mata, Bradshaw and Bender",Lake Justin,Oman,+1-206-690-3667x8103,001-008-209-8639x68350,mcgeelaura@ellison.com,2020-10-10,http://mosley.info/
25-Jan-2021,Tax,202.00,00.00,"109,017.24",6E201EF8FC26Edd,6047,Haley,Cole,Blanchard-Potts,Jeremiahmouth,Zambia,001-703-210-2314x9326,001-217-482-9123x88170,dwallace@cummings.org,2021-08-05,https://beasley.com/
25-Jan-2021,Transfer,00.00,"36,339.08","72,678.16",B6Ef430Fdd87Cb4,7823,Mercedes,Thompson,Underwood-Gaines,Derekchester,Dominica,(235)129-6652,2938767088,ymelendez@mcgee.biz,2021-02-07,http://www.kelley.info/
25-Jan-2021,Tax,"234,631.72",00.00,"307,309.88",5F19aB608503Df3,1456,Amanda,Gould,Nolan Inc,Holdenhaven,Puerto Rico,525.655.4697,7000133727,eileenstewart@mercer.com,2020-09-02,http://www.baird-henderson.com/
25-Jan-2021,Miscellaneous,"71,696.00",00.00,"379,005.88",E49AE51D8b29fEA,6812,Brenda,Weber,Bright Ltd,East Traci,Saint Pierre and Miquelon,001-035-461-3753x26106,(071)764-5576x254,rle@cannon.biz,2022-01-08,http://sharp-morales.com/
25-Jan-2021,Miscellaneous,00.00,"379,005.88",00.00,D0DcEd7DeeE5af1,9726,Melody,Castaneda,Cherry LLC,Geraldtown,Netherlands Antilles,075-195-2246,977-615-5473x11707,smorris@cline.com,2021-11-24,https://bridges-smith.com/
25-Jan-2021,Cheque,961.00,00.00,961.00,cfee3dE4d8F5914,632,Sheri,Gilmore,Blackwell and Sons,South Aaron,Saudi Arabia,877.066.7793x045,622.292.3489x1384,robinhopkins@farmer.org,2020-06-30,https://www.wells.com/
25-Jan-2021,Debit Card,93.61,00.00,"1,054.61",B2a7DA0bF0277c5,3055,Colin,Mckee,"Brennan, Navarro and Mcintyre",Lake Kristineville,Bosnia and Herzegovina,(156)465-6546,429.232.9532,fredharrington@archer-hicks.com,2020-12-27,https://shaffer-garrison.net/
25-Jan-2021,ATM,37.20,00.00,"1,091.81",a3713dFDDF55AbA,3483,Raymond,Foley,"Hess, Everett and Carr",East Ariel,Cayman Islands,2815492150,471.872.9985x341,jocelyn64@eaton.org,2021-06-29,http://www.baird.org/
25-Jan-2021,NEFT,12.31,00.00,"1,104.12",b9f56Efa955e49E,4903,Christopher,Foley,Herring-Copeland,East Alisonland,Czech Republic,182.454.8285,(264)912-5955x6203,bettywilcox@kramer.org,2021-01-27,http://curtis.net/
25-Jan-2021,IMPS,00.00,157.73,946.39,Ad3ae4Bf9557B6d,4682,Christopher,Molina,Pruitt Inc,Moraleston,Heard Island and McDonald Islands,001-851-342-0752x645,001-044-121-8414x348,lclark@hensley.biz,2020-07-27,https://clark.com/
25-Jan-2021,Bill,07.00,00.00,953.39,D36DEE5D1Bcb9ae,5268,Perry,Bentley,Forbes-Pollard,Carlland,Equatorial Guinea,+1-516-165-6317x0239,291.510.2537x7923,qwarner@gill.info,2021-06-02,http://coleman.biz/
25-Jan-2021,ATM,"1,600,794.00",00.00,"1,601,747.39",2E6d2cAB099f6fa,540,Darlene,Valdez,Fowler LLC,North Belindaborough,Aruba,531-069-9570x038,(805)677-0408,kbutler@mosley.biz,2022-04-08,https://www.booth.biz/
25-Jan-2021,NEFT,00.00,"160,174.74","1,441,572.65",5b0b116e0976700,601,Kathleen,Middleton,Mcdaniel and Sons,Derrickshire,Brunei Darussalam,(797)881-0287,988.927.5270,danielwyatt@shannon.info,2021-01-01,https://herrera.com/
25-Jan-2021,Interest,183.00,00.00,"1,441,755.65",EfCc34C16E7DBEB,9440,Kurt,Acosta,"Osborn, Crane and Riley",North Dean,Micronesia,941-656-7452x9187,012-330-1018,masonlogan@holmes.com,2020-12-03,http://callahan.info/
25-Jan-2021,Tax,"77,518.80",00.00,"1,519,274.45",AA4549c3Ba58Aa1,4314,Shane,Francis,"Valentine, Peterson and Costa",West Allisonton,Colombia,001-008-596-7689x5580,694-198-3626,basshenry@brandt.com,2020-02-08,http://kline.info/
25-Jan-2021,Interest,05.59,00.00,"1,519,280.04",74962aB79cCeb5F,2101,Julie,Russell,"Paul, Melendez and Ritter",East Chloe,Ireland,001-673-692-5097x58951,1969950864,robin82@burnett-ware.org,2020-07-27,https://www.shelton-contreras.com/
25-Jan-2021,Commission,02.50,00.00,"1,519,282.54",1eb9a595dea4aEA,6793,Damon,Galvan,Huber Ltd,Archerborough,Netherlands Antilles,851-076-5096x37877,001-564-547-9113x7592,darrenlewis@santiago.com,2021-04-02,https://www.benitez.net/
25-Jan-2021,NEFT,"156,842.00",00.00,"1,676,124.54",823CF2d5B6f8a82,6722,Alexander,George,"Alvarez, Hardy and Boyle",North Dalemouth,Congo,(580)576-4772x65826,3811161676,marissa50@howell.info,2021-11-02,https://greer.info/
25-Jan-2021,Miscellaneous,00.00,"1,676,124.54",00.00,8dfb8d863fd843E,8833,Spencer,Hess,"Crane, Wilcox and Murillo",Youngfort,Nicaragua,001-101-057-1889,001-197-703-3665x07035,manuel10@gordon.org,2020-10-24,http://woods-hernandez.com/
25-Jan-2021,Bill,241.50,00.00,241.50,364cEF4d6ac96dD,7422,Tonya,Greer,"Gilmore, Berg and Parrish",Cristinaland,Yemen,048.835.2415,974.654.5239x2142,braunholly@sherman-santiago.com,2022-03-26,http://shepard.net/
25-Jan-2021,Tax,03.54,00.00,245.04,a9A1D703Fec0F35,9109,Donna,Woodward,Bradley-Ponce,Coxbury,Svalbard & Jan Mayen Islands,001-580-548-8845x342,050-899-0590x214,phurley@madden.com,2020-04-11,https://www.pratt.biz/
25-Jan-2021,Reversal,05.11,00.00,250.15,7D0cE91963E42Ec,2284,Misty,Barrera,Mcneil Ltd,Carterfort,Bosnia and Herzegovina,362-807-9323,(162)690-0327,duane54@klein-savage.org,2022-04-12,http://www.wyatt.com/
25-Jan-2021,Interest,"2,835.00",00.00,"3,085.15",f5E359A51AF6848,5700,Tiffany,Knapp,Stokes-Wu,Port Jeffreytown,Estonia,(853)182-6190x70008,511.917.3005x32663,rutharroyo@spears-lloyd.com,2022-03-12,http://ross-foley.com/
25-Jan-2021,Miscellaneous,"28,460.70",00.00,"31,545.85",368aB1fdA3d02dd,5760,Kathryn,Bonilla,Bray-Cline,Port Susanside,Netherlands Antilles,101.681.5669x98634,001-244-699-1422x3382,plopez@noble.com,2021-10-31,https://villegas.com/
25-Jan-2021,Miscellaneous,"2,337.00",00.00,"33,882.85",a0A3E6e4DccD4C8,7129,Connie,Blankenship,"Holder, Ford and Wallace",North Malik,Fiji,008.483.8471,063.731.4949,reesejoy@barry.net,2020-08-07,http://stone-cortez.info/
25-Jan-2021,RTGS,11.40,00.00,"33,894.25",bDE2bCbf0c37c5a,9489,Tricia,Knapp,Miranda Ltd,Bradleyshire,Uzbekistan,579-705-5839x58286,(040)375-9814,xalvarez@carr.com,2021-06-07,http://www.beck-molina.biz/
25-Jan-2021,NEFT,00.00,"3,389.43","30,504.82",206BC3d36E2D937,3583,Jill,Church,Jenkins-Houston,South Tashaberg,Bangladesh,210.205.3360x4079,2903797817,lucasrichard@chandler-cross.com,2021-01-26,https://www.bradley-hodge.info/
25-Jan-2021,Cheque,00.00,"3,389.42","27,115.40",e3d2bDBAD208dD0,1865,Christy,Lutz,Walker Inc,New Hunterstad,Japan,2019250766,(951)793-2121,tomterry@gilbert-livingston.biz,2021-07-10,https://www.jimenez.info/
25-Jan-2021,RTGS,"31,016.30",00.00,"58,131.70",45a59B5B8B9c389,4424,Mason,Bates,"Cannon, Cantu and Farrell",Lake Rachaelville,Botswana,495.443.9027,+1-317-489-6546x855,omoses@lindsey.com,2022-04-07,https://cruz.com/
25-Jan-2021,Reversal,00.00,"6,459.08","51,672.62",DEDfbE19b3BABC2,7812,Samuel,Salinas,"Dyer, Rodgers and Mathis",Pattonhaven,United States Minor Outlying Islands,004.215.7392,714-386-1025,marco20@galloway-rose.com,2021-12-21,http://wilson-ramirez.net/
25-Jan-2021,Purchase,03.60,00.00,"51,676.22",6Fecdbe3D32D557,680,Kylie,Sellers,Frost-Moreno,East Anna,Sierra Leone,0807147436,561.188.4914x29747,mcfarlandbilly@ford.biz,2021-11-09,http://mendez.info/
25-Jan-2021,Purchase,00.00,"25,838.11","25,838.11",dDB35CFf9bEF1aB,4605,Ethan,Pena,"Blanchard, Cross and Klein",Lake Kentton,Zambia,+1-012-411-3656x93059,001-871-207-5402x880,xcallahan@thomas.com,2020-07-31,http://richard.com/
25-Jan-2021,Bill,"2,760.05",00.00,"28,598.16",FdD7aa9c3c9a447,5027,Kylie,Bender,Colon-Schmidt,New Franciscoport,United States Virgin Islands,603-069-7960,689.225.4123x0611,warearthur@tanner-eaton.com,2020-03-29,https://valencia.biz/
25-Jan-2021,Miscellaneous,00.00,"3,177.57","25,420.59",BD54bAb8092a043,2779,Beth,Schmidt,Reynolds-Chase,Austinberg,Vanuatu,924-010-9732x93574,775.476.3705,frances15@frank.biz,2022-05-27,https://gilmore.com/
25-Jan-2021,Cash,00.00,"12,710.30","12,710.30",DC855B1B9adEdDB,9439,Tom,Mckinney,Gonzalez-Hurst,Frankstad,Sierra Leone,001-519-260-0263x6815,+1-142-551-2721x960,moodydrew@drake.com,2021-06-20,https://levy-donaldson.net/
25-Jan-2021,Miscellaneous,"2,933.00",00.00,"15,643.30",B5A6901bBcC4eE0,3397,Dawn,Winters,Skinner-Kennedy,Richmondborough,Guadeloupe,651.065.2300x4329,2823377057,grantjoshua@james.net,2021-02-13,https://bautista.com/
26-Jan-2021,IMPS,00.00,"1,564.33","14,078.97",67BaEcFa13Adf5C,7832,Veronica,Kim,"Gates, Ingram and Scott",South George,Singapore,805-904-3661x36477,7762684396,roy03@kemp.biz,2021-10-05,https://hardin-kaufman.com/
27-Jan-2021,IMPS,06.00,00.00,"14,084.97",eDACCb9ecaA5E73,3383,Stefanie,Castillo,Owens Group,Hardingfort,Norway,232.529.8173,949.536.7015,eyork@velez-valentine.info,2020-11-05,http://shannon-summers.com/
27-Jan-2021,Cash,"231,289.10",00.00,"245,374.07",90292E2d00E5f6e,6464,Dave,Kirk,"Stevens, Taylor and Dorsey",Castrotown,Korea,(392)017-7098x044,(128)782-9113,grant32@taylor.com,2021-10-22,https://heath.com/
27-Jan-2021,IMPS,00.00,"245,374.07",00.00,c25C9c8F6FeCBa4,378,Sydney,Edwards,Hines LLC,New Emma,Denmark,(944)427-1207,050.915.6610x8821,flemingvernon@bean-le.com,2020-04-03,https://www.gibson.com/
27-Jan-2021,Transfer,"127,232.00",00.00,"127,232.00",CAbcF4c6fE2cEf2,5280,Richard,Schultz,Lynch LLC,Josephmouth,Nepal,219-477-1573,984-327-2891x97174,lisamurray@dickson.com,2020-08-24,https://www.gutierrez.biz/
27-Jan-2021,Miscellaneous,00.00,"42,410.67","84,821.33",6F9aCA7a4F014D1,2142,Kiara,Gentry,Grant-Barrera,East Kyle,Guernsey,+1-218-401-4412x281,+1-046-449-9589x1762,jordannavarro@moses.com,2020-06-25,https://www.henry-clements.biz/
27-Jan-2021,ATM,00.00,"10,602.67","74,218.66",2eDB4b0d4dBD54a,2798,Christie,Stark,Singh-Nash,South Toddtown,Israel,954.230.3622x262,(893)049-5122x832,ekerr@burch.net,2020-10-28,https://www.mckay.com/
27-Jan-2021,Interest,00.00,"7,421.87","66,796.79",A92054Cd8b9D34e,6879,Samuel,Mccormick,"Reed, Phelps and Gray",Claytonland,Thailand,+1-794-566-3044x91163,749-385-2991x87686,bonnie24@perkins.com,2020-05-24,http://www.caldwell.org/
27-Jan-2021,Miscellaneous,"5,447.50",00.00,"72,244.29",17ef9E711F27a76,534,Terri,Fleming,"Bridges, Wiley and Rush",New Stacyborough,Guinea,(115)555-6807,(779)966-7094x1928,loganschneider@blake.info,2022-02-25,http://mcpherson-henry.com/
27-Jan-2021,ATM,00.00,"10,320.61","61,923.68",eabdaE7F6D21A0B,9201,Janice,Dennis,Delacruz-Rivera,Coryfurt,Chile,+1-186-859-1157,722.423.7168,oscarwalls@luna.info,2020-11-14,https://cuevas.info/
28-Jan-2021,Miscellaneous,00.00,"10,320.61","51,603.07",A5F38CfE6bff7d6,9766,Patrick,Reeves,Shaw Inc,Schultzfort,Belarus,623-086-5838x2370,083-297-3547,jackson81@waters-arroyo.org,2020-04-05,https://schaefer-howell.info/
28-Jan-2021,Purchase,00.00,"5,160.31","46,442.76",0F6D71A8f66f4B8,6198,Hector,Mccarthy,"Ortiz, Silva and Wilson",South Tanyaborough,Jamaica,349.236.9677x583,001-288-501-4553x387,beasleyvalerie@bond-barry.net,2020-03-30,https://www.fernandez.com/
28-Jan-2021,Bill,25.00,00.00,"46,467.76",af52bdca6D4C2a1,7667,Caitlyn,Cordova,"Marsh, Mullen and Garner",Port Jackie,Djibouti,(183)870-5120x262,243-601-1311x06719,gfrederick@bray.net,2021-10-24,http://www.rogers.com/
28-Jan-2021,Reversal,00.00,"15,489.25","30,978.51",2eC63FaDdFaF7dd,5926,Erin,Murillo,Leblanc-Morales,Lake Julian,Namibia,001-546-513-0586x9465,155-853-3438x003,amanda21@hayes.com,2021-02-28,https://www.duran.org/
28-Jan-2021,Transfer,00.00,"3,872.31","27,106.20",77aFB79505b1778,7562,Vernon,Wade,Randall-Bass,Scottview,Burkina Faso,178.990.0899x26708,533.119.7069x2991,sallymatthews@stanley.net,2021-06-11,http://brandt-calhoun.net/
28-Jan-2021,NEFT,54.40,00.00,"27,160.60",33605b4e2b35cce,2025,Logan,Hickman,Richards PLC,Birdport,Cote d'Ivoire,001-646-749-4465x276,001-602-583-8863,danahorn@sellers.com,2021-07-16,https://www.burgess-koch.biz/
28-Jan-2021,RTGS,00.00,"3,880.09","23,280.51",17eE17eDEBDADac,4234,Perry,Armstrong,Moss Ltd,South Felicia,Norway,(307)657-3746x9076,001-358-599-3819x32948,garrettmiguel@schroeder-moon.org,2021-04-09,https://www.tapia.com/
28-Jan-2021,RTGS,00.00,"2,328.05","20,952.46",D1eEBbC634F832B,8041,Veronica,Bates,Miller Ltd,East Coleberg,Jersey,+1-136-469-1476x88686,486.459.4438,hunterabigail@singh.com,2021-08-19,http://pineda.com/
28-Jan-2021,Debit Card,00.00,"5,238.12","15,714.34",f575ca97eaB6e8C,835,Latoya,Floyd,Buchanan-Cervantes,South Brittney,Libyan Arab Jamahiriya,(892)350-5679,472.477.3220x1735,apotts@dalton-reese.com,2020-09-09,https://pollard.com/
28-Jan-2021,Tax,00.00,"1,571.43","14,142.91",F23021d6ddDE8c7,7614,Joseph,Mckenzie,Little-Fernandez,North Candacebury,American Samoa,001-908-443-9554x08377,(531)378-1692x721,brockjoanne@merritt-gamble.biz,2021-09-14,https://www.reese.com/
28-Jan-2021,Debit Card,"63,306.20",00.00,"77,449.11",7F23F7acC9700EC,3061,Lorraine,Herman,"Berger, Barton and Huffman",New Michaela,Sudan,001-301-655-3175,533.040.0548x08673,hooverbenjamin@parker.net,2021-01-21,http://velez-shields.biz/
28-Jan-2021,Purchase,"26,467.50",00.00,"103,916.61",F8a905EbEE8cFCf,8848,Adam,Spears,Yu-Hahn,East Stephenstad,Comoros,9313302703,319.667.5392x145,luke67@garrett.com,2022-04-03,https://www.ball-sosa.org/
28-Jan-2021,IMPS,00.00,"12,989.58","90,927.03",6aa7821BffF805c,1487,Corey,Harmon,Jarvis Ltd,Penashire,Guernsey,+1-744-114-2159,262-017-3871,barberanthony@wu-strong.biz,2021-11-16,http://hooper-pratt.info/
28-Jan-2021,Purchase,00.00,"10,103.00","80,824.03",7AaD01F2EF77C4a,9210,Bryce,Arnold,Michael Group,Thomaston,Iraq,(432)977-9198x0731,(564)071-6631x21671,perezangela@reynolds-wells.com,2021-06-10,https://www.fischer-summers.com/
28-Jan-2021,ATM,"21,774.70",00.00,"102,598.73",8ac02a294D99bBB,1980,Kristina,Hensley,"Jacobson, Webb and Snyder",Billland,Senegal,933-631-6414x06702,(397)771-1728x130,shawnchung@porter.com,2020-04-12,http://www.jennings.info/
28-Jan-2021,Purchase,00.00,"10,259.87","92,338.86",aECffDA839FdbcE,7607,Martha,Underwood,"Nichols, Bailey and Whitehead",Lake Summer,Guam,(795)502-5949x33310,640.800.7029x2864,ramirezmadison@logan.com,2021-06-24,https://www.kelley.com/
28-Jan-2021,Cheque,00.00,"30,779.62","61,559.24",beC6fF6CCAADd1a,1444,Greg,Mahoney,Lambert-Lara,Lake Manuel,Bolivia,000-076-5119,649.120.5116x8471,ghartman@beck.biz,2020-03-04,https://www.fields-erickson.biz/
28-Jan-2021,NEFT,00.00,"6,155.92","55,403.32",12A0ffbCfC9D54A,6092,Christine,Chen,Newton-Dennis,Morenoborough,Dominican Republic,001-591-482-3212x08020,001-875-757-2991x624,guerreronina@diaz.com,2020-08-03,http://barrera.info/
28-Jan-2021,RTGS,00.00,"18,467.77","36,935.55",4d9c154a6FBB4d9,2249,Trevor,Dixon,Ayers Ltd,North Belinda,Macao,+1-020-795-7200,495.044.8546,rileydave@johns.info,2021-12-15,https://www.tanner.org/
28-Jan-2021,Reversal,00.00,"18,467.78","18,467.78",Cb1adf8F4D77aDf,5407,Teresa,Sparks,Gray-Walls,West Aaron,Sierra Leone,868-979-0906x68940,(711)497-8794x665,zshepard@french.com,2020-11-09,http://bender-tapia.com/
28-Jan-2021,Miscellaneous,04.00,00.00,"18,471.78",cD736A72562bd00,3540,Norma,Reynolds,Mcdowell-Hurst,Arthurberg,Ireland,4084016763,+1-007-802-1423x9088,hsavage@frank.info,2020-07-05,https://www.vasquez-schultz.com/
28-Jan-2021,Miscellaneous,"1,506,099.50",00.00,"1,524,571.28",3fa9C24b27FebF1,1348,Logan,York,Cooper Ltd,Hancocktown,Guam,001-040-169-1991x756,+1-675-471-1235x49725,gmalone@meyer.biz,2020-09-13,https://mayo.com/
28-Jan-2021,Tax,"23,057.00",00.00,"1,547,628.28",DE5cD8ABBcaAeFa,7225,Jose,Little,"Madden, Frazier and Stone",Bryantburgh,Colombia,322.017.3409x61066,068.390.8202,michaelamoyer@duran.info,2020-06-24,https://www.shaw.info/
28-Jan-2021,Miscellaneous,00.00,"257,938.05","1,289,690.23",8FBbaF601F4EDbE,2635,Rachel,Yates,Short-Kim,Jeromefort,Bangladesh,(774)021-4092x105,(977)929-3235,vcurtis@rollins-dodson.com,2020-10-28,https://www.wilkins-brown.net/
28-Jan-2021,Debit Card,"178,364.09",00.00,"1,468,054.32",C4EbFcdc2ca405d,7784,Shelby,Martin,Rhodes Inc,Gainesberg,Cote d'Ivoire,+1-290-098-9706x9990,+1-357-341-5510,tvalencia@day-patel.com,2021-10-15,http://graham.com/
28-Jan-2021,IMPS,00.00,"367,013.58","1,101,040.74",ef8cdF16d1BcFC9,1990,Kurt,Swanson,Peck and Sons,Danielleberg,Yemen,899.658.7720x3122,(071)270-3123x72659,mariebartlett@mahoney-houston.com,2021-11-13,http://www.spence.com/
28-Jan-2021,Reversal,00.00,"367,013.58","734,027.16",FaD7BcB59a69F04,5344,Cole,Mcdowell,Martinez-Casey,Dillonview,Reunion,091.366.5461,+1-173-411-6745,drewknight@mckenzie.net,2021-06-01,https://silva-gates.com/
28-Jan-2021,ATM,"418,952.00",00.00,"1,152,979.16",d3fbBBAe6860b18,3274,Melvin,Schmidt,Bryan and Sons,Coltonborough,Denmark,+1-866-622-3921x0904,(297)349-1824,marc31@shaw-campbell.com,2021-07-27,http://www.richards.com/
28-Jan-2021,Reversal,"2,968.98",00.00,"1,155,948.14",A335cB00aDecAEA,5461,Patrick,Flynn,"Dickerson, Mahoney and Rocha",North Evelyn,Mali,+1-281-158-0010,193-803-1603x747,shaunadams@brewer.biz,2021-10-13,http://www.barajas.com/
28-Jan-2021,Miscellaneous,00.00,"231,189.63","924,758.51",C8e8DD1dBD1Cc1B,2155,Denise,Frazier,"Fitzpatrick, Bernard and King",Jordantown,Mozambique,+1-140-340-3998,671.223.8591,epratt@weaver-malone.com,2021-06-09,http://www.swanson-ballard.com/
28-Jan-2021,Commission,00.00,"154,126.42","770,632.09",B67f0bC593dE9e4,2215,Cassidy,Rush,Marks Group,South Jacob,Saint Barthelemy,567-513-3075,+1-456-266-7485x845,dennis88@francis.com,2020-04-25,http://mcneil.com/
28-Jan-2021,Tax,00.00,"385,316.05","385,316.04",Dd50fC3eF4F73bC,1083,Alexandra,Alvarado,Cuevas-Suarez,South Mikayla,Greece,435-568-6966,916-200-3617x82583,sosalance@huynh.info,2021-03-26,https://www.jimenez-fernandez.net/
28-Jan-2021,Miscellaneous,09.00,00.00,"385,325.04",b0BAD45C54EdAaC,3533,Kerri,Livingston,"Gould, Brooks and Randall",Lake Raymouth,Taiwan,001-615-265-5364x839,746.669.5758,barrymanning@estrada.info,2020-10-13,https://levine.com/
28-Jan-2021,Miscellaneous,00.00,"42,813.89","342,511.15",2a6144B02fD198f,2906,Julia,Myers,"Cherry, Jennings and Edwards",Lawrenceton,Pitcairn Islands,+1-947-512-5946,(824)806-2949,cassandra42@guerra.com,2021-05-23,https://baker.com/
28-Jan-2021,Interest,"14,835.90",00.00,"357,347.05",feeDB184c9bebEe,6459,Jasmin,Townsend,Rocha-Fleming,Terrychester,Mali,900.798.5869x3194,752.240.5614,patrickwall@shea.com,2021-08-30,http://luna.com/
28-Jan-2021,Reversal,02.00,00.00,"357,349.05",695e114bcfE0Bf0,4231,Meredith,Fisher,Maynard PLC,Earlton,Kyrgyz Republic,091-207-9090x35358,(228)679-6935,ehorton@marshall-crawford.org,2020-08-11,http://friedman.com/
28-Jan-2021,NEFT,418.00,00.00,"357,767.05",da367db0fFAcfBd,8109,Ernest,Mccarty,Vazquez PLC,Port Brookeview,Cook Islands,+1-071-993-0245x91839,186.353.5573x2111,chelseylloyd@anderson-beltran.info,2020-08-16,http://www.valentine-proctor.net/
28-Jan-2021,IMPS,00.00,"178,883.53","178,883.52",fEbD9DF696e83E4,2331,Russell,Benitez,Rodgers-Gilbert,Hendersonmouth,Macao,741.664.5984x79479,+1-049-168-4965x79444,lcarson@schmitt.biz,2020-07-31,http://booth.org/
28-Jan-2021,Bill,699.00,00.00,"179,582.52",F899c0eB5F9f113,3875,Nicole,Levine,Odonnell Group,Cherylmouth,Gibraltar,799.729.8394x2456,(448)522-5524x20937,tomreynolds@pope.com,2021-11-12,http://www.arias.com/
28-Jan-2021,Interest,00.00,"59,860.84","119,721.68",4E7Be70DAB6Ffd0,5262,Kelsey,Alexander,"Sparks, Anderson and Moss",New Mariahview,Panama,(666)582-3953x01200,645.813.6338x37353,cameronregina@velazquez.com,2020-03-20,http://www.black.com/
28-Jan-2021,Cash,00.00,"23,944.34","95,777.34",9Fe9AAdaAcF7Bba,9179,Bill,Livingston,Cunningham-Weeks,Proctorview,Belize,6890621136,(383)537-2742x2127,tylergutierrez@blair.info,2022-05-19,https://schroeder.com/
28-Jan-2021,Bill,"8,991.41",00.00,"104,768.75",BBd5BD40bfCF7B6,3101,Charlotte,Velasquez,"Ritter, Osborn and Mcgee",Mooneyhaven,Nepal,001-966-976-9904x03544,0514788290,dianawarner@roberson.com,2020-05-26,https://day.com/
28-Jan-2021,Commission,00.00,"26,192.19","78,576.56",5ee4c65a392e6C3,3227,Devon,Estes,"Copeland, Zimmerman and Ramsey",Timstad,Liechtenstein,063-552-3683x133,(832)090-2093,waltergardner@lawrence.biz,2021-11-20,https://holmes-maynard.info/
28-Jan-2021,Tax,00.00,"8,730.73","69,845.83",ABCFefFaDAc5F2C,1297,Judith,Abbott,Potter-Haney,Lake Evanberg,San Marino,(803)522-0695,8758726874,alyssajuarez@villanueva.com,2020-04-14,https://gates.com/
28-Jan-2021,Commission,00.00,"34,922.92","34,922.92",3deF6B4Db3908f2,8005,Penny,Hayden,"Wallace, Brown and Norton",North Franklintown,Northern Mariana Islands,402-309-7946x4651,994-869-2910x111,sergiojames@christensen-cohen.com,2020-09-17,http://www.burnett-murphy.com/
28-Jan-2021,ATM,235.50,00.00,"35,158.42",30Ffff3C9Cdea0d,8708,Jaime,Allison,Winters-Bruce,Port Karinaburgh,Palestinian Territory,874.570.1802x2775,001-772-960-1204x673,haley47@petty.com,2021-09-16,http://atkins.com/
28-Jan-2021,RTGS,00.00,"3,906.49","31,251.93",6dD1659A6CDC3F7,1340,Joyce,Robles,Lane PLC,Silvaport,Iran,001-268-180-7682x2159,001-939-453-4769,rittermeagan@beasley.com,2021-12-19,http://www.salazar.net/
28-Jan-2021,Purchase,05.30,00.00,"31,257.23",D64bf9154BbDFe9,2568,Jamie,Valencia,"Kim, Potts and Baker",Port Billyshire,Latvia,(453)614-8336x012,617-011-7031x4014,claytonmeghan@sparks-nelson.info,2021-04-11,https://www.morgan-spence.com/
28-Jan-2021,Tax,00.00,"3,907.15","27,350.08",21F4586e5aEBA7E,709,Jasmine,Lutz,Boyd Group,Huberville,Haiti,+1-124-988-9229x4595,(163)520-0326,kevin30@ferguson.com,2022-04-15,https://www.archer-fuller.com/
28-Jan-2021,Miscellaneous,"21,730.76",00.00,"49,080.84",6D9bF63d3DA044d,2237,Patrick,Phillips,West-Cohen,Cohenbury,Bahrain,258.775.2611,984-029-4948x6766,houstonnathaniel@deleon.org,2020-11-28,https://www.hubbard.com/
28-Jan-2021,Cheque,00.00,"4,908.08","44,172.76",082Ee9dc4F8a2C3,9046,Jenny,Nichols,Wood Group,West Emilyburgh,Tunisia,3064300351,0584183756,vfranco@wade.com,2021-12-17,https://www.trujillo-huang.com/
28-Jan-2021,Bill,00.00,"44,172.76",00.00,feABEd13C7DcEDD,93,Collin,Jackson,"Floyd, Moyer and Hodges",Damonside,Greece,(106)631-6431x8449,+1-440-944-1793x91144,carpenterkylie@chambers-frost.com,2021-02-11,http://henry.com/
28-Jan-2021,Debit Card,03.78,00.00,03.78,d2c342dc4F3cFbD,6544,John,Eaton,"Sexton, Goodman and Lam",Port Biancaborough,Iraq,6225817789,825.926.4035x52998,odonnellselena@meadows.com,2021-09-12,http://potts.com/
28-Jan-2021,Commission,00.00,00.00,03.78,da3ADA2cbcEA54F,138,Lorraine,Bradshaw,"Contreras, Pollard and Moore",Blevinsmouth,Cape Verde,001-382-620-0918x061,608-409-4320,weaverclinton@zamora.org,2021-12-25,https://www.walton.biz/
28-Jan-2021,Reversal,01.00,00.00,04.78,76dFD2f4DA0F9Fa,9488,Catherine,Combs,Benton Group,South Colleenside,Tonga,001-040-439-5657x8777,+1-165-803-3749x842,skerr@beard.com,2020-12-24,https://www.rice-weiss.biz/
28-Jan-2021,Tax,"105,139.00",00.00,"105,143.78",8c1BeeD30991021,8420,Franklin,Schneider,Hopkins Ltd,East Adrienneside,Afghanistan,899.981.6473x857,+1-824-388-5245,katherinejennings@mckay.net,2022-02-26,http://dorsey-burgess.biz/
28-Jan-2021,Cheque,00.00,"26,285.95","78,857.83",Ee009e805Fdcaa2,6321,Amber,Graves,Rodriguez-Potter,East Pamela,Tokelau,1113000633,(421)741-5351,grogers@livingston.com,2021-06-12,http://www.gilmore.biz/
28-Jan-2021,Miscellaneous,00.00,"15,771.57","63,086.26",2F924F17beFeCcC,1663,Leroy,Mann,Waters PLC,Dannybury,Northern Mariana Islands,478-845-4768,001-209-798-6403x18190,zbowers@cameron.com,2020-12-31,http://arellano.biz/
29-Jan-2021,Bill,00.00,"15,771.57","47,314.70",71CCfa7A194225B,8246,Bonnie,Simpson,"Santana, Hooper and Bishop",Stevenstad,Nicaragua,+1-674-289-0550x55908,001-607-462-6040x67039,ochoacolleen@conner-fuentes.biz,2020-06-14,https://ochoa.org/
29-Jan-2021,Reversal,200.34,00.00,"47,515.04",a603dDF849BfAAE,4706,Shelly,Hudson,Chandler-Sampson,Jonton,Iceland,234.323.2198,1009613504,mullenamanda@kennedy-navarro.info,2022-02-23,http://shannon.com/
29-Jan-2021,IMPS,00.00,"6,787.86","40,727.18",fF7218cD464708E,3225,Gregory,Mendez,Espinoza-Bell,Lake Kevinmouth,Bermuda,(080)272-8356x45014,(703)589-9420x84298,crystal46@farrell-lam.org,2020-06-10,https://www.steele.com/
29-Jan-2021,Tax,00.00,"4,525.24","36,201.94",ebc09AA8FA8FaB0,1381,Bianca,Lawson,"Owens, Bernard and Day",Marilynland,Saint Barthelemy,+1-354-626-7409x047,001-058-396-4956x817,calvinmata@richard-greene.com,2020-07-29,https://galloway.net/
29-Jan-2021,Tax,00.00,"4,525.24","31,676.70",F8775a0B1d3504E,2564,Carrie,Mcgrath,Garner-Dunlap,Lake Ana,Brazil,386-657-5617x38751,001-059-021-2523x607,marshearl@santiago-sosa.com,2020-04-13,https://www.reyes.com/
29-Jan-2021,Miscellaneous,00.00,"3,959.59","27,717.11",D4ecdFDd409C26B,6001,Dalton,Hubbard,Chavez Inc,North Warren,Cayman Islands,(509)555-2020,+1-010-857-0494x973,wongkurt@velez.org,2020-03-29,https://www.stephenson-sawyer.net/
29-Jan-2021,IMPS,00.00,"3,464.64","24,252.47",5aB555b1DBCdfA4,7131,Mike,Lambert,"Vasquez, Rodgers and Carrillo",Ortizberg,Slovakia (Slovak Republic),001-691-165-9065,+1-201-463-3781x457,austinbautista@hickman-garner.com,2020-11-24,http://sellers-yu.com/
29-Jan-2021,Tax,"30,908.00",00.00,"55,160.47",2BC658cB6F0bad7,8469,Richard,Ford,Grant Ltd,South Miranda,Sao Tome and Principe,190-501-1172x868,236.052.9385x020,robersonhelen@campbell-zhang.biz,2020-07-04,https://www.huber-page.info/
29-Jan-2021,Miscellaneous,00.00,"5,516.05","49,644.42",D00c223EA1F72D1,6906,Summer,Schroeder,"Hebert, Curry and Figueroa",Brandonview,Saint Vincent and the Grenadines,+1-759-893-9156x6299,(463)311-4013x02990,rowejulia@simmons.info,2020-11-13,https://ritter.com/
29-Jan-2021,Miscellaneous,05.59,00.00,"49,650.01",8ecf11cd4BddE0B,9386,Kerry,Christian,"Lopez, Flores and Duke",West Harry,Bermuda,001-301-886-9053x86784,3521911402,bridgetwagner@snow.com,2021-09-24,http://bradshaw-todd.net/
29-Jan-2021,Bill,24.53,00.00,"49,674.54",74dEEbe0CFB7E85,2200,Emily,Morris,Berg-Crane,Mcneilburgh,Greece,(449)630-0712x064,341-640-4767x8014,breanna29@lucero-hunt.com,2022-04-27,https://www.dixon.com/
29-Jan-2021,Bill,"5,280.87",00.00,"54,955.41",056EE52d310c8Ef,9114,Wanda,Mays,"Wolfe, Kaufman and Fischer",Brandonmouth,Denmark,9475849787,(828)630-6959x8734,randolphmackenzie@wheeler-huffman.com,2021-12-01,http://www.lowery-nolan.net/
29-Jan-2021,Transfer,00.00,"6,869.43","48,085.98",dDCCcCEEb244DCB,7459,Joann,Mckee,Mooney-Schroeder,Port Tony,Monaco,(612)252-4788,(274)639-5331x574,tyronepeterson@parks.net,2021-10-05,https://www.lam.org/
29-Jan-2021,Purchase,02.00,00.00,"48,087.98",eCab082EF2aB8E4,7805,Cathy,Padilla,Preston Inc,Baxtertown,Tokelau,+1-162-728-9669x7583,229-764-7492x4448,brucecassandra@glover-drake.com,2021-08-30,https://fox.com/
29-Jan-2021,NEFT,00.00,"5,343.11","42,744.87",40b6054b6AF1f65,5868,Joseph,Hughes,Wiggins Ltd,Kevinstad,Myanmar,+1-017-852-9854x7783,053-701-5277,lynnhodges@madden.info,2020-06-11,http://logan.info/
29-Jan-2021,Bill,41.27,00.00,"42,786.14",476Bc9A9a824AdF,9133,Caitlin,Zavala,"Duarte, Jennings and Hale",Jeffreymouth,Hungary,4255996445,+1-185-852-2783x16606,johnberger@dalton.info,2022-04-22,https://www.orozco.org/
29-Jan-2021,Commission,00.00,"10,696.54","32,089.60",bA34810aC7B7aE7,1796,Destiny,York,Juarez PLC,Mezaborough,Kazakhstan,937.545.7338x134,006-948-3832,lucasconway@hardin.net,2020-08-02,https://www.webb.info/
29-Jan-2021,Bill,00.00,"16,044.80","16,044.80",b8eb1eAd6Ebd3C9,8414,Theresa,Rose,"Baird, Harrison and Ho",North Kiaraport,Venezuela,280-125-7779x3363,891-777-7937,agriffin@long-madden.biz,2021-11-20,http://martin.com/
29-Jan-2021,RTGS,07.00,00.00,"16,051.80",2b6e2eFEcb1D3Ad,3539,Sheryl,Benson,Hebert and Sons,Lynntown,Uzbekistan,(027)465-9008,(386)011-1268x613,mcconnellbenjamin@edwards.org,2020-08-22,https://www.schmitt-moran.com/
29-Jan-2021,Tax,28.00,00.00,"16,079.80",9Edc58c4a1F8B56,9931,Sydney,Velasquez,"Tyler, Potter and Orozco",North Dillonton,Lao People's Democratic Republic,001-481-828-9174x3413,(736)395-8066x885,rickeyhobbs@clay-campbell.com,2022-02-20,http://eaton-snow.org/
29-Jan-2021,Cheque,"83,420.00",00.00,"99,499.80",FEe28dbD177A7ff,7747,Victoria,Cole,"Mcneil, Mcintyre and Mason",East Cody,Cuba,+1-142-555-0942x1265,088-802-6840,snielsen@andrade.org,2020-12-21,https://snow-molina.biz/
29-Jan-2021,Interest,00.00,"11,055.53","88,444.27",542074F6A62d16A,808,Samuel,Pearson,Gilmore PLC,Michaelhaven,Namibia,765.438.5423x7454,169.848.5012x65622,blackwelldarlene@dillon-hopkins.com,2021-07-25,https://www.orozco.com/
29-Jan-2021,Transfer,00.00,"12,634.90","75,809.37",d5BBAD2AdabB8dC,6215,Nathaniel,Alvarado,"Barajas, Smith and Michael",North Samuel,American Samoa,670-559-0127,084-651-3746x961,bernardwallace@irwin-underwood.com,2020-02-17,http://elliott-madden.info/
29-Jan-2021,Cash,00.00,"75,809.37",00.00,e6A4337A6bFDBb6,8040,Ralph,Beasley,Aguilar LLC,Port Tasha,Madagascar,0709460009,001-832-810-0936x9588,kerrytate@olson.info,2021-05-30,http://armstrong.com/
29-Jan-2021,Cheque,262.24,00.00,262.24,0ab648cc75eE10b,4072,Reginald,Guerra,"Briggs, Fuller and Zhang",Wrightfort,Heard Island and McDonald Islands,+1-908-298-7378,173-380-6717x1865,mackenzievalentine@hamilton-colon.biz,2021-05-08,http://www.hood.com/
29-Jan-2021,Commission,00.00,87.41,174.83,4dCd4AaEAA60CfB,3668,Destiny,Bolton,Barnett Ltd,South Brucestad,Slovenia,639-221-9467x6901,668.502.2031x9165,adkinsregina@bishop.info,2021-02-05,http://www.robinson.com/
29-Jan-2021,Interest,00.00,00.00,174.83,1CE0c8F2faEE040,1401,Christian,Braun,Matthews Inc,Lake Jesse,Malawi,735-322-8767x6667,923-245-4970x81082,vchavez@figueroa.com,2021-06-21,https://keith.com/
29-Jan-2021,Debit Card,205.40,00.00,380.23,8a063ae54b5ee05,9142,Nathan,Vance,Walters-Simmons,Shafferburgh,Bolivia,001-958-750-5867x7744,853.772.6518x55488,kerrihess@kirk.com,2022-02-13,http://www.stevens.com/
29-Jan-2021,Bill,00.00,380.23,00.00,7DD8d6e0AABA8FF,1728,Roger,Novak,"Cortez, Stevens and Ayers",South Barry,Netherlands,149-407-4039,+1-907-768-1609,gardnersandy@zuniga.net,2020-01-03,http://orr.net/
29-Jan-2021,ATM,22.00,00.00,22.00,ADFf4FdCceDFD3D,1942,Latasha,Weaver,Chen-Contreras,Dwaynehaven,Ghana,252.330.6673x443,(731)669-3488x71780,henrymurray@kane.biz,2022-04-04,https://www.oneill.com/
29-Jan-2021,Transfer,"150,082.10",00.00,"150,104.10",7FF0894e98eA30B,8228,Bridget,Carney,Nixon-Good,South Kristie,Samoa,001-794-735-3705x4205,(604)448-6251x6045,longdiane@steele.com,2021-05-14,https://www.solis-myers.info/
29-Jan-2021,Miscellaneous,52.80,00.00,"150,156.90",dFbC1EDEa186C2a,4782,Carrie,Merritt,Glenn-Chambers,Schaeferland,Bhutan,(018)626-6086,4738263512,latasha02@williamson.com,2020-03-10,https://www.hatfield.org/
30-Jan-2021,Miscellaneous,00.00,"30,031.38","120,125.52",D6FdCC7fCC9E0ca,4112,Candace,Cordova,"Elliott, Nelson and Stephenson",Lutzmouth,Tokelau,+1-023-036-1316x719,983.275.9331x9866,umcclain@lee-suarez.com,2020-12-06,https://www.mcknight.com/
30-Jan-2021,Interest,00.00,"20,020.92","100,104.60",eDdcfb47aa0d87E,8487,Stanley,Patton,Andrews Ltd,Lake Shelby,Anguilla,+1-574-527-4896x23045,001-546-480-6273x694,rothjason@sims-ashley.com,2021-01-12,https://poole-bender.com/
30-Jan-2021,IMPS,00.00,"25,026.15","75,078.45",39a9aa7bbBce6AD,3631,Vernon,Bartlett,Nguyen-Li,North Sarah,Senegal,939-605-3106x2774,242-089-3364,adkinslori@oliver-bender.com,2021-10-04,http://www.andersen.com/
30-Jan-2021,Bill,00.00,"75,078.45",00.00,8271eEAC7a4bF48,9186,Hunter,Walter,Duke PLC,Caitlinside,New Zealand,+1-890-156-3735x1915,(950)629-7414x8259,jeanettehill@huff.com,2020-09-05,http://hinton.biz/
30-Jan-2021,NEFT,315.00,00.00,315.00,6eA0979dA445FAA,1692,Jessica,Carney,Gallegos Group,Weissfort,France,759.269.3995x076,8269936424,zlarsen@zimmerman.com,2020-06-22,http://www.gross.com/
30-Jan-2021,Interest,"41,620.00",00.00,"41,935.00",0d17bEee6CcAe22,834,Jennifer,Booker,"Hopkins, Frederick and Wall",South Rachel,Reunion,342-905-6732,+1-430-361-1703x4186,ronnie20@sharp-foley.com,2021-03-09,https://taylor.biz/
30-Jan-2021,Commission,00.00,"20,967.50","20,967.50",Af3D43ff67eFcBA,2927,Selena,Hicks,Zamora PLC,Choibury,Haiti,062.029.5680x7916,+1-619-997-3837x621,kurtbranch@walls.com,2020-03-02,http://www.mcneil-cohen.com/
30-Jan-2021,RTGS,"14,393.00",00.00,"35,360.50",93eAEBaD69aC9ce,4662,Ashley,Moses,"Whitney, Mullins and Reed",Stuartborough,Trinidad and Tobago,(216)744-0500x430,1237517049,millsbreanna@farmer.org,2020-11-11,https://www.kennedy.net/
30-Jan-2021,Miscellaneous,"22,889.00",00.00,"58,249.50",CC9B6713dc46eA7,3221,Jerry,Howard,Cain-Chavez,East Erica,Norway,600.564.6533x789,683.517.7956x324,leroyvilla@peck.com,2021-05-22,http://vazquez-dudley.com/
30-Jan-2021,Miscellaneous,00.00,"58,249.50",00.00,08B2937A4d50FEd,1948,Melanie,Mcneil,Burch-Dodson,West Mercedes,Poland,712.040.5163x85264,(481)826-0039x71519,nbarber@kerr.net,2021-08-30,http://boyer.com/
30-Jan-2021,Bill,309.00,00.00,309.00,09aC4D0ec877e3B,6453,Jaclyn,Callahan,"Giles, Mckinney and Fuentes",New Brett,Venezuela,001-361-152-7082x5276,(512)494-0953x9823,lpowers@barnes.info,2020-04-19,http://walters.info/
30-Jan-2021,Commission,00.00,51.50,257.50,9c6eECab5CFa7ED,4259,Kayla,Dickerson,"Taylor, Mcpherson and Berg",Bakerchester,Palau,(994)964-1383,(040)899-4898x10961,emma64@nolan.com,2022-02-20,http://www.hubbard-sanchez.com/
30-Jan-2021,NEFT,54.00,00.00,311.50,4cAb8c0eC5811B5,2654,Rick,Johnson,"Noble, Holloway and Silva",West Ana,Heard Island and McDonald Islands,+1-518-849-5010x343,463.574.1156,englishtroy@castro-farley.info,2020-10-30,http://www.evans-frank.com/
30-Jan-2021,Purchase,"27,129.00",00.00,"27,440.50",f8E73B1D8440aff,5099,Ronnie,Benton,"Underwood, Jensen and Ponce",East Anthonyborough,French Guiana,(886)996-4333,5926982824,mcphersonlydia@mcfarland.com,2022-03-24,https://rangel-hunter.com/
30-Jan-2021,Cash,"5,048.00",00.00,"32,488.50",Ca492c76A52Da9F,67,Kelli,Bridges,"Black, Richardson and Sandoval",Lake Aaron,Mongolia,5657167326,220.834.4618x14578,daisyblair@walsh-holmes.org,2021-12-05,https://www.trevino.info/
30-Jan-2021,IMPS,50.79,00.00,"32,539.29",7Ce235c7FD5eD34,2687,Devin,Sellers,Romero Ltd,West Candicemouth,Marshall Islands,470-545-0978,1554209530,gavinvalencia@best.com,2020-03-30,https://farrell-perkins.com/
30-Jan-2021,Interest,50.00,00.00,"32,589.29",3edF1BfF7c19e6C,9876,Elizabeth,Huff,Adams Group,North Beth,Panama,+1-321-644-2116,+1-233-623-1599x4828,mcfarlandgarrett@flowers.com,2022-03-17,http://www.villanueva-bates.com/
30-Jan-2021,Cheque,00.00,"3,621.03","28,968.26",fe5fAbBDD1D2eFD,4930,Christie,Sandoval,"Harvey, Bauer and Weaver",East Roberto,Cyprus,892.912.7067,(178)155-2534x49676,emoran@shields.biz,2021-06-30,http://www.beard.biz/
30-Jan-2021,Transfer,00.00,"4,138.32","24,829.94",D57F7DeB5Db58fa,2803,Natalie,Cline,"Beltran, Leonard and Gonzales",East Pattyborough,Croatia,001-711-293-9218x957,297.391.0240x40487,johnnypugh@wang.net,2021-02-20,https://www.mcdowell.com/
30-Jan-2021,Interest,"2,167.60",00.00,"26,997.54",1F7cF53c7ebFc3D,408,Francis,Bradford,Contreras PLC,New Hayley,Sudan,(266)493-2713x08961,241.387.2339x4572,alejandra14@quinn.com,2022-01-11,http://maynard.com/
30-Jan-2021,Commission,"3,088.20",00.00,"30,085.74",cCdfaCc7961eEC7,2273,Alejandro,Mueller,"Duncan, Douglas and Cross",Lake Sheila,Nepal,175.447.8626,001-015-633-6935,khantricia@fields.com,2021-12-09,http://www.lambert-mullen.org/
30-Jan-2021,Reversal,00.00,"15,042.87","15,042.87",be4f53D0ed6aa57,2301,Cameron,Le,Collins-Obrien,Lake Sherritown,San Marino,(667)691-9385,780.923.4808x0592,herbertphelps@reid.com,2020-11-16,https://lester.com/
30-Jan-2021,Reversal,"190,204.30",00.00,"205,247.17",E3a886752F9Ced1,7706,Jenna,Ward,Knapp-Lucero,North Terri,Somalia,001-375-246-9830x9031,001-339-037-0128x922,kyle23@brooks.com,2022-02-13,https://www.bowers.com/
30-Jan-2021,ATM,00.00,"20,524.72","184,722.45",6dc7EFb1dAe7FFe,9710,Harry,Harrell,Morales and Sons,New Beth,South Georgia and the South Sandwich Islands,001-915-276-9165x3636,001-218-858-7497x4051,hinesgwendolyn@combs.org,2021-01-30,http://www.villanueva-duncan.net/
30-Jan-2021,NEFT,00.00,"26,388.92","158,333.53",2E7b22f7456f1aE,5478,Danny,Callahan,"Calderon, Beck and Lindsey",Alexview,Slovenia,(156)077-1338x82255,829.767.3184x6253,ychoi@carpenter.org,2020-07-10,http://www.nichols.com/
30-Jan-2021,ATM,197.57,00.00,"158,531.10",a3aCDdFA3fbCe1c,5425,Faith,Cohen,"Frazier, Russell and Bridges",East Jimmymouth,Japan,+1-893-467-7354x41283,146.330.2439x19960,fhammond@huynh.com,2021-08-17,https://garrett.com/
30-Jan-2021,Cash,06.40,00.00,"158,537.50",6e5a91cE65CCD61,3325,Ernest,Hurst,Monroe and Sons,Joycechester,South Georgia and the South Sandwich Islands,001-371-539-0088,557.596.6312,camerongregory@camacho-clayton.com,2020-03-02,http://trujillo.com/
30-Jan-2021,Commission,"152,551.40",00.00,"311,088.90",fB5c83e698FBF88,755,Caroline,Lamb,Shannon PLC,Port Donald,Turkey,(398)273-3053x049,001-333-231-9162x7785,hnunez@alexander.com,2022-01-06,http://www.randolph-brooks.com/
30-Jan-2021,Bill,00.00,"311,088.90",00.00,a21Ce6067cD633E,360,Drew,Patterson,"Ruiz, Leon and Salinas",Diazmouth,Congo,+1-629-893-3866x5762,484-379-5918x42421,mbanks@dorsey-sanchez.biz,2020-01-25,https://www.hunter.net/
30-Jan-2021,IMPS,"4,181.10",00.00,"4,181.10",ff8af69AecCdFCB,4021,Kelli,Wilcox,"Taylor, Hanna and Valdez",Lynnstad,Guyana,615-445-5255,+1-692-624-2700x3041,edward96@greene.org,2022-01-02,http://friedman.com/
30-Jan-2021,Bill,00.00,"2,090.55","2,090.55",8F6Bfe6c8DE9a2c,885,Darrell,Alvarado,"Dickerson, Guerra and Wyatt",Garrettburgh,Slovakia (Slovak Republic),(552)907-4300x61041,866-784-1737x1261,fdurham@christian.com,2021-12-03,http://greer.com/
30-Jan-2021,Cheque,00.00,522.64,"1,567.91",B48c0Ab1cc90fe2,7349,Johnny,Singleton,"Howell, Walker and Warren",West Debra,New Zealand,+1-605-004-7382,+1-312-276-2577x27582,jillholmes@barnett-mcknight.info,2021-10-30,http://www.conway.com/
30-Jan-2021,Tax,00.00,391.98,"1,175.93",6bE41F7aC3AEcDa,8064,Holly,Avery,"Moyer, Donaldson and Vincent",Dukefurt,Antarctica (the territory South of 60 deg S),(918)569-3321x4425,609.956.9824x1465,pbass@li.com,2021-07-15,http://franklin.org/
30-Jan-2021,Purchase,"98,274.00",00.00,"99,449.93",6dD1659A6CDC3F7,1340,Joyce,Robles,Lane PLC,Silvaport,Iran,001-268-180-7682x2159,001-939-453-4769,rittermeagan@beasley.com,2021-12-19,http://www.salazar.net/
30-Jan-2021,Tax,00.00,"19,889.99","79,559.94",1dFB22F16d11e25,7201,Marisa,Bowman,Guzman and Sons,Nicholasside,Serbia,(150)212-0745,(890)658-6895,maureenblankenship@mcintyre.com,2020-08-24,https://www.francis.net/
30-Jan-2021,Purchase,06.00,00.00,"79,565.94",EE4808D6e405282,8598,Xavier,Clark,Clarke Group,Lake Randall,Pitcairn Islands,975-545-8778,+1-991-272-8702x9689,tommykerr@montoya.com,2021-01-16,https://ruiz.net/
30-Jan-2021,IMPS,"27,105.00",00.00,"106,670.94",2b5B80C641F7CA5,3599,Faith,Jennings,Bridges-Price,Homouth,Montserrat,802.603.5245x5154,(478)826-6925x5787,mathewlara@nixon.com,2020-01-22,https://www.prince.com/
30-Jan-2021,Reversal,00.00,"106,670.94",00.00,a3A97EAB8EAef0D,1667,Pedro,Aguilar,Brooks-Kennedy,Fieldsfurt,Vietnam,+1-716-854-7725x23751,001-940-925-3567x4640,dudleyabigail@crosby.com,2021-10-12,https://www.mckenzie.net/
30-Jan-2021,ATM,"13,405.80",00.00,"13,405.80",f40A85B5CFDaf3E,7140,Adrian,Munoz,Benitez-Browning,Port Dana,Philippines,(382)056-6608x881,1692054897,leonard63@romero.biz,2021-11-14,https://www.oneal.org/
30-Jan-2021,Cheque,38.50,00.00,"13,444.30",f7FDde683A4e5c9,3618,Alan,Paul,"Floyd, Zuniga and Krause",Olsenville,Western Sahara,750-164-4973,(875)326-1324x37314,sara48@stone-barber.org,2021-07-05,http://roth-campos.com/
30-Jan-2021,Purchase,00.00,"3,361.08","10,083.22",A6d69E1Cac8bB22,3620,Sheena,Weeks,"Mooney, Diaz and Hale",Deanstad,Guatemala,(724)968-4525,097-908-8214,kellerclinton@faulkner.biz,2022-03-14,http://www.macias.com/
30-Jan-2021,Purchase,05.60,00.00,"10,088.82",2E1fDFc73D4B224,8868,Isaiah,Ramirez,"Trujillo, Rios and Browning",Debraland,Latvia,687.801.6794x53241,250-759-6778x94693,chelsey49@dean.info,2020-02-07,https://moon-hensley.com/
30-Jan-2021,Debit Card,396.70,00.00,"10,485.52",6DFd95ac1ad8FBa,8207,Jenny,Tapia,Petty-Livingston,Port Tabithatown,Djibouti,(566)463-2243,045-799-9378,makayla17@caldwell-gregory.com,2020-09-27,https://www.beard.com/
30-Jan-2021,Bill,00.00,"3,495.17","6,990.35",07EAb9Ad864Dc88,4593,Sherri,Stokes,Powell Inc,Triciachester,Mauritania,7391365736,844.105.3242x59777,lindamurray@kelly-lara.com,2020-02-22,http://griffin.org/
30-Jan-2021,Debit Card,01.60,00.00,"6,991.95",af9E08B0dDe8216,5800,Frederick,Bullock,Orozco-Hebert,Jefferytown,Djibouti,001-835-668-1766x550,001-834-882-8713x507,blankenshipdonna@beck-barron.com,2020-03-07,http://meadows.org/
30-Jan-2021,RTGS,37.00,00.00,"7,028.95",05c6e3D55a93Ce3,1471,Dakota,Chapman,Cochran and Sons,Coxton,Saint Pierre and Miquelon,572.114.6164x236,001-991-905-2279,gwalker@stevens.biz,2022-04-10,https://www.zuniga.info/
30-Jan-2021,Tax,104.26,00.00,"7,133.21",da33dd230Ffd7c5,3045,Bryce,Lara,Kaiser-Hardin,Ellenton,Croatia,001-406-297-9725,622.954.8682,philip29@english.com,2020-01-26,https://nixon-cline.org/
30-Jan-2021,Bill,241.00,00.00,"7,374.21",cdC79DdEcF0B52C,569,Dwayne,Kane,"Branch, Mcclain and Baker",Terrimouth,Saint Lucia,(307)645-5099,(380)435-1039x041,gamblemaria@humphrey.com,2020-09-22,http://richard-olson.com/
30-Jan-2021,RTGS,00.00,"1,843.55","5,530.66",662221D2eb1A79b,1153,Emma,Fitzgerald,"Spence, Hendrix and Singh",Lake Jasminchester,Burkina Faso,748-888-8639x940,(418)560-4947x080,alexlynn@gilmore-chang.biz,2020-04-08,http://www.rivers.com/
30-Jan-2021,Reversal,00.00,921.78,"4,608.88",2A4AE5dE3fbfAE6,1664,Ashlee,Dixon,Reese Ltd,Mcmahonborough,American Samoa,001-674-243-7422x57501,001-078-052-4654,jorgenewman@bullock-welch.com,2020-09-07,https://www.boyle-berry.com/
30-Jan-2021,NEFT,00.00,"1,536.29","3,072.59",3991Cf25eBc54bd,5523,Alyssa,Woodard,Norton-Dudley,Kentside,Eritrea,001-779-112-8126x6111,(612)843-2304,hansengene@meyers-hatfield.biz,2022-01-08,http://mendoza-velazquez.com/
30-Jan-2021,ATM,00.00,614.52,"2,458.07",917FddC72648eFf,5963,Bridget,Cardenas,Thomas-Fernandez,Ramirezfurt,Brazil,647-099-2086,(981)042-1251x372,qspears@best.net,2021-01-30,https://www.hardy-blevins.org/
30-Jan-2021,Cash,00.00,245.81,"2,212.26",a88f50a26639aC7,2138,Ana,Martin,Arroyo-Mejia,Leslieland,Austria,001-693-235-6846,271-611-7047x9334,jeffsimpson@shannon-singh.biz,2021-05-20,http://www.abbott-choi.com/
30-Jan-2021,Bill,00.00,553.07,"1,659.20",aDD9391DeBdF839,6972,Malik,Sullivan,Donaldson and Sons,Rosarioport,Montserrat,(926)659-8757,(236)764-9445x027,danielle18@francis.com,2022-01-19,http://snyder.com/
30-Jan-2021,Transfer,00.00,237.03,"1,422.17",cA0FDFe071A4BED,3869,Billy,Schneider,Pugh-Snow,Graceport,Central African Republic,4697628364,001-531-312-6360x2292,mitchellerika@drake.com,2020-06-04,https://cochran-wu.info/
30-Jan-2021,NEFT,00.00,711.09,711.08,dC9dc0BB8f757E1,3408,Victor,Case,Maxwell-Sloan,Lake Vanessa,Kenya,249.180.2602x400,831.283.5049x838,barbaramoore@elliott.org,2020-11-19,https://mccoy.info/
30-Jan-2021,Cash,"2,276.00",00.00,"2,987.08",Ce37AAdB41AA254,1009,Scott,Parrish,Ball PLC,West Marcochester,Timor-Leste,+1-019-049-1108x815,698.862.0127x58025,kristina85@forbes-sullivan.com,2021-08-27,http://mosley.biz/
30-Jan-2021,Tax,00.00,746.77,"2,240.31",eE5a4e00d9Be04a,4740,Patrick,Hughes,"Blackburn, Fritz and Soto",North Taylormouth,Holy See (Vatican City State),002.356.5147x00309,5810688916,greg00@strong-chang.net,2020-11-30,http://www.summers.com/
30-Jan-2021,Miscellaneous,"155,993.70",00.00,"158,234.01",d64aAa813DebAb4,2300,Penny,Dougherty,Munoz-Dorsey,Palmerchester,Anguilla,+1-740-942-7761x95649,+1-825-799-2306x94192,glen96@greer.info,2020-10-29,http://www.stephens.com/
30-Jan-2021,Purchase,02.58,00.00,"158,236.59",090ae58fc4Fa672,2691,Travis,Buck,"Bruce, Williams and Shelton",Kaufmanburgh,Dominica,535-355-1892x193,037.649.8748,jtucker@ayers-swanson.com,2020-05-18,http://oconnor-sampson.biz/
30-Jan-2021,Bill,"1,674.80",00.00,"159,911.39",D96FEF8459EcEb0,2419,Emma,Davies,Escobar Group,East Tristanport,Congo,633-088-8389x23693,822.309.5385,tannermcmillan@nixon-luna.info,2020-01-19,https://guerrero.biz/
30-Jan-2021,Commission,"137,763.62",00.00,"297,675.01",B4BCE89feD0fDfA,3704,Jeff,Escobar,Phillips-Cobb,Brandyburgh,Bosnia and Herzegovina,001-178-690-2441x8902,852.037.7581,diane65@grant.org,2022-01-04,https://hunt.com/
30-Jan-2021,Tax,00.00,"33,075.00","264,600.01",73cdf8Af51B6ABc,840,Bruce,Marquez,Walker-Best,West Carol,Bermuda,(190)697-4919,001-414-495-7711x5162,hguerra@blake.org,2022-02-28,https://blevins.com/
30-Jan-2021,Debit Card,"1,817,358.00",00.00,"2,081,958.01",431CF7E64CEE346,887,Earl,Wells,"Guerrero, Hinton and Nicholson",East Latasha,Sudan,804.524.5403x52164,+1-686-273-5209x429,valdezshelley@jarvis-buchanan.info,2021-05-15,http://www.mahoney-wiley.com/
30-Jan-2021,Purchase,06.07,00.00,"2,081,964.08",2E1fDFc73D4B224,8868,Isaiah,Ramirez,"Trujillo, Rios and Browning",Debraland,Latvia,687.801.6794x53241,250-759-6778x94693,chelsey49@dean.info,2020-02-07,https://moon-hensley.com/
30-Jan-2021,Transfer,341.50,00.00,"2,082,305.58",20f858Ba0d8bE40,7095,Alejandro,Cooley,Mahoney Group,Hutchinsonhaven,Syrian Arab Republic,+1-554-412-8139,686.014.7962x67969,lydiarichards@velez.info,2022-03-20,http://mueller-marshall.biz/
30-Jan-2021,Transfer,"2,975.00",00.00,"2,085,280.58",7DE404aeE6EFCbe,2834,Jeff,Robbins,Ewing-Johnson,North Sabrina,Denmark,+1-756-748-3884x7452,(448)987-6032x97970,noah57@blackburn.com,2020-08-30,http://lowery.biz/
30-Jan-2021,ATM,00.00,"297,897.23","1,787,383.35",cec5D53082Ba76C,297,Alyssa,Woodard,Horne-Guerrero,North Jamesside,Panama,+1-371-916-6695x29105,001-344-303-0348,wbuckley@randall.com,2021-10-08,https://chaney.biz/
30-Jan-2021,Bill,00.00,"893,691.68","893,691.68",DFB3fcfbe67D6cc,8903,Laura,Petty,"Hill, Mcpherson and Hernandez",North Mindy,Namibia,(437)493-9021x439,7636737129,perry53@skinner.com,2020-04-03,https://berry.com/
30-Jan-2021,Miscellaneous,"677,971.00",00.00,"1,571,662.68",C19F0D7e2FFD095,7856,Leslie,Andrade,"Sloan, Bowers and Livingston",West Autumn,Cote d'Ivoire,+1-419-669-8338x94732,+1-030-990-9729x9798,haydenhector@burgess.com,2021-06-19,http://www.savage.info/
30-Jan-2021,NEFT,02.08,00.00,"1,571,664.76",9465BBe5bc7abEe,1000,Colleen,Serrano,"Hobbs, Chandler and Bennett",Wendymouth,Montenegro,373.106.3944x6794,(884)294-9618x00033,ynielsen@booker-cervantes.com,2020-07-01,https://prince.org/
30-Jan-2021,NEFT,00.00,"392,916.19","1,178,748.57",1eaF40D3aDb4551,2266,Rachael,Carrillo,Flynn Inc,Rickyberg,Falkland Islands (Malvinas),(058)336-2304,(507)354-5160x41864,warrencoleman@compton.com,2021-08-14,https://daniels.com/
30-Jan-2021,Cash,"3,179.70",00.00,"1,181,928.27",e63BFCd5ae7B40c,9650,David,Nixon,King-Merritt,South Shawn,Vanuatu,350.633.1609x415,108.042.3610,cristinawelch@ferguson.com,2020-07-15,https://hogan.com/
30-Jan-2021,RTGS,00.00,"196,988.05","984,940.22",00C5FeadD87EeD5,2978,Matthew,Hurley,Stewart-Davidson,Oscarmouth,Myanmar,891-910-9221x7233,732.970.1087x415,esparzakyle@rogers.com,2020-12-29,http://macias-morris.com/
30-Jan-2021,Reversal,00.00,"109,437.80","875,502.42",0b5faA7c4e6b6fA,5105,Sergio,Fisher,"Atkins, Fleming and Wolfe",New Markside,Saint Vincent and the Grenadines,+1-021-822-7216x4884,+1-903-434-6381,miafuentes@ritter-sutton.org,2022-05-07,http://quinn.com/
30-Jan-2021,Miscellaneous,00.00,"109,437.80","766,064.62",FfDfEcc5FFFdA95,6781,Kenneth,Craig,"Wall, Walter and Page",Port Joel,Morocco,001-089-129-6082x036,+1-547-924-6453x2022,melanie55@kelley.biz,2020-07-05,https://www.escobar.com/
30-Jan-2021,RTGS,"516,991.25",00.00,"1,283,055.87",a1F5BC70ef4AAfC,3367,Natasha,Hayes,Riley-Taylor,Tashaside,Bulgaria,001-433-991-3240x42563,895-508-8780x3821,arthur78@sandoval.com,2020-08-20,https://www.gallagher-levy.net/
30-Jan-2021,Debit Card,"1,275.00",00.00,"1,284,330.87",4dc8DdF4D0DfecA,8929,Doris,Waller,Yates Group,Port Lonniestad,Indonesia,(110)520-4824,001-670-961-3900x54843,ramseyleah@coleman.info,2021-08-17,https://lowery.org/
30-Jan-2021,Interest,00.00,"160,541.36","1,123,789.51",a18febEDd0d210b,6258,Beth,Ryan,Ochoa-Pierce,Jimmyshire,Portugal,(490)524-4831,(131)646-0362x738,hinesjoanne@mata-spears.org,2021-11-20,https://cummings.com/
30-Jan-2021,Cheque,00.00,"224,757.90","899,031.61",eD16DBEbeAc83F1,4084,Gail,Mcgrath,Dougherty-Waller,Port Kennethborough,Romania,001-822-787-7712x49955,001-487-402-6390,jeanhatfield@greene.com,2021-07-10,https://stewart.com/
30-Jan-2021,Tax,00.00,"112,378.95","786,652.66",c3928aAEf93beA7,2584,Perry,Zuniga,Lawrence-Gay,West Valerieland,Belgium,829-415-0057x08290,(574)431-5896x462,brettruiz@rivera-moss.com,2020-06-15,http://novak.com/
30-Jan-2021,Interest,00.00,"786,652.66",00.00,4262Dcdc013a0c2,6788,Jackson,Rodgers,"Hurst, Patterson and Cooper",Johnsonchester,Nicaragua,(258)559-7396,+1-866-068-0718x945,sbranch@welch-santana.net,2020-05-13,http://brandt-andrade.biz/
30-Jan-2021,Miscellaneous,"112,027.97",00.00,"112,027.97",5e2FC08bDF0aB5d,4771,Carly,Burns,"Melendez, Rodgers and Petty",Daltonland,Italy,167.830.2362x669,001-554-167-1434,helen45@sims-ewing.com,2020-01-13,https://vincent.com/
30-Jan-2021,Interest,00.00,"112,027.97",00.00,47B103d5B5f10F1,3884,Sherri,Escobar,Russo-Blackwell,Kimside,Peru,801.598.8166,254.433.4701,bnovak@mathews.org,2021-03-25,https://dean.net/
30-Jan-2021,Purchase,05.00,00.00,05.00,5EDb197afE9965F,98,Paul,Moore,White-George,Marcoburgh,Brazil,(451)968-9182,+1-454-876-8759x02495,spencerbright@powell.biz,2021-12-10,https://wall-reid.com/
30-Jan-2021,Interest,18.00,00.00,23.00,f80b8038baa9De3,5297,Meghan,Townsend,Bowman Group,Duaneton,Cocos (Keeling) Islands,(541)002-1423x916,358.581.4126x1627,hannahrobertson@leon-larsen.com,2020-12-27,https://www.navarro.com/
30-Jan-2021,Debit Card,170.00,00.00,193.00,56124Dc5553DDc0,5319,Derek,Chambers,Knox-Cooper,Port Savannahview,Taiwan,+1-627-339-7450,+1-473-653-3405x171,ralphperez@blake.com,2020-09-10,http://www.kirby.org/
30-Jan-2021,IMPS,00.00,96.50,96.50,bdD61A6589BDeC2,4257,Terry,Frederick,"Larson, Jordan and Garcia",Burnsview,Bangladesh,157.490.8624x26827,122-482-2447,andersonangie@hickman.com,2021-07-14,https://lloyd.com/
30-Jan-2021,ATM,306.00,00.00,402.50,88Ecd5ff77F037d,9128,Douglas,Gross,Parsons-Key,North Marilynbury,Holy See (Vatican City State),+1-103-710-2409x79008,(952)120-8001x189,claire74@schwartz.biz,2022-04-26,http://www.rose.com/
30-Jan-2021,Reversal,"194,521.00",00.00,"194,923.50",95299c08e6C0a9D,6419,Gordon,Lindsey,Bray-Small,East Aimee,Angola,(711)940-7991,+1-003-005-2217x25865,santosnathaniel@glover-patel.com,2020-06-19,https://www.bernard.info/
30-Jan-2021,Cheque,"305,125.75",00.00,"500,049.25",90cd0eBFcFaDB3f,8628,Carlos,Delgado,Garza-Frye,South Marie,Turks and Caicos Islands,102.018.0758,355-029-9122,sheliaarmstrong@gardner.net,2020-09-25,https://waters.com/
30-Jan-2021,Cheque,00.00,"125,012.31","375,036.94",dFB8Ebf04d9b655,1537,Sheila,Dean,Woodward Inc,South Haileyport,Nigeria,486-140-2038,751.527.4787x860,vaughankerry@ball-roth.com,2022-05-27,http://rubio.com/
30-Jan-2021,Cash,"184,777.00",00.00,"559,813.94",cdbf58F98acA97c,3938,Bridget,Shepherd,"Sloan, Hurley and Ramos",West Cheyennetown,New Zealand,001-873-089-1184x539,+1-690-988-5003x69223,zhangbrian@hatfield-wright.org,2022-05-04,https://www.gibbs.net/
31-Jan-2021,Cash,"9,171.83",00.00,"568,985.77",FE5Ee2dEeE4cE28,409,Marilyn,Peck,"Solomon, Potter and Merritt",Oscarborough,Western Sahara,(319)744-3383x354,1974058669,stacy53@gardner.com,2022-04-30,http://www.frank.com/
31-Jan-2021,Miscellaneous,"104,971.10",00.00,"673,956.87",BAA7b818eaaacbD,9616,Edgar,Blair,"Ellis, Morris and Willis",South Hailey,Lebanon,(033)173-8003,001-530-286-0787x6756,shannon04@nelson-mcbride.com,2021-06-21,https://martin.com/
01-Feb-2021,Commission,07.90,00.00,"673,964.77",52aC7BadBdD4823,1365,Phyllis,Hatfield,Montes-Bradford,Port Alexisside,Moldova,6137332375,976.302.2855x34054,wigginsnatasha@compton.org,2021-10-26,http://www.oconnell.com/
01-Feb-2021,IMPS,00.00,"134,792.95","539,171.82",d9e413aC4aa8FC0,4207,Pam,Burton,"Ware, Grimes and Hamilton",Lake Oscarfort,Christmas Island,512-279-3608x02985,544.610.0819x35861,mitchellshort@bartlett.com,2022-02-27,https://www.mcdonald-snow.com/
01-Feb-2021,Miscellaneous,10.00,00.00,"539,181.82",5a1bCfF2C6Cfc18,3660,Steve,Powell,Noble-May,West Russell,Afghanistan,7532662805,352-654-2536,bushbetty@klein.com,2021-05-19,https://gardner.info/
01-Feb-2021,ATM,00.00,"53,918.18","485,263.64",beDDbdf4BD0ADcc,7371,Damon,Reeves,Bryant PLC,Lindsayview,Algeria,(173)197-2970x388,+1-069-376-1558x334,john91@marshall-zhang.com,2022-03-17,https://santos-lutz.com/
01-Feb-2021,IMPS,00.00,"80,877.27","404,386.37",b2AcD3fF071C6cb,5472,Mercedes,Hammond,Mullen and Sons,Normanborough,Antarctica (the territory South of 60 deg S),001-142-185-2595,(767)898-5137x7028,galvanandrea@hester-rojas.org,2022-03-21,https://pearson.com/
01-Feb-2021,Reversal,00.00,"101,096.59","303,289.78",cE9bf90bBcd20e6,7378,Hayden,Wilkerson,"Martinez, Brewer and Pruitt",Hesterfort,Christmas Island,3664218814,685-085-1020x62377,sheliaglenn@davila.com,2021-08-27,http://www.jensen.com/
01-Feb-2021,Reversal,"2,443.08",00.00,"305,732.86",1DF7EEa5FDbA75b,2397,Ebony,Ray,"Singh, Benson and Mercado",Hurstchester,Sierra Leone,+1-005-480-3950x959,001-799-374-8584x11288,elane@phelps-spears.org,2020-12-22,http://weiss.com/
01-Feb-2021,Interest,00.00,"50,955.48","254,777.38",c00B7286C0Ee99d,6373,Andrew,Richards,Shea-Bush,Davidtown,Kenya,(803)074-2374x9631,001-441-257-0884,garrett61@gonzalez-welch.com,2020-03-09,https://www.schmitt.net/
02-Feb-2021,Commission,"1,836.00",00.00,"256,613.38",37EAd13bcB2af9E,7270,Kelli,Mccann,Gordon PLC,New Samantha,Timor-Leste,332.640.4453x584,(609)103-0269,loridiaz@cook.com,2021-06-05,https://www.mendoza.net/
02-Feb-2021,Cash,00.00,"36,659.05","219,954.33",aFD75E96E9a3d4e,1139,Grant,Patrick,Shepherd-Sherman,Carlyside,Uzbekistan,173-554-4085x7863,988.429.6615,aberg@sawyer-kim.biz,2020-08-29,https://www.hester.com/
02-Feb-2021,Bill,00.00,"73,318.11","146,636.22",B958dE9666cEaD9,964,Bobby,Pham,"Hill, May and Howell",Manningland,Niue,5100635002,(770)003-1509,whitneyjoan@chen.org,2020-12-28,https://anthony.com/
02-Feb-2021,Bill,00.00,"146,636.22",00.00,30e4F39fCD9d4bC,1133,Amber,Haney,Robertson-Hines,West Graceburgh,Aruba,(731)321-8580,249-558-3443x362,qwalters@farley.com,2021-06-21,http://www.castaneda.com/
02-Feb-2021,IMPS,08.00,00.00,08.00,D7a2a8bA28eD9d4,6295,Renee,Dennis,Winters-Nichols,Glendaberg,Aruba,(678)645-3658x839,(097)791-8520x616,krubio@wise-cruz.com,2021-04-03,https://www.murphy.com/
02-Feb-2021,Transfer,00.00,01.33,06.67,874fbaF8F4DE8BF,8819,Bethany,Dunlap,Delgado Group,Anitaborough,Turkmenistan,594-454-5947,354.655.3840x3099,jcantrell@nichols.com,2020-01-16,https://greene.com/
02-Feb-2021,NEFT,00.00,00.83,05.84,DCA6cFefcbd8e58,2286,Dan,French,Cooley-Campbell,East Sonya,Central African Republic,001-441-104-7842,726-148-9622x94527,cruzolivia@prince.biz,2020-01-15,https://farmer-rhodes.biz/
02-Feb-2021,Cash,30.30,00.00,36.14,cf5EfBBBcF9eDcb,7010,Sandy,Delgado,Pennington Inc,Maciasville,Uruguay,+1-562-318-0154x5624,544.070.9619x9515,mindy57@yu.com,2021-06-04,https://chambers-robertson.com/
02-Feb-2021,Bill,03.00,00.00,39.14,4528d6aBf2Aa4D3,7976,Paige,Hobbs,Valdez Group,Rebekahchester,Montserrat,+1-192-498-7362x89206,356-227-9021x9108,arivas@manning.com,2022-05-01,https://www.rasmussen.info/
02-Feb-2021,Debit Card,00.00,04.35,34.79,fe5fAbBDD1D2eFD,4930,Christie,Sandoval,"Harvey, Bauer and Weaver",East Roberto,Cyprus,892.912.7067,(178)155-2534x49676,emoran@shields.biz,2021-06-30,http://www.beard.biz/
02-Feb-2021,Cash,"7,040.69",00.00,"7,075.48",dEd3cA84E2baa77,8292,Brenda,Lowery,Fritz-Hodges,East Gracebury,Mali,(649)433-2277x68552,620.546.2797,hunteryolanda@oconnell-hess.com,2021-04-04,http://www.mahoney-mercer.com/
02-Feb-2021,Commission,00.00,707.55,"6,367.93",d1C9Ac510126AE5,5814,Melvin,Duran,"Barnes, Roman and Benjamin",Hickmanfort,Taiwan,332.072.8323x8464,(290)081-3408,patrickalec@clements.com,2021-01-27,http://osborn.info/
02-Feb-2021,ATM,00.00,"6,367.93",00.00,eD96b58cbf4aAC5,9057,Autumn,Sims,Guerrero and Sons,Lake Rebekahchester,Sierra Leone,+1-352-652-3975x765,(844)463-4376,qmccormick@walter.com,2021-12-13,http://wood-orozco.com/
02-Feb-2021,Cheque,31.80,00.00,31.80,63cEC09aC4FF8AD,2006,Ray,Carrillo,"Rojas, Boyer and Raymond",Alexaburgh,Australia,001-822-796-9773,746-521-3042x48329,abrewer@castaneda.biz,2021-04-05,https://www.salinas.com/
02-Feb-2021,Cheque,00.00,04.54,27.26,9De5a7C4F977Dec,4897,Traci,Oconnor,Hull-Ware,East Angelaberg,Bermuda,(151)089-3406x49727,(794)676-5425,diazchristie@garrett-rowe.info,2020-10-06,https://www.houston.org/
02-Feb-2021,Cheque,00.00,06.82,20.44,119a6EB0f60EcdB,3825,David,Miles,Welch-Whitehead,South Sherihaven,New Zealand,1137531857,(347)701-1618,paynetammy@mcmahon.info,2021-10-20,https://bullock-johnson.info/
03-Feb-2021,Transfer,00.00,02.04,18.40,A53CAeFdc9B8DdC,8461,Erica,Berry,"Heath, Pope and Todd",Evelynborough,Portugal,565.732.9748x94385,+1-379-242-9712x24350,gzimmerman@cunningham-bautista.com,2021-02-07,https://kaiser.com/
03-Feb-2021,RTGS,61.00,00.00,79.40,713bCf157CdeaF2,3164,Stacy,Hampton,Cochran-Bailey,Lauraside,Monaco,(956)942-9511x23972,495.999.9409,joan47@hanna.com,2021-09-20,https://simon-pineda.com/
03-Feb-2021,Purchase,"1,799.00",00.00,"1,878.40",a670EB5D36A72FF,5065,Margaret,Miranda,Johns Group,New Candacechester,Turkey,(656)745-6101x5035,977-999-8523x89664,evan43@perry.com,2021-09-16,http://www.rollins-levy.com/
03-Feb-2021,Bill,01.61,00.00,"1,880.01",1c8289ea71E97D9,2026,Kristopher,Tapia,Day-Mclean,Taylorshire,Faroe Islands,679.554.9438x394,+1-377-070-6392,nprince@small-mckenzie.com,2022-04-21,http://nunez.com/
04-Feb-2021,Debit Card,00.00,376.00,"1,504.01",fc9AFCc51BfEb04,5528,Daisy,Moon,"Sanford, Gallegos and Casey",Lake Tristan,Morocco,(415)335-2966x6505,(611)617-6637x156,steveosborne@hoover.com,2020-05-03,http://vincent-molina.com/
04-Feb-2021,Commission,00.00,188.00,"1,316.01",8a5C36aBc71ace2,8456,Darrell,Pitts,Callahan Group,Meyerfort,Saint Barthelemy,610.315.0468x7719,799.047.2687x8180,rreilly@ponce.info,2021-06-06,http://frazier.info/
04-Feb-2021,Commission,"4,611.20",00.00,"5,927.21",1B8c6b9a10BbfcD,3305,Rose,Atkins,"Maynard, Gates and Townsend",Lake Darleneshire,Bermuda,+1-249-870-7326,(215)905-1607x59620,wburch@martin.biz,2020-10-09,https://gilbert-watson.net/
04-Feb-2021,ATM,00.00,987.87,"4,939.34",1BdfeCFF1584a3A,9287,Maureen,Johnson,Vaughn PLC,Aliciaberg,Romania,529-723-6871x9311,001-385-542-6250,isaac80@mack.org,2020-03-05,http://www.meza-gentry.com/
04-Feb-2021,Reversal,00.00,823.22,"4,116.12",FCAAa5D90f2dC65,8943,Ralph,Gonzalez,Pham-Park,Port Jackson,Montenegro,(955)592-2996x37256,6380005245,kaitlinsutton@yang-werner.info,2021-11-19,http://www.hoffman.com/
04-Feb-2021,Tax,00.00,"2,058.06","2,058.06",0B94efF2fb312DE,6865,Bethany,Navarro,Chan Inc,East Melinda,Canada,(700)308-0722,016-323-4705x4912,hodom@oconnor-welch.com,2020-03-12,https://stewart.info/
04-Feb-2021,Cheque,38.50,00.00,"2,096.56",eFd88b7DFC290D8,7100,Steve,Ashley,Washington-Mejia,Soniaside,Australia,(607)586-7753,491-853-2516x6434,tristancollins@donovan.com,2022-01-16,https://bush.biz/
04-Feb-2021,Miscellaneous,00.00,232.95,"1,863.61",c7a44B5D4c44A33,273,Audrey,Levine,Franco-Berg,West Gregory,Mozambique,001-939-299-4393,122.214.6853x762,kristinemunoz@neal-kline.com,2022-05-29,http://oliver.net/
04-Feb-2021,Tax,00.00,621.20,"1,242.41",5EcDE0A0e5a8AC4,5326,Meredith,Villegas,Taylor-Watson,Kaylaside,Cameroon,+1-825-651-4114,001-522-400-7587x3572,tpeterson@wilson-fritz.info,2021-07-12,http://pugh-dunn.com/
04-Feb-2021,Reversal,00.00,621.21,621.21,10DeD27fdBF80f8,4243,Randy,Velez,Bright Group,South Shannonchester,Rwanda,660.669.0549x54895,+1-910-927-7756x1028,kendra58@levine-pittman.com,2021-05-12,http://www.reynolds-pittman.com/
04-Feb-2021,NEFT,00.00,88.74,532.47,0e5d94FC6778978,1853,Suzanne,Terry,Richmond PLC,South Elainetown,Angola,818.794.0389x82537,6719858432,sherry54@pitts-greer.com,2022-02-04,http://glenn-levine.com/
04-Feb-2021,IMPS,"2,204.00",00.00,"2,736.47",3AD32Dab554fcaD,1373,Kyle,Jefferson,Farley-Mcgrath,Lorettatown,Australia,435-303-9388x292,(703)354-0004x2229,natalie51@reid.com,2021-07-13,http://cole-melton.com/
04-Feb-2021,IMPS,00.00,390.92,"2,345.55",DBada96b18B3f8b,8443,Isabel,Nichols,Melton-Moody,South Ryanstad,Syrian Arab Republic,362.834.1012,831.756.2107x506,petersroger@henry.info,2021-02-10,http://mullen-moore.com/
04-Feb-2021,Debit Card,00.00,335.08,"2,010.47",5900F88dA25cFa5,1479,Sheena,Hughes,Hurst and Sons,Lake Walter,Syrian Arab Republic,+1-813-843-9655,679.277.8243,tonyagallagher@barajas-goodwin.biz,2022-01-11,http://franklin.com/
04-Feb-2021,Purchase,"2,542.00",00.00,"4,552.47",5C4Fb6f1184e16F,8745,Jerry,Sweeney,Mccarty PLC,Mossshire,Samoa,154.442.9260,+1-591-085-1250,mcdanielmelvin@jacobs.biz,2022-01-01,https://beard-maldonado.com/
04-Feb-2021,Cheque,00.00,"2,276.24","2,276.24",a40bC7dB8B2DdEa,8799,Tanya,Holmes,"Mooney, Everett and Hayes",East Kellieside,Syrian Arab Republic,001-437-227-6258x9743,594.141.8364,gregmunoz@greene.com,2021-11-15,http://le.com/
04-Feb-2021,Tax,00.00,325.18,"1,951.06",6d1adaC8060aEa6,7883,Stephanie,Preston,Gonzalez-Farmer,Birdside,Norway,001-624-487-5218x657,001-557-791-8630,cesar59@harrison.info,2021-11-01,http://hopkins.com/
04-Feb-2021,Cash,00.00,325.18,"1,625.88",3eC1Bfd767484E2,1158,Hailey,Pratt,Tran and Sons,Acevedobury,Belize,(334)568-8298x757,312.203.5970x1752,rick08@shepard.com,2022-02-16,https://stephenson-landry.org/
04-Feb-2021,Tax,00.00,203.24,"1,422.64",ff8f77B7BDEEF11,6131,Joanne,Love,"Graham, Anderson and Waller",South Chelseyville,Cuba,101-884-2079x856,177-052-6881,cfernandez@patel.org,2020-03-17,http://www.erickson.com/
04-Feb-2021,Cash,"50,895.59",00.00,"52,318.23",b0bFc35A998Ffcd,9088,Mark,Bennett,Martinez-George,South Mitchelltown,New Zealand,001-535-467-3408x2538,001-568-842-9114x2089,dmcguire@randall-mccarty.biz,2021-02-13,http://mcclain-wheeler.org/
04-Feb-2021,Miscellaneous,00.00,"26,159.12","26,159.12",8cbDABC6BCC2CC2,5286,Kerry,Soto,Harrington Ltd,Kristaborough,Marshall Islands,(500)218-4362,001-008-860-9135x3300,erussell@huerta.org,2021-03-10,https://cherry.com/
04-Feb-2021,Bill,"10,525.79",00.00,"36,684.91",0Dff6c27C8049C4,5539,Chris,Buck,Bowman-Bowen,South Edgarberg,Gambia,948.512.2454x11348,001-472-421-9145x827,damon10@clarke.com,2020-09-29,http://www.santos.biz/
04-Feb-2021,Tax,"173,984.50",00.00,"210,669.41",6C46A6bdd0dedfE,9727,Terrence,Galloway,Wang-Cochran,Haileybury,Greece,(065)231-8902,(761)006-6529x44738,clinton57@gallegos-franklin.biz,2020-09-02,http://houston.info/
04-Feb-2021,Bill,00.00,"42,133.88","168,535.53",fdCdfE6f31839E4,2440,Stefanie,Pollard,"Horne, Roberson and Gates",New Angiefort,Equatorial Guinea,173-281-4412x87406,001-836-526-9692x75900,spearscurtis@rich.com,2021-12-28,https://henson.org/
04-Feb-2021,ATM,00.00,"84,267.77","84,267.76",dcCbdebbfedbf5E,8653,Lance,Brown,Santiago Ltd,New Derekport,Tajikistan,306.206.6517,772.985.2111,bellbryan@watson.net,2021-10-10,https://contreras.org/
04-Feb-2021,Interest,"102,106.66",00.00,"186,374.42",E6B6Dbd1cCCB900,1849,Meghan,Trevino,Pearson-Brooks,Port Edwardhaven,Honduras,+1-578-346-4552x90051,2012428909,geoffreyguzman@pace.com,2021-06-01,https://larsen.com/
04-Feb-2021,NEFT,426.97,00.00,"186,801.39",Ba834EbDCd37b69,8478,Elaine,Jimenez,"Dean, Burgess and Jennings",Lake Ariel,Malaysia,964.994.0939,+1-268-331-9307,mccalltasha@kelly.org,2021-05-10,https://waller-conner.com/
04-Feb-2021,Purchase,"152,840.00",00.00,"339,641.39",b9B3B5f1ba40FD3,28,Roberta,Walton,"Lamb, Little and Frazier",Campbellshire,Tonga,805-974-3346x026,001-324-540-6599x3227,sharigriffin@cameron.com,2020-11-15,https://quinn.biz/
04-Feb-2021,ATM,00.00,"113,213.80","226,427.59",AE642068F9eBAa4,9466,Rose,Francis,Salazar PLC,Farmerberg,Senegal,(870)390-1588x755,+1-862-571-8518x49957,iperkins@macias.info,2020-12-26,http://bennett.com/
04-Feb-2021,Miscellaneous,00.00,"22,642.76","203,784.83",5fBDE5cDc5F4B96,3499,Angel,Kim,Fox-Conrad,Thomasshire,Oman,635.882.8193x809,001-406-615-9671x81681,tomhall@kline.com,2021-08-25,http://www.grant.com/
04-Feb-2021,RTGS,"4,882.00",00.00,"208,666.83",AF7C4EBeE64CbbF,2850,Eddie,Kidd,"Thomas, Dudley and Glenn",Larrychester,Cook Islands,364-921-2231,001-571-418-4859,qballard@golden.com,2020-11-28,https://dawson.net/
04-Feb-2021,ATM,261.60,00.00,"208,928.43",f2BDB1FdA5a7b3e,4132,Tara,Hensley,Mosley Group,East Susan,Papua New Guinea,633-333-2193x1792,(783)388-5277,kaufmankristie@thornton.org,2021-10-04,http://hays.biz/
04-Feb-2021,RTGS,26.00,00.00,"208,954.43",7741E98D0D5ED12,4941,Clifford,Sanchez,"Shaw, Little and Jordan",South Tyler,Mauritius,5208128451,001-328-765-1610x286,hvincent@hatfield.org,2021-12-16,https://www.benson-schneider.com/
04-Feb-2021,Cash,02.73,00.00,"208,957.16",8CA866F85c97Ea1,5016,Catherine,Gillespie,"Wagner, Wheeler and Sims",North Tiffanyside,Canada,+1-166-249-7741x708,100.752.2115x46235,zmaynard@chan.net,2020-04-18,https://santiago-buckley.net/
04-Feb-2021,Commission,00.00,"23,217.46","185,739.70",1B8c6b9a10BbfcD,3305,Rose,Atkins,"Maynard, Gates and Townsend",Lake Darleneshire,Bermuda,+1-249-870-7326,(215)905-1607x59620,wburch@martin.biz,2020-10-09,https://gilbert-watson.net/
04-Feb-2021,Debit Card,"60,552.75",00.00,"246,292.45",26DA623bcf8BFB2,1806,Joy,Mercer,Cain-Smith,Johnnyview,Cote d'Ivoire,(429)672-7636x6097,944-407-6115x221,maysalyssa@preston-whitaker.com,2020-11-14,http://www.hanna-butler.net/
04-Feb-2021,Cheque,00.00,"82,097.48","164,194.97",b24f6baAB432DAf,2921,Amy,Duran,"Bird, Moreno and Griffin",Kochtown,Switzerland,001-001-002-8164x33186,1214411111,nancymccoy@gates.com,2020-04-13,http://hester-randolph.com/
05-Feb-2021,RTGS,00.00,"27,365.83","136,829.14",3aBe7dd22e1ecD6,2185,Sherry,Boyer,"Marshall, Bell and Hooper",North Amanda,Haiti,(790)258-2066,723-043-1374,bobbywilcox@hamilton.com,2020-06-23,https://pace.com/
05-Feb-2021,Debit Card,"195,150.00",00.00,"331,979.14",796aefD7c70afB0,6297,Sally,Richards,"Stevenson, Hawkins and Davidson",Port Ronald,Saint Martin,001-291-218-1573x511,504.439.5574x43515,ohubbard@deleon-christian.biz,2021-06-25,http://arellano.com/
05-Feb-2021,Miscellaneous,126.70,00.00,"332,105.84",CAbcF4c6fE2cEf2,5280,Richard,Schultz,Lynch LLC,Josephmouth,Nepal,219-477-1573,984-327-2891x97174,lisamurray@dickson.com,2020-08-24,https://www.gutierrez.biz/
05-Feb-2021,Transfer,"1,861.60",00.00,"333,967.44",5ECED0624DD7BE6,7077,Todd,Valdez,Cochran-Moon,Lake Eric,Gambia,(642)208-7661,503-762-3605x14887,qwilliamson@lozano.com,2021-04-23,https://www.barron.org/
05-Feb-2021,NEFT,"663,201.00",00.00,"997,168.44",75eff8a1c363EAe,2460,Xavier,Gordon,Woods PLC,Navarrobury,Andorra,460-020-7429x110,(400)001-5850x0976,rebeccaestrada@mooney-blackburn.net,2021-07-24,https://www.ford-pruitt.com/
05-Feb-2021,Transfer,"71,995.00",00.00,"1,069,163.44",DbE634fd0B4d8FC,1240,Larry,Sawyer,"Mccall, Padilla and Woodward",Port Carrie,Bulgaria,001-615-631-4552x37599,(353)522-3641x7791,cholder@mccarty.com,2021-08-14,https://burke.com/
05-Feb-2021,Commission,00.80,00.00,"1,069,164.24",dea3eFB3b564FEe,8238,Dean,Dyer,Ryan PLC,Chenfurt,Barbados,(093)320-7714,6264712740,marc69@duran.org,2020-04-19,https://johnston-wong.info/
05-Feb-2021,Commission,"21,567.70",00.00,"1,090,731.94",C95a2de9dFF4deD,3652,Kristy,Reyes,Figueroa-Tran,Lake Faith,Tokelau,+1-594-344-4775,001-093-497-0068x119,tiffanymendoza@austin.com,2021-01-07,https://www.huff.biz/
05-Feb-2021,Purchase,"2,879.60",00.00,"1,093,611.54",bc10ba4Cab8b40b,6936,Jasmin,Murray,Oconnell and Sons,Vasquezshire,Cook Islands,477-615-4596x99764,4941157139,scottdawn@acevedo.biz,2021-12-30,http://knox.info/
05-Feb-2021,Debit Card,00.00,"273,402.89","820,208.66",F03CDdbA130cbC5,3647,Felicia,Ibarra,Rice PLC,Mcdowellland,Bermuda,391-670-0450x854,287-968-6889,maurice76@kennedy.com,2020-12-13,http://lucero.com/
05-Feb-2021,Cheque,00.00,"91,134.30","729,074.36",BCd7aF1A59a4BDf,1543,Martha,Frazier,Mcdaniel-James,Beasleyshire,Montserrat,001-686-239-6091x3847,244.269.6291x4797,marcofloyd@castaneda.com,2021-08-01,http://patterson.com/
05-Feb-2021,Interest,"137,224.94",00.00,"866,299.30",48C91ABB48c74eF,5292,Connie,Zavala,Carrillo PLC,Farleyberg,Ghana,554-641-3220,+1-334-832-7140x942,oblake@ramos.net,2021-05-21,http://glenn.com/
05-Feb-2021,RTGS,"465,479.20",00.00,"1,331,778.50",cEe6Db2E326c78e,933,Chad,Nguyen,Sullivan-Cline,Lake Joanne,China,(765)971-5674,+1-535-486-3537x158,glenda75@gay.org,2021-10-14,https://www.donovan-pruitt.biz/
05-Feb-2021,Transfer,00.00,"147,975.39","1,183,803.11",68a17341d8242d4,6218,Anna,Rice,Faulkner-Boyer,Billymouth,Madagascar,(442)960-3423x8782,001-790-654-0861,brentedwards@riley-craig.com,2022-02-06,http://www.bullock.com/
05-Feb-2021,RTGS,00.00,"169,114.73","1,014,688.38",f2AF1ECB3F7E5DA,4460,Jonathon,Glover,Kelley PLC,Nguyenport,Marshall Islands,063.375.9723x160,2526554719,treeves@cervantes-houston.com,2022-05-25,http://petty.info/
05-Feb-2021,Interest,00.00,"202,937.68","811,750.70",9dc1Ede2996A2E2,7802,Nichole,Lynn,Schmitt-Gallagher,New Warren,Pitcairn Islands,+1-423-849-5717,+1-930-498-6087,kelleyjared@kline-velasquez.info,2020-12-08,http://www.parker.com/
05-Feb-2021,Commission,00.00,"81,175.07","730,575.63",05d0BBD8588dc21,9538,Randall,Chung,Daniel-Stuart,Rileyhaven,Mali,429-485-7232,+1-316-077-0083x122,jonbright@conway.org,2020-09-15,http://www.payne.biz/
05-Feb-2021,ATM,768.90,00.00,"731,344.53",52860F8FF6EDC10,6482,Gregg,Fleming,"Mcneil, Page and Huber",East Sarahmouth,Burundi,(167)325-4980,6401499215,breannasaunders@hull.biz,2020-04-12,http://bridges.com/
05-Feb-2021,Cheque,00.00,"81,260.50","650,084.03",3ACcE1d8aBB63ae,84,Francisco,Stanley,"Brewer, Trevino and Key",Rickeychester,Italy,001-090-771-1995x209,198.341.1742,charlottemercer@hensley.net,2020-12-12,http://watson-frye.org/
05-Feb-2021,Purchase,01.00,00.00,"650,085.03",B9EDf9fE373df4d,1376,Gerald,Salinas,Moore and Sons,Micheletown,Montenegro,+1-622-637-0984x117,(957)190-5716,tcardenas@koch.com,2021-09-02,http://craig.biz/
05-Feb-2021,ATM,88.21,00.00,"650,173.24",Af1431b64FE4DBF,2527,Riley,Dawson,Melton-Pratt,Jesseland,Puerto Rico,0825578960,294-485-3943x0744,savannah09@trevino.com,2021-04-23,http://www.stokes.com/
05-Feb-2021,Debit Card,00.00,"108,362.21","541,811.03",B2DC6ad9e8bFff9,8557,Dan,Ortiz,"Mcpherson, Montgomery and Khan",Lake Dariustown,Togo,(937)468-6840,159-618-8218,villanuevadakota@bowers-lopez.com,2022-01-25,http://www.morse.com/
05-Feb-2021,NEFT,"22,945.42",00.00,"564,756.45",27BA6ccF0BD9233,5355,Geoffrey,Vang,Bonilla and Sons,Patelborough,Swaziland,001-922-835-4371x63464,(117)307-4642,sergio33@hicks-cantrell.com,2020-07-23,https://peters.com/
05-Feb-2021,Purchase,06.00,00.00,"564,762.45",C9bFa849Cd1DeEe,7292,Helen,Weiss,"Sweeney, Newman and Guerra",South Bryce,Antigua and Barbuda,+1-545-223-7038x98874,389.415.3502x7264,lancemayer@webster.info,2021-12-15,http://pope.com/
05-Feb-2021,Cash,00.00,"282,381.23","282,381.22",f63cA54Cbf5BeB8,1130,Dwayne,Franco,"Ritter, Spence and Kennedy",Branchtown,Congo,001-950-344-0425x59543,5346033317,lauriespears@li.biz,2021-05-26,http://www.zimmerman-grant.com/
05-Feb-2021,Cash,"162,922.20",00.00,"445,303.42",Ad405181e191d0A,4108,Brianna,Foster,"Huffman, Ho and Donovan",West Alan,Seychelles,001-001-173-6754x9928,+1-007-396-9733x8672,christine15@nash.com,2021-12-27,https://hood.com/
05-Feb-2021,Interest,07.00,00.00,"445,310.42",34616EE42FC1aeA,1421,Norma,Alvarez,Wyatt Ltd,New Melvinborough,Japan,774.852.8761x78970,565-081-2471x5617,ruizrichard@york-cummings.org,2021-02-22,https://alexander.net/
05-Feb-2021,Reversal,56.30,00.00,"445,366.72",F9defC2B8cEBA63,1195,Cory,Bridges,Gonzales PLC,West Savannahburgh,Jamaica,001-195-532-0285,(561)226-1826,heathshirley@porter.org,2022-02-09,https://www.bryan-hanson.biz/
05-Feb-2021,Cheque,00.00,"148,455.57","296,911.15",1c5515fEee8Cbb2,4352,Melinda,Schaefer,"Wilkinson, Matthews and Sparks",West Gwendolynview,Indonesia,001-996-020-8027x04528,673.882.8623x50601,stacy46@pham.biz,2021-07-14,https://cameron.com/
05-Feb-2021,Debit Card,"5,953.95",00.00,"302,865.10",6Cde3D5c15dbDCe,4672,Julian,Lane,Garza Group,Lake Maxwellberg,Hong Kong,001-096-796-9549x86258,6541939945,cabbott@adkins.com,2021-08-31,https://www.davenport.org/
05-Feb-2021,Purchase,04.93,00.00,"302,870.03",F68078d5c9c908c,588,Anita,Banks,"Proctor, Edwards and Schaefer",Lake Robinberg,Moldova,(797)436-0495x973,001-325-431-2689x6612,toni29@figueroa.net,2021-02-12,https://www.dalton.info/
05-Feb-2021,Debit Card,"206,989.80",00.00,"509,859.83",9Dd78C7bb9E6C6a,1928,Dana,Ross,"Hayes, Holder and Russo",Lake Ellen,Hong Kong,+1-808-176-3957,329.153.2849,marie53@bell.com,2022-01-18,https://mcgrath.info/
05-Feb-2021,IMPS,04.36,00.00,"509,864.19",7fddda3cf7AeDFC,5560,Kristina,Fernandez,Mcpherson Group,East Rossmouth,Pitcairn Islands,257.714.7910x724,390.740.9042,maynardroberta@wagner-conley.org,2020-09-20,http://lee.com/
05-Feb-2021,Commission,03.00,00.00,"509,867.19",8b7fA1F50B94E8a,3615,Mia,Woods,Robinson-Turner,North Yvetteview,British Indian Ocean Territory (Chagos Archipelago),(312)361-6998,001-401-693-4463x5674,diana58@cherry.com,2022-04-01,http://www.ibarra.com/
06-Feb-2021,Transfer,51.58,00.00,"509,918.77",D87D3D0fcBc316E,3494,Levi,Ayala,"Byrd, Patton and Hunt",Connorside,Saint Helena,583.895.8012x043,001-170-631-5575,alyssa63@cooley.org,2020-01-03,https://www.oneill.biz/
06-Feb-2021,Debit Card,00.00,"56,657.64","453,261.13",Ba0BCdd5AAd0116,3350,Marisa,Sherman,Aguirre Inc,Littleside,Guam,083.324.4044,478.614.1773,kent43@booker.com,2022-05-23,http://www.silva.org/
06-Feb-2021,Transfer,00.00,"75,543.52","377,717.61",2edacB92F81e27D,2050,Alfred,Hunt,Gallegos-Owens,Gwendolyntown,Bouvet Island (Bouvetoya),+1-477-518-6436,(702)814-2423,sherrymoore@jones.biz,2021-08-21,http://www.hart.com/
06-Feb-2021,Tax,00.00,"188,858.81","188,858.80",C9fdCfd4f9147b1,5888,Lucas,Gonzalez,"Garcia, Watson and Vargas",Lake Kentfort,Germany,+1-412-178-9139x94957,+1-219-271-4331x85034,laura58@schwartz.com,2020-11-14,https://heath.biz/
06-Feb-2021,Miscellaneous,07.70,00.00,"188,866.50",8CBDFfF1C1ddCE8,7524,Daryl,Bishop,"Hale, Wright and Howell",Feliciaport,Fiji,(060)115-9600x51228,830.574.6174x0199,brittany02@blevins.info,2021-04-27,http://webb-cabrera.com/
07-Feb-2021,Commission,02.20,00.00,"188,868.70",dD4be1A5bef3FA2,9716,Diamond,Gaines,Webster-Schaefer,East Gina,Maldives,215-788-0180x4567,(791)687-8276,ernestluna@hays-ford.com,2020-02-14,https://www.hess.org/
07-Feb-2021,Debit Card,27.40,00.00,"188,896.10",d01d145cF86a08E,7478,Cheyenne,Acevedo,Barr-Russo,West Jennifer,Swaziland,001-795-120-9211,+1-421-853-0440x7378,krichard@maldonado.com,2020-09-06,https://www.howard.com/
07-Feb-2021,Cheque,16.20,00.00,"188,912.30",A453aC0a6757a06,4963,Shelia,Yang,"Lloyd, Horn and Cooke",Joycehaven,Ghana,+1-685-873-6646x46619,(126)375-8186x232,ryan81@hull-chung.info,2021-12-24,http://www.garrett-gardner.org/
07-Feb-2021,NEFT,"254,231.00",00.00,"443,143.30",FB358C9e5bC0E12,2188,Jackie,Becker,"Ramos, Bryant and Goodwin",West Shane,Brazil,001-911-744-0581,001-070-356-5674x587,haguirre@cherry.com,2021-01-13,http://www.reese.com/
08-Feb-2021,Debit Card,"656,799.50",00.00,"1,099,942.80",5D24eb6c7Ba0fBe,7342,Marilyn,Chen,Morton-Sampson,Cynthiaside,Belize,980.756.5889,337.611.5560x24375,brendaandersen@spence-galvan.com,2021-06-15,https://www.hatfield.com/
08-Feb-2021,Miscellaneous,00.00,"549,971.40","549,971.40",85cF0BA71aE67Ec,9313,Dustin,Weeks,Malone-Gallegos,New Chelseybury,Taiwan,+1-707-832-8459,(595)866-7925x94944,crodgers@griffith-barnett.com,2021-04-13,http://hanson.com/
08-Feb-2021,Transfer,00.00,"549,971.40",00.00,5bC6960fD8ca2FF,6271,Harold,Chavez,Kirk-Winters,South Jeremy,Kazakhstan,7380099118,995-985-4774,dominicholloway@wilkinson.com,2021-01-19,http://flynn-wright.com/
08-Feb-2021,Cash,"1,165,996.75",00.00,"1,165,996.75",0929F53A08faE52,6472,Tanya,Fuentes,Leonard-Hunt,Bobtown,Grenada,+1-302-340-3595x5894,(824)151-9119x448,isaiah58@burke.com,2021-09-08,https://hanson-wiley.com/
08-Feb-2021,Commission,00.00,"1,165,996.75",00.00,cE0dCc874eA67b2,8591,Caroline,Reyes,Woodard-Bishop,Royville,Namibia,988-953-9872x22505,507.418.2137x080,pottsralph@gregory.info,2020-11-28,https://doyle.com/
08-Feb-2021,Purchase,"15,202.50",00.00,"15,202.50",b75E87B928b86F7,2056,Connor,Maxwell,"Abbott, Frost and Baker",South Daltonside,Macedonia,693-127-6264x51440,001-611-034-4488x20528,conradbrittney@brennan.com,2021-01-19,https://www.decker.com/
08-Feb-2021,Commission,"17,594.80",00.00,"32,797.30",5b0E47FbaaFBc07,3319,Dennis,Dickson,Mays-Henderson,West Kelliestad,Mali,+1-473-592-5124x06090,309.312.2166x5489,dariusschmitt@moyer.info,2021-04-18,http://sweeney.org/
08-Feb-2021,Miscellaneous,00.00,"4,099.66","28,697.64",d2adD39063FfDFA,4482,Janice,Hart,"Mcconnell, Buckley and Hawkins",West Ivanberg,Suriname,(991)324-1380x56561,3983976026,howardvictoria@blake-sandoval.com,2020-09-11,http://obrien.biz/
08-Feb-2021,Cheque,00.00,"4,099.66","24,597.98",40debCb4B2cEdd5,8342,Mallory,Baker,"Gonzalez, Solis and Hahn",Gomezport,Brunei Darussalam,447-924-9294,166-838-2173,samuel47@eaton-odom.com,2020-10-28,http://patterson.com/
08-Feb-2021,NEFT,01.10,00.00,"24,599.08",b1BabAFCce090F5,9791,Alejandro,Cameron,Richardson Ltd,Louisburgh,Senegal,426.235.9969x94451,(317)642-6419x2108,alan20@willis.org,2021-02-12,https://www.gallegos.com/
08-Feb-2021,Cash,38.50,00.00,"24,637.58",A4Ef3Aa048c01Ba,2920,Helen,Mercer,Gaines Inc,Mcclurebury,Peru,605-520-0709x3077,259-534-8034x865,kellerkevin@hancock.biz,2021-02-25,http://bowman.biz/
08-Feb-2021,Transfer,00.00,"4,927.52","19,710.06",cdF6EaBC23a6a74,1524,Yvette,Swanson,Stanton LLC,Ramosville,Cyprus,+1-706-625-8482,487.262.9612x77342,floydhayley@salazar-wyatt.com,2021-08-12,http://pope.biz/
08-Feb-2021,Reversal,83.71,00.00,"19,793.77",7FDE65Cbdd11a44,7246,Rodney,Montoya,"Oconnell, Lowery and Hardin",Butlertown,Ireland,(993)041-5889,001-893-984-1838x89399,bakerbenjamin@levy.info,2021-11-29,http://trujillo-hart.com/
08-Feb-2021,RTGS,277.00,00.00,"20,070.77",6f3C5BF3AC545e8,2810,Nichole,Gordon,Evans-Gaines,Lake Caroline,Ecuador,7910388252,(634)903-8529x5615,vaughanmarissa@sutton-carter.com,2020-02-16,http://parsons-david.net/
08-Feb-2021,Cheque,"159,045.20",00.00,"179,115.97",fA498A48FAb17c7,9858,Howard,Burns,Munoz-Hess,East Kirk,Mexico,647-501-5913x7537,575-083-0672x26431,fullerdavid@morris.org,2020-11-27,http://www.yu-warner.net/
08-Feb-2021,Commission,00.00,"19,901.77","159,214.20",Ea33ba8301E32A6,5148,Debra,Barton,Woods and Sons,North Isaiah,Iceland,753.677.1581,(096)081-3073x9202,danielbaird@powers.info,2020-06-08,http://skinner.biz/
08-Feb-2021,Transfer,00.00,"22,744.89","136,469.31",629dfFD48c4fCC4,8751,Cassidy,Quinn,"Bradford, Melton and Ryan",Petersenville,Niger,388-096-4068x4828,+1-786-742-8118x218,ebonypollard@huang.biz,2020-10-02,https://cervantes.org/
08-Feb-2021,Purchase,00.00,"136,469.31",00.00,AD11aee28Ecc768,413,Jasmine,Brennan,"Conway, Jones and Morton",Charleneview,Tunisia,561.311.5283x5492,398-406-9441x95528,uarroyo@david-greer.net,2021-07-15,http://www.zuniga.com/
08-Feb-2021,Purchase,06.89,00.00,06.89,02a56F66FeafFcC,8823,Alan,Shah,Herring PLC,Simonland,Switzerland,697-900-0698,001-222-057-9930x53820,glenda65@scott.info,2022-03-20,https://johns-graham.net/
08-Feb-2021,Debit Card,00.00,06.89,00.00,D69C3ef77AbD0eC,6894,Lee,Glenn,Levy PLC,Virginiahaven,Mozambique,825.540.6318x10917,001-186-903-6412x18707,jaclyn71@wright.org,2020-02-20,https://www.morrison.info/
08-Feb-2021,Reversal,117.00,00.00,117.00,1fE2c9DfEa1bF3a,1319,Randy,Morton,"Colon, Compton and Booth",Port Carolborough,Bahrain,562.780.1287,001-568-013-2710x69644,mortonjermaine@hogan.com,2022-03-06,http://peterson-glenn.org/
09-Feb-2021,Debit Card,00.00,14.63,102.38,6Fb7235659198CA,5271,Darren,Odom,"Stark, Fuentes and Bowman",Brooksside,Puerto Rico,+1-152-741-4962x8751,+1-307-352-9643x940,travis78@hart.com,2020-07-03,http://www.santos.org/
09-Feb-2021,Transfer,00.00,51.19,51.19,BCAba51C23BB78C,1598,Kristin,Estes,Miles-Benson,East Maureen,Iceland,+1-049-168-1943x525,378-955-3678,timothystrickland@jefferson-mendez.net,2021-12-26,https://www.moon.org/
09-Feb-2021,Miscellaneous,"1,256.90",00.00,"1,308.09",ad211Ff2f681dE3,4062,Brianna,Petersen,"Bridges, Sanchez and Booker",New Susanburgh,Guernsey,+1-733-192-1507,768.736.7555,rthompson@farrell.com,2021-12-05,http://logan-lindsey.com/
09-Feb-2021,Tax,"9,767.50",00.00,"11,075.59",bFdD0b5D6Be5Ee4,2270,Priscilla,Levy,"Esparza, Andersen and Lawson",Laceyfurt,Armenia,352.638.6484,426.158.8556x8280,rbentley@spears.com,2021-02-24,https://dunlap.com/
09-Feb-2021,Bill,"1,565,137.25",00.00,"1,576,212.84",b4A0E5970e6aaEc,8217,Lonnie,Murphy,Oconnor-Sosa,Ochoaville,Turkmenistan,+1-992-650-8164x2863,001-610-107-7255x419,sherry78@barker.com,2021-04-14,http://www.klein-kane.biz/
09-Feb-2021,ATM,00.00,"788,106.42","788,106.42",3AfeC7207388B4F,570,Roy,Estes,Thompson Group,South Cesarbury,Cote d'Ivoire,+1-282-022-7311x33918,+1-722-227-3754,wdennis@marks-russell.com,2020-12-18,https://www.cohen.net/
09-Feb-2021,RTGS,"3,481.70",00.00,"791,588.12",2dcAAA283976E4E,8408,Daryl,Henderson,Evans-Burch,Gavinton,Vietnam,(730)000-0475x640,001-221-019-6311,shortkirsten@bowman.com,2020-11-02,http://www.pruitt.org/
09-Feb-2021,Cheque,"7,586.00",00.00,"799,174.12",A60B00ABddD66dD,4552,Gilbert,Ritter,Burns Group,West Vickie,Malawi,274.566.3324x21147,195-049-0364,sergio92@hansen-moss.info,2020-09-21,https://www.koch.com/
09-Feb-2021,Reversal,00.00,"114,167.73","685,006.39",867edfaeeBDbdCB,2923,April,Davila,Dalton PLC,Port Teresamouth,Switzerland,(429)457-8232x43601,(576)596-6522x7757,jocelynmathews@terry-mclaughlin.com,2020-11-06,http://mcdonald.com/
09-Feb-2021,Debit Card,00.00,"685,006.39",00.00,e4D9C5bcfA4b0E3,8118,Joel,Conley,Richards-Saunders,East Aimee,Saint Lucia,982.423.5836x695,179.824.6309,ninaortega@guzman.com,2020-06-11,https://www.thornton.com/
09-Feb-2021,RTGS,13.00,00.00,13.00,a98DeC0AB3Ce7Ea,958,Victoria,West,"Holden, Mcfarland and Caldwell",West Caseytown,Macao,(728)693-4921,001-228-911-7240x03151,roymarvin@bright.com,2020-04-29,https://bartlett-hines.com/
09-Feb-2021,Commission,403.00,00.00,416.00,48A5EAA875822FB,3206,Teresa,Sanford,Villanueva PLC,West Jeanettemouth,Guinea,011.270.8410,5683857488,iperez@fuentes.org,2020-01-02,https://www.moyer.biz/
09-Feb-2021,Purchase,00.00,208.00,208.00,f8bbb7D9Fa1dA73,2792,Angelica,Adams,Watson Ltd,West Darylburgh,Ecuador,001-926-923-2649,157-018-7616x288,kimberly94@valdez.com,2020-10-12,https://gordon.com/
09-Feb-2021,Purchase,60.00,00.00,268.00,B1Cbd3b8810b78c,7987,Natasha,Kidd,Hill-Hendricks,East Haydenville,Tuvalu,852-220-0484,001-372-352-4399,patelshannon@wyatt.info,2022-01-22,https://daugherty.com/
09-Feb-2021,Miscellaneous,05.60,00.00,273.60,3cAbe3aaCbc9eb9,1355,Suzanne,Landry,Pittman LLC,New Mario,San Marino,(640)966-8261,158-686-4225,tbowen@foster-soto.info,2022-01-19,https://www.paul.com/
09-Feb-2021,Reversal,00.00,39.09,234.51,1C69de8ACc7de36,1221,Cassie,Levine,"Allen, Webster and Reed",Lake Mia,San Marino,378.001.5435x58422,+1-264-536-1967x759,snoble@ward.com,2020-11-21,http://www.hudson.net/
09-Feb-2021,Purchase,00.00,33.50,201.01,A4FEeDAABDC088D,7668,Ariana,Kerr,Carney Inc,Jacobsonburgh,Saint Pierre and Miquelon,+1-278-343-3039x3432,001-403-397-5235x782,oneillbelinda@hodges.com,2020-07-20,https://chandler.biz/
09-Feb-2021,ATM,"120,945.50",00.00,"121,146.51",b1c4F3fA04D5d6a,1327,Caroline,Harding,Hardy and Sons,West Franciscoview,Zimbabwe,327-833-2164x340,346.973.4578x2525,kendra51@pratt-gibbs.com,2020-01-24,https://www.chambers-ray.info/
09-Feb-2021,Transfer,00.00,"121,146.51",00.00,F9c1B6BfadA0eF8,6479,Colleen,Allison,"Beck, Price and Rasmussen",Kingmouth,Saint Kitts and Nevis,053-001-3462x337,269-488-3497x4822,wwillis@mcclure.net,2022-05-29,http://poole-cline.com/
09-Feb-2021,Cash,"20,202.20",00.00,"20,202.20",A6c0BaFbd38Bdce,6657,Christian,Carney,"Harrell, Carr and Tran",Bettyborough,French Guiana,+1-560-075-2040x02447,(288)777-0688,nparsons@hernandez.com,2021-06-03,http://diaz.org/
09-Feb-2021,Tax,04.03,00.00,"20,206.23",A6Dd3dB5bA44D3e,6165,Brian,Mccormick,"Foley, Cortez and Durham",Natashaland,Angola,001-545-162-9350x33238,316-806-7075x645,wwatts@dalton.com,2020-02-10,http://www.mcpherson-fischer.biz/
09-Feb-2021,Reversal,"217,975.00",00.00,"238,181.23",8D6e62B960eb3E5,6089,Dawn,Crosby,Randall-Hogan,Eugeneshire,Tonga,+1-942-610-8769x16692,027-655-8278,janet51@weeks.com,2021-01-31,http://www.crosby.com/
09-Feb-2021,Purchase,"2,736.27",00.00,"240,917.50",3FdFa713B9AF4Ea,6051,Gabrielle,Baldwin,"Kerr, Riggs and Stone",North Lonnieport,Brunei Darussalam,001-844-781-0565x2178,664-731-7066,garycarr@shea.com,2021-12-21,http://mccullough.com/
09-Feb-2021,Reversal,00.00,"60,229.38","180,688.12",3B49CEBA7cf85bA,9918,Sally,Stephens,Weber-Whitney,Robertaside,Brunei Darussalam,(408)640-1653x78247,(085)243-7158x2466,xhamilton@berger.com,2020-08-18,http://padilla.com/
09-Feb-2021,Transfer,"1,538,208.00",00.00,"1,718,896.12",B5eE5EcF91B2B99,8516,Ruth,Randolph,"Wu, Joseph and Brock",Krauseberg,Anguilla,(169)874-3455x69641,821-503-2205,carmenbates@larsen-maddox.info,2021-12-09,http://gallagher.com/
09-Feb-2021,ATM,437.56,00.00,"1,719,333.68",6ba0BC5c67eCDD0,196,Amanda,Harper,"Trevino, Lam and Brewer",Lake Kylie,Chad,331-372-4188,287.106.6090x069,fieldskelly@blackburn.biz,2020-03-22,http://macias-duffy.com/
09-Feb-2021,NEFT,00.00,"343,866.74","1,375,466.94",Cef3AEf6c0e66FF,795,Tracey,Costa,Harmon-Graves,East Brendanbury,New Caledonia,611-021-3027x21053,440-140-6605,qrandolph@poole.com,2020-03-09,http://www.lawrence.com/
09-Feb-2021,Interest,00.00,"229,244.49","1,146,222.45",c2169620C14FaC3,9948,Warren,Jefferson,"Lowe, Sherman and Martin",North Ebony,Guam,001-539-455-1269x769,(300)721-1331,huynhisabel@cantrell-patel.com,2020-12-13,https://www.robinson-snow.biz/
09-Feb-2021,Purchase,"786,499.25",00.00,"1,932,721.70",8C0AEc5Ad5BfAEa,3514,Curtis,Sutton,Watkins-Knapp,Morganton,Madagascar,001-887-654-8828x33911,105.987.8893,ghester@dixon.info,2020-09-19,http://ramirez-payne.com/
09-Feb-2021,Commission,"169,989.60",00.00,"2,102,711.30",fEC7be95D19Dff1,6116,Anthony,Rosario,"Casey, Chen and Cohen",Sanfordbury,Kuwait,+1-880-918-2856,970.717.1234,conniewu@erickson.org,2021-11-25,http://www.frost.biz/
10-Feb-2021,Interest,05.50,00.00,"2,102,716.80",aace2C6eB3d41D2,219,David,Simpson,"Peterson, Maldonado and Daugherty",Elliotthaven,Taiwan,742.257.1474x049,(177)558-2199,knappalisha@franco.org,2020-03-01,http://www.robbins.biz/
10-Feb-2021,Transfer,00.00,"300,388.11","1,802,328.69",F23FB38aFc8ccdE,2763,Alejandra,Rush,"Dyer, Brennan and Fox",Matthewtown,Central African Republic,001-707-059-5715x742,750-201-9438,billarroyo@nielsen.com,2020-08-17,http://www.mckinney-mcclain.biz/
10-Feb-2021,Purchase,00.00,"1,802,328.69",00.00,FFC3CEF8f775799,7052,Jill,Branch,Heath-Pearson,Lake Trevor,Equatorial Guinea,399.826.9583x30860,(843)973-9485,clarkcathy@booth-barker.com,2021-09-08,http://norris.com/
10-Feb-2021,IMPS,"1,832,184.00",00.00,"1,832,184.00",48553D4dd081a54,5767,Cesar,Gillespie,"Howe, Baldwin and Summers",Sheriton,Wallis and Futuna,001-085-373-3573,990-351-5658,joycecaldwell@maxwell-delgado.com,2020-10-22,http://www.krueger.biz/
10-Feb-2021,IMPS,00.00,"305,364.00","1,526,820.00",9C0c46fD2Dc3193,8704,Sheri,Holder,"Randolph, Simpson and Oconnor",East Molly,Botswana,(058)581-8175x791,(683)312-5539x783,cory26@allen-gonzalez.com,2022-01-06,https://www.solomon.net/
10-Feb-2021,RTGS,"1,907.00",00.00,"1,528,727.00",1dB9eb60f760c1B,2766,Shari,English,"Bass, Mann and Cain",Suarezland,Papua New Guinea,001-406-842-2551x4925,(245)382-8146,jean11@farley-krueger.com,2021-06-20,http://www.carroll.info/
10-Feb-2021,Transfer,"16,638.00",00.00,"1,545,365.00",9F4971EFb502c27,5499,Kelsey,Morris,Collins PLC,Belindaview,Moldova,001-516-947-2216x1645,001-492-514-4137,awinters@lara.com,2021-09-07,https://www.phelps-powers.org/
10-Feb-2021,ATM,00.00,"171,707.22","1,373,657.78",c1DbDb64C5447F5,7494,Donna,Donaldson,Ramsey Group,Lake Christianport,Hong Kong,690.474.3421,985.499.9109,powellkarl@craig.com,2021-06-24,https://nash.org/
10-Feb-2021,ATM,00.00,"228,942.96","1,144,714.82",3eF073982211bdb,7942,Mitchell,Baxter,Casey-Dodson,New Donnatown,Antarctica (the territory South of 60 deg S),(829)401-4007x7375,001-373-329-5457x90581,julianmorris@berger.com,2021-11-17,https://www.contreras-wilkinson.net/
10-Feb-2021,RTGS,18.00,00.00,"1,144,732.82",AD0F1A7b11DeAa0,7173,Troy,Mueller,"Meadows, Pruitt and Powell",Teresahaven,Western Sahara,533-472-0887x81797,0543846659,qstafford@vasquez.com,2021-05-28,http://ibarra-soto.com/
10-Feb-2021,RTGS,00.00,00.00,"1,144,732.82",3FDa7a8e8f3d3aA,3122,Lindsay,Abbott,Gordon PLC,Lake Victoria,Albania,001-369-827-0050x450,054-938-7451,dana33@pennington-ewing.org,2021-09-26,https://rose.com/
10-Feb-2021,Cheque,"114,413.75",00.00,"1,259,146.57",6E8BC71Da4a716b,710,Darrell,Mcneil,Hubbard LLC,North Garrett,Iran,820-265-6563x42062,001-460-889-5334x59702,yangrebekah@obrien.info,2020-08-31,http://mitchell.net/
10-Feb-2021,Cash,"10,059.65",00.00,"1,269,206.22",dC8CB3EcfC6BDaA,2505,Jesus,Cunningham,Kelley Group,North Melissa,British Virgin Islands,(943)527-4394,001-313-365-0667x9961,summer34@gates.info,2020-11-17,http://hanna.info/
10-Feb-2021,IMPS,05.57,00.00,"1,269,211.79",93eb5Bf642f92A7,2271,Gabriel,Casey,Underwood-Dean,Mcbridestad,Mozambique,+1-745-836-3629x35271,255-334-5753x7982,selena52@richard.info,2021-03-18,https://hughes.com/
10-Feb-2021,Debit Card,07.00,00.00,"1,269,218.79",57ecBB93BBbFdEE,4438,Cory,Mckinney,"Fletcher, Hale and Shannon",Staffordfort,Cuba,1697545879,001-961-800-1664,sara92@stevens.com,2021-10-10,https://glover.info/
10-Feb-2021,NEFT,20.20,00.00,"1,269,238.99",C74CADB9aC1137A,9618,Cindy,Vasquez,Wong-Chan,Mckaychester,Mali,(055)197-7581x919,125-403-9562,neil04@allen-cohen.com,2020-03-16,https://osborn-roberson.com/
10-Feb-2021,Interest,52.00,00.00,"1,269,290.99",9EBDc5A06dF5EAC,6831,Gregg,Johnston,Irwin Ltd,Bernardfort,Korea,001-243-591-3118x430,8962531839,tcowan@sutton.com,2022-01-28,http://www.sheppard.com/
10-Feb-2021,Tax,00.00,"1,269,290.99",00.00,A80989EE3Da7F7d,2468,Gordon,Randolph,Hickman LLC,Herringburgh,Jamaica,112-210-9330x30823,837.649.6240,fergusonchloe@mcgrath.biz,2022-04-29,https://velazquez-hudson.info/
10-Feb-2021,Purchase,01.50,00.00,01.50,d3fF4F1DceACA2D,481,Christian,Thornton,"Duffy, Castro and Yates",Port Mariostad,Norway,001-037-597-5406,5445268667,gschultz@rollins.com,2020-10-21,https://walter-yates.com/
10-Feb-2021,ATM,"1,491,044.00",00.00,"1,491,045.50",BE25dE3e8CfF3D1,9750,Diamond,Johns,Hodges-Rodriguez,New Drew,Argentina,+1-561-066-6157,624-553-9073x19909,scott30@wilkinson.biz,2022-03-11,https://foley-lowery.com/
10-Feb-2021,Transfer,"11,166.00",00.00,"1,502,211.50",81d3bA3fC7CDA8C,2198,James,Holt,Kent and Sons,Suttonland,Andorra,1800337906,951-006-9287x937,marisa33@richardson-tate.com,2021-01-06,http://www.jackson.com/
10-Feb-2021,IMPS,00.00,"214,601.64","1,287,609.86",Cff2136b64Ccb3F,5633,Jeremy,Andersen,Cooley PLC,Keithborough,Russian Federation,001-928-106-5776,001-998-609-9829,bcastaneda@flowers.com,2021-03-22,http://www.fox.com/
10-Feb-2021,ATM,00.00,"143,067.76","1,144,542.10",9Df4494913EF39f,8265,Clarence,Palmer,Hill-Hunter,North Judith,United Arab Emirates,677-187-1001x27091,668.785.2970,hlam@booth-booker.com,2022-05-14,https://petersen.info/
10-Feb-2021,ATM,49.60,00.00,"1,144,591.70",f5eDb90dF42aA44,4368,Ryan,Huang,"Navarro, Flynn and Byrd",Angelicastad,Guyana,(475)621-3585x98896,571.013.9242x67743,lacey91@bradford-stanton.net,2020-08-05,https://www.bowers.com/
10-Feb-2021,Purchase,"39,075.00",00.00,"1,183,666.70",4ea4a84Cba53A63,8997,Desiree,Green,Molina Ltd,West Cathy,South Africa,(978)607-7249,8222738858,dylanfrazier@stevenson-watson.com,2022-01-10,https://mcdaniel-anthony.net/
10-Feb-2021,IMPS,00.00,"118,366.67","1,065,300.03",dfCa94D5f068C65,6339,Holly,Reed,Bernard-Wallace,Lake Damon,Guinea,423-373-5561x89173,575.314.7351x94998,mercadogeorge@allen.com,2021-11-11,https://www.silva.com/
10-Feb-2021,Interest,00.00,"177,550.01","887,750.02",9e37d4afEC84ce1,3492,Vanessa,Peck,"Kaiser, Small and Hickman",West Frank,Svalbard & Jan Mayen Islands,857.664.6796,001-857-359-4123x7294,tannerlogan@ramos.net,2022-02-26,https://www.mcdaniel.com/
10-Feb-2021,Bill,07.40,00.00,"887,757.42",1d4eDF4394eEdBF,719,Matthew,Valdez,Garrison-Larson,North Dwayne,Vietnam,198-844-7879x2559,412-910-3872,destiny53@rivera-davenport.com,2022-04-29,https://rich.com/
10-Feb-2021,Reversal,00.00,"221,939.36","665,818.07",7F5e80C56c0f00c,8644,Bradley,Simmons,Christian LLC,Port Autumn,Turkmenistan,(256)553-1957,+1-734-329-2290x28055,alicebowen@mccullough.com,2020-07-03,http://www.arnold.com/
10-Feb-2021,Commission,00.00,"332,909.04","332,909.03",a7Cd5AebCcCcB43,5104,Erin,Maynard,Smith-Hartman,Mccartyview,Finland,+1-974-106-9171x7675,918-475-3972x676,pattersoncasey@glenn.com,2020-12-25,http://vance.net/
10-Feb-2021,Commission,00.00,"36,989.89","295,919.14",aE1dDFBf75bAd9A,522,Tom,Hogan,Waller Inc,West Rickyton,Germany,(425)426-1714,+1-673-217-6692x8647,bbowen@bowman.com,2020-05-14,http://www.ruiz.net/
10-Feb-2021,Tax,"9,552.00",00.00,"305,471.14",fc94fcFCc5EF4e3,4395,Jennifer,Sherman,Barton Group,East Jaime,Pakistan,046-074-2754x6836,9521219091,trevor59@mooney-clements.info,2021-11-08,http://www.soto-shields.com/
11-Feb-2021,Transfer,00.00,"61,094.23","244,376.91",ccFbE36B36DA8ca,906,Stacy,Wright,Mcmillan Ltd,Lanceburgh,Macao,(298)415-3714x8433,(084)259-2369,brittany22@blake.org,2021-04-12,http://www.perkins.biz/
12-Feb-2021,NEFT,00.00,"48,875.38","195,501.53",0eFf84b706a8DdB,100,Aimee,Sims,"Lara, Leon and Montoya",East Jeanneside,Grenada,(570)770-4667x7987,001-511-768-2295x52680,anthonyzuniga@tucker.com,2021-07-27,http://moran.com/
12-Feb-2021,NEFT,"3,324.00",00.00,"198,825.53",2cd3cEBb3Bb9c3f,9816,Nina,Boyer,"Brady, Lynn and Gallagher",South Kathryn,Saint Vincent and the Grenadines,738.100.5607x3601,190-674-6921x29242,jasmin50@sanders.info,2021-09-10,http://mckay.com/
12-Feb-2021,Bill,20.30,00.00,"198,845.83",E8F1FB33Eb5cAfd,4106,Tara,Wyatt,Woods Group,South Leroy,China,001-845-258-1736,(039)106-0839x9049,guerrerowanda@marks-campbell.org,2020-09-24,https://www.blackburn-fry.com/
12-Feb-2021,Cheque,00.00,"99,422.92","99,422.92",2F70bCFc4b8e4cd,9242,Tracie,Sandoval,Wise LLC,Veronicaton,Spain,(897)395-7597x68624,(962)225-7779x642,dylan38@russell-ross.com,2021-08-09,http://www.vaughn-boyle.com/
12-Feb-2021,NEFT,"272,529.50",00.00,"371,952.42",e090f2CAF78D1fa,2497,Erica,Sloan,Rowland LLC,West Noahview,Botswana,+1-092-286-3619x944,001-666-132-2734x6100,hendrixshelby@gallagher-villanueva.com,2021-12-15,http://vargas.com/
12-Feb-2021,Reversal,"20,756.00",00.00,"392,708.42",cF9c1Cc4BfaA85e,7157,Jack,Leon,Mcbride LLC,South Kirsten,Niue,6809752975,654.690.0491x89143,caitlynguzman@farmer.com,2022-05-13,https://www.hogan.org/
12-Feb-2021,Purchase,10.13,00.00,"392,718.55",Ea5906ce832cAA2,1820,Felicia,Stein,"Johnston, Pope and Kirk",Rileybury,Djibouti,+1-479-211-1356x7705,(234)757-0892,angie16@ayers.com,2022-04-21,https://larsen.com/
12-Feb-2021,Interest,00.00,"49,089.82","343,628.73",195c71b876bf11d,6884,Mandy,Roberts,Levy-Shepard,Fritzberg,Lebanon,053-757-0709,+1-683-633-1808x662,candicechan@salazar.biz,2021-02-14,http://cline.com/
13-Feb-2021,Tax,00.00,"171,814.37","171,814.36",C4A721a55d222FB,3405,Sierra,Santana,Kidd Group,West Carlos,Benin,+1-434-971-4211x908,384-223-7991x61161,abarajas@vargas.info,2020-03-11,http://bridges-lloyd.com/
13-Feb-2021,Purchase,"735,620.00",00.00,"907,434.36",B8BABDa477CcAcd,496,Crystal,Barry,"Walker, Walters and Terry",Lake Dale,Ethiopia,209-590-9084x42026,001-512-881-6108x91846,kathybradshaw@anderson-steele.com,2020-02-08,https://www.newton-vaughan.com/
13-Feb-2021,Tax,00.00,"302,478.12","604,956.24",FfDfEcc5FFFdA95,6781,Kenneth,Craig,"Wall, Walter and Page",Port Joel,Morocco,001-089-129-6082x036,+1-547-924-6453x2022,melanie55@kelley.biz,2020-07-05,https://www.escobar.com/
13-Feb-2021,Commission,"11,904.22",00.00,"616,860.46",e8fC8CC2f02B9aC,3074,Malik,Roth,Alvarado-Young,Dominguezbury,Tonga,+1-484-610-9650x3616,007-366-0489,michellehurst@navarro-barajas.info,2021-01-16,http://www.benjamin.com/
14-Feb-2021,Purchase,"25,878.62",00.00,"642,739.08",e4d7aD9D753a35b,3736,Julia,Bates,Gill Inc,Lambfort,Russian Federation,2864821224,694-037-3123x6369,molly59@alvarado.info,2020-10-11,https://www.harrington-reyes.biz/
14-Feb-2021,IMPS,02.00,00.00,"642,741.08",Da2efbC6fCc5b74,9950,Sandra,Silva,Gonzalez PLC,Tabithaberg,Bangladesh,(434)277-0630x7629,634-816-4808,ablackwell@watkins-mcmahon.com,2020-09-03,https://www.campos.com/
14-Feb-2021,Miscellaneous,00.00,"64,274.11","578,466.97",E8c0e0a7C7DEF59,6945,Kelsey,Mullins,Mosley-Kennedy,South Marioview,New Zealand,084-311-5017,001-537-420-7489x740,trevinobreanna@murphy.com,2020-05-09,https://www.singh.com/
14-Feb-2021,Tax,05.00,00.00,"578,471.97",3AD32Dab554fcaD,1373,Kyle,Jefferson,Farley-Mcgrath,Lorettatown,Australia,435-303-9388x292,(703)354-0004x2229,natalie51@reid.com,2021-07-13,http://cole-melton.com/
14-Feb-2021,Cheque,00.00,"57,847.20","520,624.77",EE526B8Fbde0AE6,5195,Adrienne,Novak,Douglas Inc,Stacietown,Singapore,250.749.5145x2466,386.700.8102x9602,snolan@ochoa.org,2021-12-07,https://cline-hensley.net/
14-Feb-2021,NEFT,00.00,"57,847.20","462,777.57",b0bFc35A998Ffcd,9088,Mark,Bennett,Martinez-George,South Mitchelltown,New Zealand,001-535-467-3408x2538,001-568-842-9114x2089,dmcguire@randall-mccarty.biz,2021-02-13,http://mcclain-wheeler.org/
14-Feb-2021,RTGS,00.00,"462,777.57",00.00,e5BbA364CB51FE2,5606,Carrie,Barnes,"Gutierrez, Waters and Wade",Lake Nicolas,Taiwan,0728216305,354-966-5127x777,dillon87@eaton-acevedo.biz,2020-02-21,http://www.anderson.com/
14-Feb-2021,Tax,03.83,00.00,03.83,F4E9F931Fbc99CD,8673,Jared,Mosley,Gates Ltd,West Sheryl,Botswana,4685693747,001-974-803-9491x57880,judith83@mueller.org,2021-06-01,http://www.erickson-lozano.net/
15-Feb-2021,Bill,00.00,00.55,03.28,CEe46Ca6cB6D3e9,429,Autumn,Rogers,Bowers Ltd,Stoutview,Panama,067-985-0255,780.088.8664x51628,byoung@bailey.com,2021-07-29,http://www.wall-colon.com/
15-Feb-2021,Purchase,00.00,00.33,02.95,0dBACeBCCAED7De,4414,Traci,Lloyd,"Walters, Foster and Roberson",West Isaiah,Armenia,+1-632-371-3631,714-649-0694x09431,webbfrancis@park.com,2021-09-29,https://www.porter.org/
15-Feb-2021,Debit Card,00.00,00.74,02.21,5d2e8b324BDDA6A,9409,Kurt,Sampson,"Wagner, Young and Rivers",East Kimberly,Mauritania,+1-256-505-7087,706.005.4226x57496,denisebeck@phelps.com,2020-07-28,http://gay.com/
15-Feb-2021,Reversal,02.24,00.00,04.45,eD16DBEbeAc83F1,4084,Gail,Mcgrath,Dougherty-Waller,Port Kennethborough,Romania,001-822-787-7712x49955,001-487-402-6390,jeanhatfield@greene.com,2021-07-10,https://stewart.com/
16-Feb-2021,Transfer,"206,351.00",00.00,"206,355.45",538A6933Eb83A12,8544,Kent,Gamble,Vega Inc,North Emma,Mongolia,468-514-6261x3965,398.205.9898,savannah02@duran.com,2020-10-09,https://www.frank.org/
16-Feb-2021,RTGS,00.00,"29,479.35","176,876.10",06CEd2F28a10F43,5852,Dave,Everett,"Hogan, Griffith and Jefferson",New Jeff,Isle of Man,001-413-693-7164x4942,543-511-0335,crojas@wolf-pittman.com,2021-02-11,http://stone.com/
16-Feb-2021,Cheque,00.00,"88,438.05","88,438.05",D5ff2fDe6fCc4eD,9100,Parker,Mejia,"Schroeder, Berg and Powell",Lake Hailey,Latvia,112.984.6034,001-568-030-6757x7668,mollyford@cameron.com,2021-11-10,https://howe-holloway.com/
16-Feb-2021,IMPS,00.00,"44,219.03","44,219.02",eA8eEd912C7D21D,624,Angela,Riggs,Fischer-Prince,Anaton,Costa Rica,001-626-655-4132x76016,(972)983-8773x9998,dillon73@frey-sawyer.com,2022-05-23,https://www.strong.info/
16-Feb-2021,Reversal,00.00,"11,054.76","33,164.26",DAe07FEAfCeab89,283,Brad,Booker,Beard LLC,West Gabriel,Maldives,001-741-430-6383x602,930.509.1674x306,robinfitzpatrick@hardy.biz,2022-03-26,http://www.benson-pratt.com/
16-Feb-2021,Debit Card,"483,187.25",00.00,"516,351.51",C9bFa849Cd1DeEe,7292,Helen,Weiss,"Sweeney, Newman and Guerra",South Bryce,Antigua and Barbuda,+1-545-223-7038x98874,389.415.3502x7264,lancemayer@webster.info,2021-12-15,http://pope.com/
16-Feb-2021,Reversal,00.00,"86,058.59","430,292.92",8B79dF5b2C91Ef8,2868,Henry,Valdez,Scott PLC,Gregville,United Kingdom,(072)411-0588x6943,+1-240-576-5180,lbolton@andersen.net,2020-10-02,https://dudley.com/
16-Feb-2021,Interest,00.00,"43,029.29","387,263.63",fDe3575BF7f4ad3,9660,Kimberly,Cordova,"Klein, Scott and Mcintyre",Chrischester,Gabon,599.138.4408x557,001-171-529-3947x6754,charlesmoore@lowe.com,2022-05-03,https://wells-jennings.org/
16-Feb-2021,Cash,00.00,"193,631.82","193,631.82",FAdED1A29b30019,180,Martha,Small,Cordova-Acevedo,Michelehaven,El Salvador,230.073.8571,581-665-8434,reginahancock@walker.org,2021-01-17,http://haney.biz/
16-Feb-2021,ATM,00.00,"27,661.69","165,970.13",5820deAdCF23EFe,5,Kathleen,Mccormick,Carson-Burch,Andresmouth,Macao,001-184-153-9683x1497,552.051.2979x342,alvaradojesse@rangel-shields.com,2021-01-17,https://welch.info/
16-Feb-2021,Bill,"442,024.00",00.00,"607,994.13",5a16bE270f9cbFC,1913,Elijah,Navarro,"Giles, Reid and Cisneros",North Jimmy,French Southern Territories,4036464204,731-835-6137,williamrich@byrd-harvey.net,2020-03-16,https://www.booker.biz/
16-Feb-2021,Reversal,"31,580.00",00.00,"639,574.13",bdD38eE4AD08eB2,9187,Leon,Russo,Hammond-Mccullough,Maciasside,Romania,303.439.4472x113,244.979.0731x070,vincentmichele@osborn.com,2022-03-11,https://mccarthy.com/
16-Feb-2021,Interest,169.96,00.00,"639,744.09",46f9c1beE1e04ea,4291,Yvonne,Wise,Peck-Nguyen,Johnsonmouth,Latvia,909-324-9560,001-715-081-1134,allisondouglas@marsh-flowers.info,2021-12-03,https://salazar.com/
16-Feb-2021,Miscellaneous,00.00,"71,082.68","568,661.41",a70D52BEA11F6ff,3121,Selena,Walter,"Hull, Sandoval and Werner",East Jacob,Guatemala,997.846.9769x8096,001-100-451-5269x20593,robertohodges@sweeney.info,2020-03-31,http://robbins.net/
16-Feb-2021,Reversal,"193,762.40",00.00,"762,423.81",71a78adCFDC23bE,5250,Chase,Anderson,Herman-Watts,Geoffreystad,Greenland,001-211-043-3552,563-846-4982,bradflowers@harvey-mahoney.info,2020-03-27,http://hardin.com/
16-Feb-2021,Transfer,15.20,00.00,"762,439.01",0A4c6c06dC7C933,9962,Terry,Peck,"Hays, Sampson and Atkinson",Coltonbury,Zambia,001-402-443-2359x65661,+1-641-685-7552x23210,scott85@brock-park.com,2020-07-12,https://ingram.com/
16-Feb-2021,RTGS,331.60,00.00,"762,770.61",12FBd65eadd00E5,7333,Andre,Blackburn,Harrison Ltd,Lake Corey,Venezuela,(416)544-1619x84358,+1-900-054-4746x95838,jeremyswanson@cook-casey.org,2022-05-29,https://www.carney.com/
16-Feb-2021,Transfer,"855,068.00",00.00,"1,617,838.61",2C1B4FEcAE0bA62,8899,Sergio,Fitzgerald,Ponce-Duncan,Lake Larryhaven,Pakistan,456-753-3168,104-168-5587x469,espinozabernard@kaiser.com,2021-03-06,http://washington.net/
16-Feb-2021,Bill,01.00,00.00,"1,617,839.61",Bda5A1d6cee9de3,2077,Jeanette,Mendez,"Daugherty, Simmons and Hogan",Donview,Yemen,3521654823,(984)888-0612,kwalters@mann.com,2020-07-09,https://guerrero.biz/
16-Feb-2021,RTGS,670.55,00.00,"1,618,510.16",9d6E195c5eCA03c,8483,Gregory,Shannon,Adams-Burch,Bradymouth,Cameroon,199.320.8648,843.448.5869x507,denniskayla@cross.info,2020-09-25,https://www.klein-bautista.com/
16-Feb-2021,Debit Card,06.50,00.00,"1,618,516.66",d1654CCFDBc92Dd,7476,Edward,Townsend,"Mccoy, Bass and Yu",Bobport,Solomon Islands,001-998-926-3118x757,(515)058-7774x906,dustin11@stout-landry.org,2021-08-18,http://roberts-mcconnell.info/
16-Feb-2021,Miscellaneous,00.00,"179,835.18","1,438,681.48",F7d5CEbbE72a432,9821,Stuart,Norman,"Carr, Camacho and Forbes",New Patrick,Vietnam,406.736.8965,589-651-5432,peter47@gallagher-stewart.biz,2021-12-26,https://www.parrish-mathews.net/
16-Feb-2021,IMPS,00.00,"239,780.25","1,198,901.23",d6866bBAdd79aFa,8199,Danny,Lowe,Rich-Burgess,West Jacksonstad,Mayotte,416.656.0933x34559,073-877-9368,veronica96@dyer-romero.com,2020-12-24,https://www.adams.com/
16-Feb-2021,Cash,00.00,"119,890.12","1,079,011.11",CbE4C5BCEFB7d82,7119,Brenda,Douglas,Dickerson-Ford,New Kimberly,Saint Lucia,+1-980-930-5528,(413)839-1888x17764,reynoldssusan@fleming-buckley.net,2021-05-30,https://www.ellis-wong.com/
16-Feb-2021,Tax,45.00,00.00,"1,079,056.11",4B16C327F677BDc,7554,Samantha,Maldonado,"Khan, Dominguez and Davis",Meganborough,Uruguay,047.475.1619x963,(334)275-4384,cheath@ray-thornton.net,2020-07-29,https://roberts.com/
16-Feb-2021,Purchase,00.00,"215,811.22","863,244.89",0DB2FCacDe847c3,2914,Erik,Yates,Zavala LLC,Rhondafort,Turks and Caicos Islands,344-684-8572x54477,+1-161-427-1972x411,bryanttanner@anderson.com,2021-12-22,http://howell.org/
16-Feb-2021,Commission,00.00,"431,622.45","431,622.44",1bE19EFe5De126a,4745,Noah,Dickerson,Koch PLC,Mayfurt,Belize,+1-375-432-9946,001-205-778-5551x4218,opope@harding.biz,2021-04-10,https://knox.com/
16-Feb-2021,Interest,00.00,"215,811.22","215,811.22",90D853A55e68d3e,5702,Regina,Wheeler,"Sims, Hardy and Esparza",Clairehaven,Guinea-Bissau,2979664806,559.551.0348x515,isaacmercer@kelley.com,2021-10-19,http://www.douglas.com/
16-Feb-2021,Transfer,00.00,"107,905.61","107,905.61",4D26D6AD5D4DD5a,288,Shawna,Beasley,"Olsen, Barrera and Robles",West Gene,Saint Pierre and Miquelon,321-895-3140x030,212-501-9922,kowens@peterson-jimenez.com,2021-09-03,http://www.gregory.org/
16-Feb-2021,Purchase,267.00,00.00,"108,172.61",Ca39543a15fBe1f,5895,Marie,Baldwin,"Mccarty, Buchanan and Nunez",Jacobsonville,Saint Barthelemy,486-748-8458,+1-131-445-8873x78358,prattbruce@velez.net,2020-01-17,https://meadows.net/
16-Feb-2021,Purchase,00.00,"15,453.23","92,719.38",E36DAb7C11fae5b,7923,Victoria,Ray,Padilla Inc,West Jerry,Niger,(233)456-6657,001-062-922-4558x29422,marshalljenna@gates.net,2021-11-06,https://www.jackson-phillips.info/
16-Feb-2021,ATM,"6,659.30",00.00,"99,378.68",aebEcf786E55Fff,4848,Raven,Morales,Martin PLC,West Tashamouth,Northern Mariana Islands,272-714-0293x40949,+1-217-995-2774x99468,terrence18@west.net,2021-12-24,http://anderson-jenkins.com/
16-Feb-2021,Bill,05.00,00.00,"99,383.68",78a2aeFd5bE26cE,8191,Carol,Wong,Lynch Ltd,South Rubenmouth,Greece,(649)319-7804x654,614-981-1536x3272,tcrane@bolton.com,2021-12-09,http://neal.com/
16-Feb-2021,Commission,415.30,00.00,"99,798.98",c2C55a1cba2ebEa,4321,Sheryl,Osborn,Santana Inc,New Wyatt,Qatar,001-123-344-9288x48231,260.053.1744x745,ocruz@mcguire-kennedy.org,2022-04-02,http://simmons.com/
16-Feb-2021,ATM,"1,414,538.00",00.00,"1,514,336.98",fAc3e7CE2EbceFf,9892,Stephen,Case,"Church, Figueroa and Allen",Rojasville,Cambodia,828-880-9498,(126)657-7691,neilberger@pena-oconnor.org,2021-12-10,https://hancock.org/
16-Feb-2021,Cash,"2,968.30",00.00,"1,517,305.28",Fa094Bf730CdAe4,8712,Raven,Krause,Deleon Inc,South Dominique,Latvia,001-408-146-1021x55726,(756)222-4344,ellenweiss@hester.com,2021-08-19,http://www.douglas-willis.com/
16-Feb-2021,Interest,"30,035.00",00.00,"1,547,340.28",6dfe9E67F5eFAbb,9056,Deanna,Tapia,Torres-Hampton,North Bethtown,Kenya,001-428-928-4516x11954,(882)117-0078,derekmayo@randall.com,2021-07-07,http://hall.com/
16-Feb-2021,NEFT,19.00,00.00,"1,547,359.28",Ee1F78c5A3Ce2aD,4533,Bonnie,Nielsen,"Sanders, Benitez and Wagner",Lake Willie,Australia,435.969.3245x112,6208912575,roydavies@heath.com,2021-11-12,https://www.salas.com/
16-Feb-2021,Debit Card,00.00,"773,679.64","773,679.64",53eD081839B6E57,1893,Yesenia,Alvarez,"Holloway, Ferguson and Fitzgerald",Port Nathaniel,Guadeloupe,001-389-426-7805x9646,(855)827-1085x7634,pottskerri@rosario.com,2021-03-30,http://savage.com/
16-Feb-2021,Tax,144.10,00.00,"773,823.74",0F6D71A8f66f4B8,6198,Hector,Mccarthy,"Ortiz, Silva and Wilson",South Tanyaborough,Jamaica,349.236.9677x583,001-288-501-4553x387,beasleyvalerie@bond-barry.net,2020-03-30,https://www.fernandez.com/
16-Feb-2021,ATM,"2,122.10",00.00,"775,945.84",75578FB58Dcfe6E,5474,Margaret,Casey,Maxwell Inc,Port Erinville,United Kingdom,001-429-525-8997x7292,156.138.8305,bethany89@hartman.com,2021-05-25,https://evans.com/
16-Feb-2021,Transfer,00.00,"155,189.17","620,756.67",eFe7fBBAFEC50dA,7117,April,Kline,Thompson-Barber,Port Suzannemouth,Zambia,192-294-4222x986,+1-653-077-1466,natalie84@gibson-kent.biz,2021-10-12,http://oconnor.net/
16-Feb-2021,Transfer,"638,848.00",00.00,"1,259,604.67",A71261AFE0bfbc0,2416,Anne,White,"Farrell, Williamson and Fisher",Haroldland,Lesotho,(309)850-4482,001-266-148-6515,lawsonkelli@chase.com,2020-02-18,https://blanchard.com/
16-Feb-2021,RTGS,"24,057.00",00.00,"1,283,661.67",9A6D2cedCcbc530,8584,Cassie,Ellison,Acosta-Sims,Keithshire,Finland,+1-702-339-9728x09691,+1-697-870-1662,kristameza@eaton.com,2020-01-22,https://www.hull-benitez.com/
16-Feb-2021,Interest,00.00,"128,366.17","1,155,295.50",47875Cdfb9cE5Bc,4122,Fernando,Terry,Lawson PLC,Dorseyside,Antigua and Barbuda,(465)394-3799x41119,(214)335-0824x066,makaylaward@steele.org,2020-04-28,https://castro-garcia.net/
16-Feb-2021,Miscellaneous,501.00,00.00,"1,155,796.50",7B4F36a6219AC88,1290,Aaron,Fritz,Lawson-Stanton,Carlyburgh,Bangladesh,001-501-747-1945,(086)859-5884,pollardkirk@french-rios.org,2020-10-05,https://singh.net/
16-Feb-2021,Transfer,186.00,00.00,"1,155,982.50",aA53aA6475331EA,7606,Caitlyn,Andrade,"Kirby, Stein and Molina",Melodyberg,Mongolia,120-015-0284x368,558-816-3985,pconner@shaffer.com,2021-01-11,https://www.melton.com/
16-Feb-2021,Bill,"3,161.94",00.00,"1,159,144.44",c998c52B60B8e15,3436,Karen,Huff,Whitney-Palmer,Suzannebury,New Zealand,039-510-0761x926,433-110-9261x95190,casey02@barry.info,2020-09-20,https://www.prince-campos.org/
16-Feb-2021,Bill,239.60,00.00,"1,159,384.04",6CaAB9eB928DcC5,536,Rebecca,Rasmussen,Park and Sons,North Tanya,Comoros,749-064-9430x7897,204-684-0840x23498,weberkerry@mcbride.biz,2020-08-06,http://ashley.com/
16-Feb-2021,RTGS,59.05,00.00,"1,159,443.09",b74C5f67dE8bA4a,3202,Stephanie,Zhang,"Odom, Brock and Levine",Lynchmouth,Philippines,(592)554-3947x5170,(151)587-0695,rowen@swanson.com,2021-08-23,https://cardenas.com/
16-Feb-2021,Tax,"2,084,854.00",00.00,"3,244,297.09",ea5FEBad94BDF31,6586,Drew,Bonilla,Owens PLC,Graceview,Lebanon,(840)775-9739x4361,758-461-5228x23538,duffymiguel@blanchard-hebert.net,2021-01-06,http://howard.com/
16-Feb-2021,Debit Card,"1,687.10",00.00,"3,245,984.19",aaEAbf6C5EC23C2,1811,Gloria,Anthony,Pierce Inc,Soniafort,Barbados,001-209-995-5970x830,601-551-6979x23749,samanthamccall@conley.com,2021-11-09,http://www.reyes.net/
16-Feb-2021,Miscellaneous,00.00,"540,997.37","2,704,986.82",fD7beCAA0757B09,4746,Gregg,Zavala,Frederick LLC,Woodside,Azerbaijan,001-356-060-3825,649.168.8340x167,timothygraves@cochran-mack.net,2021-09-12,https://franco-stein.net/
16-Feb-2021,Interest,"18,687.40",00.00,"2,723,674.22",e6FaA0b330bb4AF,7469,Makayla,Wang,"Lucero, Wu and Mcclain",Cherylberg,Tajikistan,+1-773-495-9752,2294826048,marshallisabel@li-porter.com,2021-12-27,http://www.drake-nunez.com/
16-Feb-2021,ATM,"1,715,361.00",00.00,"4,439,035.22",DDA1D938B28CEA3,2823,Curtis,Lucero,Chavez and Sons,West Jackie,Indonesia,2152256724,822.815.2456x02530,wmaynard@vasquez.org,2021-06-01,https://orr.com/
16-Feb-2021,Interest,00.00,"887,807.04","3,551,228.18",5ac476d798a9EE1,7242,Megan,Robinson,Mills Inc,North Bryce,Serbia,575.089.1288,(507)636-6186x4214,dcrawford@cisneros-daniels.org,2021-12-07,http://love-chung.com/
16-Feb-2021,NEFT,00.00,"1,183,742.73","2,367,485.45",07076DBd0216DC7,7377,Edwin,Roberson,"Chandler, Ewing and Holt",West Pamelamouth,Niue,8984931458,596.514.7174x56091,alivingston@salas.com,2020-10-01,http://www.sanford.org/
16-Feb-2021,Cheque,00.00,"295,935.68","2,071,549.77",aD7FCD2FB05E924,9365,Haley,Zimmerman,Meyer-Everett,New Eugene,Montserrat,(447)094-8199x46204,(726)482-5634x380,kurt02@harris.info,2020-05-03,http://olson.com/
16-Feb-2021,Miscellaneous,00.00,"207,154.98","1,864,394.79",b00a5AF2aBcfEdF,7511,Keith,King,"Turner, Huang and Kemp",Alejandrahaven,Northern Mariana Islands,193.825.1497x1650,785.133.6420x088,rbradshaw@edwards.com,2020-08-08,http://rubio.com/
16-Feb-2021,Transfer,13.30,00.00,"1,864,408.09",e5919db787AECFc,4398,Breanna,Frey,Pollard-Ruiz,Loweryport,Colombia,030.064.6850x599,545-447-1712,april52@martin.com,2020-09-25,http://woodard.com/
16-Feb-2021,NEFT,00.00,"932,204.05","932,204.04",f663eE36Dfa75db,6644,Susan,Day,"Robinson, Stephens and Martin",South Melanie,Azerbaijan,224-435-2080x813,842-932-8318,rhansen@franco.org,2020-07-22,http://www.kline.com/
16-Feb-2021,Commission,173.10,00.00,"932,377.14",5bbB2caA615b33c,2250,Earl,Oconnor,Krueger and Sons,Port Donald,Iraq,001-048-723-5763x010,(676)301-3438x84807,arielschroeder@heath.com,2021-11-29,https://pennington-miller.com/
16-Feb-2021,Cheque,"1,237.40",00.00,"933,614.54",D7Ba0FBF04dAd2f,8147,Gregory,Mitchell,Mercado-Rivas,Hendricksview,Monaco,001-675-333-8549x671,001-951-808-2242x12075,zwaters@conley.com,2020-03-24,https://wu.com/
16-Feb-2021,NEFT,275.00,00.00,"933,889.54",8dBC3De87B82F0f,2526,Wyatt,Carson,"Santos, Duran and Clark",Port Adrianmouth,Uruguay,335.097.5090x3692,+1-465-996-1269x76503,leachkerri@oneill.info,2022-02-21,http://www.rowe-huber.com/
16-Feb-2021,Reversal,00.00,"466,944.77","466,944.77",fC0B4005EC5ACD4,6211,Monique,Braun,"Mcfarland, Larsen and Pena",Toniville,Trinidad and Tobago,001-450-928-7928x06328,(502)858-5696x43649,huberlee@rice.net,2021-07-19,http://mclean.com/
16-Feb-2021,Bill,00.00,"51,882.75","415,062.02",eadc6aE1Eaaf400,4135,Rose,Walter,"Escobar, Briggs and Sloan",New Dustin,Samoa,374.646.8095x72267,734.207.7384,yluna@nash.com,2021-10-27,https://dickerson.com/
16-Feb-2021,Reversal,00.00,"83,012.40","332,049.62",8cAAd16A0daFdaC,9525,Christy,Johnston,Price Ltd,Bradleyview,Aruba,+1-061-934-6211,(096)801-7375x125,jasmine17@wheeler.com,2021-07-11,https://mcintosh.com/
16-Feb-2021,Commission,00.00,"36,894.40","295,155.22",d81da3Aafe2DbD1,1505,Katelyn,Chase,"Blevins, Diaz and Mccann",Sergioshire,Iran,863.767.9615x7786,968.253.0049x268,skinnerstephanie@webb.com,2021-05-31,https://osborn.com/
16-Feb-2021,Debit Card,32.17,00.00,"295,187.39",59bDE56C1053b64,7016,Jeff,Henson,"Glenn, Macias and Shannon",Keithfurt,Bangladesh,001-833-902-2467x49521,5912823530,uhamilton@sawyer-cardenas.com,2021-08-10,http://sutton.com/
16-Feb-2021,Reversal,00.00,"36,898.42","258,288.97",5D59AB3879BFBcE,5710,Shelia,Whitehead,Esparza and Sons,Frankport,Turkey,(105)432-8851,012.644.7889x2046,mia79@parks-ramos.info,2020-09-22,http://www.bolton.com/
16-Feb-2021,NEFT,00.00,"28,698.77","229,590.20",94cA16AFe68CC4D,1908,Caleb,Griffith,Morton-Dudley,North Evelynville,Niger,+1-350-020-0270x7526,5361352759,peter97@newton.com,2020-05-10,https://bautista.com/
16-Feb-2021,Bill,00.00,"76,530.07","153,060.13",5ab036db472aB64,6769,Todd,Branch,Aguirre-Hill,Lanechester,Northern Mariana Islands,183-821-8581x855,001-947-416-8656x4227,meaganmcclure@carlson.com,2020-07-27,https://www.dickerson.net/
16-Feb-2021,IMPS,00.00,"51,020.04","102,040.09",c3FE9fCd5D26e8E,6960,Bruce,Meyers,Olson-Parsons,Beanberg,Fiji,0905184444,395.193.8608,phamjaime@schultz.com,2022-05-16,http://www.stanton-griffith.info/
16-Feb-2021,Cash,"1,400.45",00.00,"103,440.54",e4aeF985Db6e3Bb,2943,Dalton,Blanchard,Jackson LLC,West Melody,Timor-Leste,319.531.8769x7938,+1-065-194-3631x5369,logan88@krueger.com,2021-06-10,https://www.oneill-brady.com/
16-Feb-2021,Bill,00.00,"25,860.14","77,580.40",0A8Ab0Fffb2835f,7178,Carol,Velez,Barrera LLC,Sherylmouth,Singapore,548-343-3775x3501,001-996-701-3133,brendan91@shea-bond.com,2020-12-31,https://hardin-wilkerson.com/
16-Feb-2021,Bill,00.00,"38,790.20","38,790.20",77fed1Da3fFFacF,1597,Stephen,Hooper,"Peck, Stark and Nash",Vernonstad,Morocco,+1-513-343-2973x252,237.953.3333x889,tcuevas@moore-rice.com,2021-03-14,https://www.duarte-mcdaniel.com/
16-Feb-2021,Miscellaneous,"2,481.30",00.00,"41,271.50",e3CA7aED67FBB0E,4970,Kathy,Rhodes,Spears-Rivas,Port Amanda,Jersey,724.509.7219x5759,001-518-408-1780x4999,caleb96@proctor.com,2020-09-28,http://www.stevens.com/
16-Feb-2021,Interest,00.00,"5,895.93","35,375.57",6DFd95ac1ad8FBa,8207,Jenny,Tapia,Petty-Livingston,Port Tabithatown,Djibouti,(566)463-2243,045-799-9378,makayla17@caldwell-gregory.com,2020-09-27,https://www.beard.com/
16-Feb-2021,Tax,"25,643.00",00.00,"61,018.57",1FeFCc451dbbe0A,9743,Dakota,Patel,"Velazquez, Mccarty and Rowland",Pollardborough,Saint Vincent and the Grenadines,(158)651-1214x0595,8159860909,darrylmarks@hall.biz,2022-01-25,http://willis.biz/
16-Feb-2021,IMPS,"24,318.80",00.00,"85,337.37",206BC3d36E2D937,3583,Jill,Church,Jenkins-Houston,South Tashaberg,Bangladesh,210.205.3360x4079,2903797817,lucasrichard@chandler-cross.com,2021-01-26,https://www.bradley-hodge.info/
16-Feb-2021,Commission,00.00,"21,334.34","64,003.03",3eeEafAaE0E89Dc,2320,Kristen,Pacheco,Stephenson Inc,Lozanoland,Guyana,604.649.1724x21371,764-287-8916x0203,gmora@mcgrath.net,2021-02-12,http://barrett-larson.biz/
16-Feb-2021,Commission,330.58,00.00,"64,333.61",C1d7CAA0b1e3EBA,9077,Bryce,Washington,Bridges and Sons,New Seanstad,Tonga,075-652-0712x0547,+1-161-946-6916x52826,ronald57@diaz-pratt.info,2020-12-12,https://bruce-hess.biz/
16-Feb-2021,Bill,29.15,00.00,"64,362.76",C0bB49b13054Cc9,5652,Fernando,Fitzpatrick,Zimmerman Inc,Beanburgh,Qatar,3952038506,001-162-189-1956x90984,margaretblake@shepard.net,2022-05-28,http://hampton.com/
16-Feb-2021,Purchase,"17,693.15",00.00,"82,055.91",D0c4cf17fbfEC4a,3977,Christopher,Shields,Glass-Hampton,Medinachester,South Georgia and the South Sandwich Islands,212-880-3700x6971,(801)051-6366x46026,laceyholloway@weeks.info,2021-08-02,https://www.mcbride.com/
16-Feb-2021,Bill,"22,198.74",00.00,"104,254.65",F2a44D88AfcDEeB,4293,Alyssa,Knight,Leach-Gamble,New Dalton,Gabon,(657)878-3639,001-130-774-5993x8831,ceverett@gamble-faulkner.com,2021-07-25,https://lindsey-duncan.com/
16-Feb-2021,Cash,244.00,00.00,"104,498.65",e1795bDcc9dFd0e,7958,Stacy,Coleman,Cortez Group,Lake Janetown,Kazakhstan,+1-118-382-9725x6741,+1-573-114-1364x58839,alexbaxter@glass.com,2020-10-14,http://grimes.info/
16-Feb-2021,NEFT,00.00,"14,928.38","89,570.27",8D72B3c4472A3Bd,5253,Robin,Carson,"Orr, Massey and Barrett",Palmerport,Ukraine,825.314.5321,(105)258-6887x04775,villanuevaalec@whitaker.biz,2022-04-25,https://www.mcbride-dunlap.net/
16-Feb-2021,Cash,285.00,00.00,"89,855.27",f7d0bFCAcbd2Af1,8922,Colton,Macias,Preston and Sons,Duanemouth,Bangladesh,(982)788-4726,069.679.7377x440,jason37@heath.info,2021-02-19,https://peterson.com/
16-Feb-2021,Tax,00.00,"29,951.76","59,903.51",adFCdB9C13947B6,8765,Kellie,Pollard,Hess-Miranda,West Isaiahchester,Italy,795.873.1433x5028,001-500-670-9095x37932,weberkaylee@sosa.biz,2020-11-14,https://www.morales.com/
16-Feb-2021,Bill,00.00,"14,975.88","44,927.63",B68DC9CfBCe279c,7132,Deborah,Roth,Shaw-Burnett,Moraside,Turkmenistan,001-824-221-7748x61238,657-002-7884,tanyamalone@mccormick.net,2021-12-25,http://www.benson.org/
16-Feb-2021,Tax,492.00,00.00,"45,419.63",5fBDE5cDc5F4B96,3499,Angel,Kim,Fox-Conrad,Thomasshire,Oman,635.882.8193x809,001-406-615-9671x81681,tomhall@kline.com,2021-08-25,http://www.grant.com/
16-Feb-2021,ATM,152.24,00.00,"45,571.87",Beb14Bbee95FEFE,6836,Nancy,Baldwin,Mcbride-Zavala,Wallerton,Kyrgyz Republic,340-687-9715x989,(136)687-4732x2797,mezakristine@knox.org,2021-04-21,http://chen.com/
16-Feb-2021,Debit Card,"51,944.69",00.00,"97,516.56",eB6f6648A7A0BD1,546,Carrie,Nielsen,"Ingram, Brady and Simpson",Rebekahmouth,South Georgia and the South Sandwich Islands,0676998498,001-775-546-6228,pkelly@lindsey-barr.info,2020-07-17,https://flynn.org/
16-Feb-2021,NEFT,"4,750.00",00.00,"102,266.56",a0A3E6e4DccD4C8,7129,Connie,Blankenship,"Holder, Ford and Wallace",North Malik,Fiji,008.483.8471,063.731.4949,reesejoy@barry.net,2020-08-07,http://stone-cortez.info/
16-Feb-2021,Purchase,"312,495.00",00.00,"414,761.56",BAB0Bcb6253f2dd,7350,Kevin,Allison,Cain-Yu,Mejiaton,Iran,+1-000-466-1886x9604,577.136.7759x25421,megan30@clayton.com,2020-12-15,https://www.diaz-cardenas.info/
16-Feb-2021,Reversal,00.26,00.00,"414,761.82",1DeA9ff7bC60be0,9238,Mindy,Ball,"Avery, Robbins and Ross",Perryburgh,Saint Martin,001-571-725-7413,+1-650-907-8691x23600,kbrooks@meyers.com,2020-07-11,https://www.white-burton.com/
16-Feb-2021,Tax,00.00,"207,380.91","207,380.91",CB5a8Da7d4aA15a,7648,Daryl,Booker,"Buck, Alexander and Bond",Gambleborough,Guinea,+1-449-294-9516x1186,257-614-1964,soniasexton@smith-frank.net,2021-11-10,http://www.waller.info/
16-Feb-2021,Tax,"14,566.38",00.00,"221,947.29",D8F6Ec6B5EdE6da,2972,Candice,Nixon,Hunt-Santiago,North Nancyberg,Heard Island and McDonald Islands,6335096987,957.984.7008,kiaralindsey@baker-doyle.com,2022-03-21,https://www.mayer.net/
16-Feb-2021,Interest,"596,794.00",00.00,"818,741.29",9Aa1df75dC5DAa9,9875,Nathaniel,Guerra,Holmes LLC,Abbottmouth,Saint Lucia,7788166402,001-859-798-4667x0601,george62@miles.com,2022-05-28,https://lyons-mendez.com/
16-Feb-2021,Cash,00.00,"409,370.65","409,370.64",79DBcd5b753Ab65,8533,Kelly,Sharp,Holland-Bruce,Rachelhaven,British Virgin Islands,027.793.1370x3799,652-323-5967,mhartman@holden.com,2022-01-10,https://www.wise.com/
16-Feb-2021,Commission,"1,883,996.00",00.00,"2,293,366.64",9f6C1EF41E03EB1,1012,Lindsey,Houston,"Avila, Barton and Weeks",West Kathyburgh,Trinidad and Tobago,+1-948-118-2481x570,544.609.2502x38377,kelly48@cantrell-grimes.com,2020-04-15,https://monroe-oliver.com/
16-Feb-2021,Commission,00.00,"458,673.33","1,834,693.31",B75cA9DF92eAfAf,466,Collin,Ortega,Daugherty-Stephens,Tanyafurt,Norfolk Island,+1-414-605-9690,091-142-1887x0417,ufriedman@rowland.org,2021-11-05,https://www.norris.net/
16-Feb-2021,Transfer,219.21,00.00,"1,834,912.52",7cbcfDb0BaC95C8,5121,Xavier,Walsh,Costa Inc,Priscillabury,Vietnam,(380)010-2685x472,737.747.8158,phillippollard@lambert-castillo.biz,2020-04-03,https://www.sanders.com/
16-Feb-2021,ATM,"15,989.14",00.00,"1,850,901.66",5e4500A6D8f7e1F,6331,Nina,Knapp,Fleming-Mclean,South Hunter,Reunion,747.970.2386,969.292.2500x581,malik18@hancock.info,2020-01-31,https://pruitt.net/
16-Feb-2021,Tax,00.00,"925,450.83","925,450.83",Ed753e4CcceEC7D,3757,Shawna,Odonnell,Wells Inc,North Phyllistown,Guinea-Bissau,(899)118-2294x13390,+1-978-682-9977,lorettanorman@hunter-mcdaniel.com,2021-06-21,http://pena-hayden.com/
16-Feb-2021,ATM,"2,019,710.20",00.00,"2,945,161.03",Db3e47FaFdBE7Ba,381,Laura,Zamora,Colon-Sampson,Gardnerport,Uganda,+1-449-493-6747x404,+1-778-276-5327x54075,mchandler@bailey.org,2020-03-15,https://www.murphy.com/
16-Feb-2021,Cheque,"24,358.00",00.00,"2,969,519.03",1Cebed4aFC905FF,8453,Felicia,Montgomery,"Mendez, Clements and Proctor",Lake Chloeberg,South Georgia and the South Sandwich Islands,964-990-7531x2044,+1-181-630-7973,oblackburn@ferrell-wall.com,2022-02-04,http://www.wu.com/
16-Feb-2021,Transfer,"214,107.75",00.00,"3,183,626.78",4E80b48Ae2f5493,4040,Bridget,Trevino,Krause-Stanley,Lake Aimeeside,Andorra,(468)936-1314,3381283810,kingerica@beck.com,2021-07-26,https://howard.com/
16-Feb-2021,Debit Card,388.37,00.00,"3,184,015.15",22fEcCFF4D15EdE,3409,Ivan,Russo,Shah-Garcia,Bobbyfort,Lithuania,499.222.1070x886,167-316-0357x386,atkinsebony@simmons-mills.com,2021-09-24,https://chan.com/
16-Feb-2021,Transfer,00.00,"398,001.89","2,786,013.26",9B6EcAeeFc7bdFA,9558,Jeff,Duncan,"Hughes, Cooper and Price",New Brookehaven,Finland,019.837.9775,182-208-0688,huffmanshirley@huffman-lutz.net,2020-11-07,http://ellis.org/
16-Feb-2021,Bill,381.50,00.00,"2,786,394.76",224b2c596c942F7,4681,Brittany,Benson,Cole-Mcgee,Morafurt,Moldova,6462930426,+1-761-916-5950x37346,chamberscolleen@welch.com,2020-08-26,https://owen.com/
16-Feb-2021,Transfer,00.00,"278,639.48","2,507,755.28",F4EcE1A45d9F8a7,5925,Briana,Bond,Holloway-Calhoun,Deborahstad,Lao People's Democratic Republic,001-063-160-5412x537,(604)961-4328x489,payneneil@patton-bond.info,2022-03-03,https://www.carson-hooper.com/
16-Feb-2021,Commission,00.00,"1,253,877.64","1,253,877.64",5ee4c65a392e6C3,3227,Devon,Estes,"Copeland, Zimmerman and Ramsey",Timstad,Liechtenstein,063-552-3683x133,(832)090-2093,waltergardner@lawrence.biz,2021-11-20,https://holmes-maynard.info/
16-Feb-2021,Tax,20.91,00.00,"1,253,898.55",180C3ff1Bfa0ee5,2794,Yolanda,Macias,"Mcfarland, Malone and Huber",West Bradberg,Isle of Man,368.597.3651,550-766-1883,bobbywebster@lyons.org,2020-11-14,https://mathis.net/
16-Feb-2021,Debit Card,00.00,"313,474.64","940,423.91",d9F553DCAea9a42,7946,Alan,Mooney,Mcdaniel Inc,Dukehaven,Bulgaria,+1-472-103-4051,469-085-9969,vgoodman@galvan.biz,2021-06-16,http://cordova-lester.com/
16-Feb-2021,Cash,00.00,"313,474.64","626,949.27",7951fEB618E8eaE,4683,Alexander,Conley,Harrington-Terrell,Port Omar,American Samoa,726.252.6748x881,(503)291-7365x44598,valenzueladakota@ponce.info,2021-07-06,http://kent.com/
16-Feb-2021,Transfer,00.00,"626,949.27",00.00,2a6fBb57d4FF166,7334,Chelsey,Pollard,"Shaffer, Rhodes and Romero",Boyershire,Trinidad and Tobago,001-609-170-4002x14892,001-630-714-6576x2893,jacob28@jacobs.com,2022-01-17,http://warren.com/
16-Feb-2021,Interest,"3,292.10",00.00,"3,292.10",79B604c25b08F7b,1716,Gregg,Mcclure,"Mcmillan, Sparks and Bean",Samanthaville,Malaysia,+1-110-769-1479x976,9339302604,nbautista@poole-mcneil.com,2020-07-17,http://gross.com/
16-Feb-2021,IMPS,00.00,470.30,"2,821.80",e252dFf95Ed3bE0,4158,Christine,Case,Kaufman PLC,South Alfredborough,Anguilla,(155)490-1747,7245631107,hobbslatoya@garcia.net,2022-05-05,http://leach.info/
16-Feb-2021,Debit Card,00.00,940.60,"1,881.20",949AA8ccC9FEBe5,7460,Colleen,Durham,Mckee-Sexton,Connieside,Saint Pierre and Miquelon,0865284599,675-503-6675x3216,phillipsyvonne@wiggins.net,2020-11-09,http://www.alvarez.com/
16-Feb-2021,Bill,00.00,209.02,"1,672.18",0027bD1919b8266,3041,Brandy,Clayton,"Preston, Francis and Hughes",Tylerville,Barbados,+1-290-867-4564x1931,+1-777-582-6465,norma31@castaneda.net,2022-03-16,http://www.vang.com/
16-Feb-2021,Reversal,00.00,836.09,836.09,85E14A8DdAc7CE8,8974,Sheena,Miles,Decker Ltd,Gwendolynhaven,Bangladesh,858-242-8900,001-576-665-0862x1081,cmanning@leblanc.com,2020-02-04,http://jimenez-baker.biz/
17-Feb-2021,Tax,00.00,836.09,00.00,3BC681EBdC551FD,8794,Allison,Roy,Horton-Maldonado,Carolineburgh,Zimbabwe,+1-393-992-6682x15632,001-868-785-6831x6130,lancemcknight@harrington.com,2021-11-22,https://www.joyce.org/
17-Feb-2021,Cheque,13.10,00.00,13.10,0A6DaC0d5420acC,8334,Barbara,Wu,Barr-Ellison,Proctorborough,Dominican Republic,(645)849-5485x28289,1071131356,hbridges@hayes-watkins.com,2021-03-05,http://serrano.com/
17-Feb-2021,IMPS,"4,282.00",00.00,"4,295.10",0D6C9D499BbD0dF,4214,Brent,Nunez,Tanner Ltd,West Chadfurt,Hungary,(811)626-2151x3994,646.399.9651x1716,belindabenitez@camacho-small.info,2022-01-24,http://www.alvarado.com/
17-Feb-2021,Purchase,00.00,613.59,"3,681.51",DdDcEabdE9f9587,5421,Jaclyn,Mcintyre,Conrad PLC,Christineton,Falkland Islands (Malvinas),+1-780-845-0989x996,001-988-124-0214x265,washingtonclaudia@mcgee.net,2020-10-28,https://www.esparza.biz/
17-Feb-2021,Bill,"3,747.30",00.00,"7,428.81",8AcC9306b4cC5cE,7615,Ann,Choi,Robinson PLC,West Franklinport,Benin,263.114.7795,(829)532-5397,veronicabender@norman-goodwin.com,2021-09-26,http://avery.com/
17-Feb-2021,Commission,00.00,"1,485.76","5,943.05",a40bC7dB8B2DdEa,8799,Tanya,Holmes,"Mooney, Everett and Hayes",East Kellieside,Syrian Arab Republic,001-437-227-6258x9743,594.141.8364,gregmunoz@greene.com,2021-11-15,http://le.com/
17-Feb-2021,Bill,00.00,"1,485.76","4,457.29",d63fC569F1a72DE,8235,Jeremy,Fry,Nichols-Carrillo,South Isaacview,Belize,473.766.8694x85956,(656)516-1655x6652,gillvickie@hoover-stevenson.com,2022-01-02,http://chapman.info/
17-Feb-2021,Bill,24.70,00.00,"4,481.99",93CE401F9Cb3C4c,5008,Danielle,Kim,Hughes Group,East Tashamouth,Bangladesh,2002382133,+1-913-031-4428x075,huertamarc@pierce-glass.net,2022-04-20,http://www.davidson-riggs.info/
17-Feb-2021,Tax,"225,090.25",00.00,"229,572.24",4ac3FBBD6a53390,1060,Lindsey,Frye,"Vega, Villarreal and Wheeler",Sherylburgh,Bouvet Island (Bouvetoya),425.493.0735,+1-939-128-1334,wendy75@newman.org,2022-02-07,https://www.yoder.com/
17-Feb-2021,Commission,"136,957.70",00.00,"366,529.94",cd1D0d3ABf09FBA,430,Dan,Murray,"Mora, Compton and Gregory",Alvaradohaven,Moldova,(516)030-4038x326,580.939.6109,kathleenle@martin.com,2021-06-06,https://www.fowler.biz/
17-Feb-2021,Purchase,437.04,00.00,"366,966.98",4cbfa64a5471B1e,8082,Bailey,Ross,"Mayer, Lane and Simpson",Delacruzmouth,Mongolia,001-010-315-7738x63148,001-133-693-3692,qoneal@dickerson-chaney.org,2021-03-05,http://www.manning.biz/
17-Feb-2021,Commission,03.98,00.00,"366,970.96",AAFEf71DDFCf0ce,6377,Doris,Yu,Crane-Bruce,West Vincentton,Gambia,001-425-008-9825x41046,+1-308-374-6828x70814,tyler98@garrett.com,2021-11-09,http://wood.com/
17-Feb-2021,Cheque,"19,773.00",00.00,"386,743.96",D93C59A4b0E9277,4819,Sylvia,Nixon,Franco PLC,New Maxside,Sao Tome and Principe,231.003.0534x051,177.483.6388,paul71@todd.com,2021-10-23,http://www.rocha.org/
17-Feb-2021,NEFT,"226,540.00",00.00,"613,283.96",2173FAecEAfff3F,5776,Angelica,Black,Guzman Group,Dianechester,Jamaica,3849212106,001-675-516-2026,santoskirsten@villarreal.com,2021-10-12,http://skinner.biz/
17-Feb-2021,Commission,00.00,"61,328.40","551,955.56",eEbD7deF89c5C24,6402,Charlotte,Thornton,Marks-Strickland,Port Derrick,Angola,6414397271,(622)911-7651,normariddle@case.com,2020-07-19,http://davila.net/
17-Feb-2021,Debit Card,"219,670.20",00.00,"771,625.76",cD4f552CeAbd0ab,6162,Jeremiah,Schaefer,Diaz-Morse,Sheppardbury,Vanuatu,141.721.3451x6195,+1-321-031-7622x85490,syates@bell-conway.info,2022-02-11,https://guerra-phillips.com/
17-Feb-2021,NEFT,00.00,"257,208.59","514,417.17",A4c3f8CF4aD3A99,9430,Jaime,Powell,Stark-Lucas,Marisaview,Kenya,001-608-418-8616x5028,001-269-511-2001,merceryvonne@riddle.biz,2021-09-16,http://rush.net/
17-Feb-2021,Purchase,00.00,"257,208.59","257,208.58",c2Bd14ebFcCE39B,3111,Charles,Boone,Hardin-Acosta,New Shaun,Mali,(678)326-0164,8870998276,mcgrathfrancis@nixon.info,2021-05-01,https://heath-blackburn.biz/
17-Feb-2021,Cheque,00.00,"128,604.29","128,604.29",CC27BDb3309CCFd,5880,Carly,Pearson,"Gutierrez, Nash and Garcia",Lucasmouth,Slovenia,(595)693-4208x838,003.541.5715,johnathan63@dorsey-marquez.com,2020-07-05,http://www.hendricks-atkinson.com/
17-Feb-2021,Cash,00.00,"12,860.43","115,743.86",F5Ffd5A23f12d68,1280,Jose,Mahoney,Logan PLC,Alvaradostad,Ukraine,(955)614-8163x64020,001-779-602-9437x100,gmcgrath@melendez.info,2020-06-13,https://stout-cantu.com/
17-Feb-2021,Purchase,00.90,00.00,"115,744.76",5A9a1c1B90DdC36,8949,Sylvia,Cain,Heath and Sons,Johnathanchester,Sierra Leone,084.463.4589x22776,001-432-006-6237,luke12@carlson.com,2020-11-01,https://www.wyatt.net/
17-Feb-2021,IMPS,"3,041.00",00.00,"118,785.76",59c712ACDf547d8,1880,Judith,Moyer,"Holt, Yang and Boyle",New Brianna,Central African Republic,691-349-8187x950,(531)732-7358x595,ale@massey.com,2021-02-12,http://daniel-bray.com/
17-Feb-2021,Cash,00.00,"23,757.15","95,028.61",D9c3Aec96C173d9,4105,Gail,Skinner,"Hinton, Tucker and Peterson",Kyliehaven,Uganda,(164)987-8507,(603)692-2352x8981,joycenash@west-cobb.com,2022-05-07,https://donovan.net/
17-Feb-2021,Reversal,00.00,"11,878.58","83,150.03",dFEcFC7195E7CFB,120,Frank,Mueller,Ford Ltd,Newmanfort,Tonga,040.183.1117x569,338.325.5168,joe34@salazar.com,2022-05-13,https://www.duffy-coffey.biz/
17-Feb-2021,Cheque,19.00,00.00,"83,169.03",3aaADFDb9e0c417,2114,Kathryn,Farley,Gilmore-Garrett,Warrenmouth,South Georgia and the South Sandwich Islands,247.690.3340,(523)201-3864,meghan14@flynn.com,2020-08-31,http://www.mosley.com/
17-Feb-2021,Purchase,00.00,"16,633.81","66,535.22",3076E7ffaBC5D2A,8830,Jason,Clarke,Brewer-Walls,Port Lance,Heard Island and McDonald Islands,172.440.6818,+1-520-500-4917x922,bateseileen@mcgee-buck.biz,2022-02-12,http://jacobson.com/
17-Feb-2021,Commission,00.00,"22,178.41","44,356.81",B21940d265A0fCF,4138,Collin,Harmon,Becker PLC,Savannahfort,Nauru,+1-610-466-1659x76087,+1-595-863-6852x46951,juarezallen@cox-costa.com,2021-11-28,http://richard.com/
17-Feb-2021,Purchase,00.00,"8,871.36","35,485.45",E2E1d8f5b4Db626,6241,Joann,Krueger,Molina-Cameron,Wongland,Greenland,585.937.5798x8911,001-097-427-3609,sramirez@allison.com,2021-11-07,https://sanchez.com/
17-Feb-2021,Cheque,41.78,00.00,"35,527.23",eBcEBD4bF39B1E9,9511,Darlene,Burnett,"Eaton, Vincent and Moss",Juanberg,Vanuatu,121.992.3556x351,791-475-9541,benjaminbullock@hull.biz,2021-07-06,https://www.clayton.com/
17-Feb-2021,Interest,00.00,"3,552.72","31,974.51",FBdEB8beaD4CC91,1860,Natalie,Ochoa,Bond-Banks,South Timothy,Cape Verde,+1-214-881-7936x4542,001-797-064-6943x9216,branchkelsey@fowler-charles.info,2022-04-26,http://carroll-oneal.com/
17-Feb-2021,Interest,"19,637.41",00.00,"51,611.92",7fd07F597e9eE63,2604,Alyssa,Fischer,"Cochran, Bauer and Edwards",Edwinfort,Singapore,001-167-395-2029x1080,776-404-3799x22338,natashawalton@bullock.biz,2020-09-20,http://www.bentley-stark.net/
17-Feb-2021,Bill,00.00,"5,734.66","45,877.26",22D621f990AA28c,3778,Bradley,Park,Clements-Curtis,West Barryborough,San Marino,(411)060-0600x58715,(696)895-1708x60556,bonnie48@fritz-costa.org,2022-05-26,https://montoya.com/
17-Feb-2021,Commission,154.73,00.00,"46,031.99",B7dcD9aFE0FeA41,2062,Kiara,Charles,Long and Sons,Richardfort,Nauru,944.256.0846,(492)273-1599x40679,stephanieedwards@doyle-doyle.org,2020-01-31,http://cowan.org/
17-Feb-2021,Cash,"22,280.00",00.00,"68,311.99",aaEA2FAA5B4A808,1601,Karl,Tanner,Perkins PLC,West Crystalhaven,Madagascar,369-917-0938,001-527-095-4711x066,grossbecky@horne-hunter.com,2020-02-14,http://nelson-steele.com/
18-Feb-2021,Tax,"2,806.98",00.00,"71,118.97",fF431cA5eA804CC,9167,Leah,Kirk,Dorsey-Tapia,West Coltonbury,Heard Island and McDonald Islands,(307)966-9533x63920,834.554.0344x48323,jeffersoncarly@austin.com,2021-06-05,http://boyd-booker.org/
18-Feb-2021,IMPS,46.49,00.00,"71,165.46",19EE920b5514dD6,6685,Latasha,Peterson,Wyatt-Mendoza,West Dalton,France,+1-540-861-2915,327-464-8511x77153,claire01@stevens.com,2021-04-03,http://www.conrad.com/
18-Feb-2021,Debit Card,179.00,00.00,"71,344.46",6C86aE28E42f652,4219,Gavin,Barry,"Bright, Foster and Mitchell",Connershire,Madagascar,+1-029-939-4567,387-269-2658,gmiles@mccarty-burgess.com,2020-11-09,https://benjamin.com/
18-Feb-2021,Tax,00.00,"11,890.74","59,453.72",Dc3Eb2268524A69,7749,James,Hines,"Ramsey, Barr and Dawson",New Russell,Indonesia,989-616-0860,719-624-0683x1496,raymond98@oconnell.info,2020-05-19,http://gross.biz/
18-Feb-2021,Purchase,30.49,00.00,"59,484.21",a69EC70Ac9a6BFf,8551,Cameron,Nichols,Williamson PLC,Lake Tara,Marshall Islands,558.003.6796x276,(547)459-8798x37220,beasleyjorge@payne-hoover.com,2020-06-30,http://www.hayden.info/
18-Feb-2021,ATM,03.30,00.00,"59,487.51",47B103d5B5f10F1,3884,Sherri,Escobar,Russo-Blackwell,Kimside,Peru,801.598.8166,254.433.4701,bnovak@mathews.org,2021-03-25,https://dean.net/
18-Feb-2021,IMPS,484.06,00.00,"59,971.57",388eBDdDC8E6b18,8494,Samantha,Howell,Andrade-Ware,Gordonbury,Gambia,670.266.7549x1617,(887)627-7197x2403,cantrellkirsten@sanford.com,2020-12-09,http://www.cordova.com/
18-Feb-2021,Commission,00.00,"8,567.37","51,404.20",cE0a9F2ba934afa,5757,Kathleen,Crane,Vincent PLC,New Kirk,Afghanistan,417.066.5417,0848769988,jramirez@bird-sutton.info,2020-12-30,https://cohen-coleman.org/
18-Feb-2021,Cheque,00.00,"25,702.10","25,702.10",929685f77ecba7c,2481,Jenna,Maldonado,"Sandoval, Orozco and Hines",East Wyatt,Mozambique,0989799734,(474)377-8546x7640,dmckenzie@wood.com,2020-04-06,http://www.barr.com/
18-Feb-2021,Purchase,02.70,00.00,"25,704.80",cA3bcfE8c5E4E36,2879,Tonya,Bautista,"Lawson, Marshall and Briggs",Isabelport,Zambia,076.971.6171,714.182.4023x72136,vangjoshua@petersen.com,2020-06-27,https://www.mcintyre.com/
18-Feb-2021,ATM,69.00,00.00,"25,773.80",f0b0e0bD51d9fBF,694,Mikayla,Meyers,"Dodson, Stark and Kemp",Claireborough,Mexico,+1-254-998-7082x70063,4548877696,contrerasalice@higgins.biz,2020-02-06,https://www.atkins-pearson.com/
18-Feb-2021,Purchase,00.00,"25,773.80",00.00,Ed3DDEE0De1b769,875,Becky,Obrien,"Dunlap, Page and Duke",North Billfort,Andorra,256.124.9882,+1-503-703-0457x21281,wileygordon@salinas.com,2020-05-02,https://merritt.com/
18-Feb-2021,Tax,"966,022.00",00.00,"966,022.00",e1B07addD3A0eea,9442,Elizabeth,Cooper,"Wilcox, Fuller and Sloan",North Lucas,Peru,(522)898-9494,(518)932-0605,alexandercisneros@wright.com,2021-07-18,https://www.lane.org/
18-Feb-2021,Miscellaneous,00.00,"161,003.67","805,018.33",D00c223EA1F72D1,6906,Summer,Schroeder,"Hebert, Curry and Figueroa",Brandonview,Saint Vincent and the Grenadines,+1-759-893-9156x6299,(463)311-4013x02990,rowejulia@simmons.info,2020-11-13,https://ritter.com/
18-Feb-2021,Miscellaneous,00.00,"115,002.62","690,015.71",4EAF7a8222cFfCC,3429,Duane,Murillo,"Howe, Austin and Lozano",Osborneburgh,Marshall Islands,876-099-5807,001-167-996-2062x3460,beverly16@terrell.info,2021-08-28,https://anthony-clark.net/
18-Feb-2021,Commission,00.00,"230,005.24","460,010.47",d6c06b3d5A3FefE,1916,Howard,Larson,Henson Ltd,Lyonsmouth,Jamaica,155.545.9670x1337,+1-643-000-5438x7377,lmoon@macdonald-meyer.biz,2021-02-18,https://www.morales.com/
18-Feb-2021,Purchase,"2,274.00",00.00,"462,284.47",cAbFB9E93A510AD,3131,Kari,Jensen,"Sheppard, Horn and Cardenas",Taylorstad,Latvia,(208)104-4651,+1-249-976-9760x44721,reesebruce@wilkins.info,2022-02-27,https://www.galvan.info/
18-Feb-2021,Reversal,00.30,00.00,"462,284.77",a2aFD7BcEEC45EB,7431,Tammie,Figueroa,"Carter, Horne and Mcmillan",Port Derek,Portugal,001-011-914-6334x7620,910-486-3220x416,ofry@rivera-norton.com,2020-08-12,http://osborne.com/
19-Feb-2021,NEFT,00.00,"115,571.19","346,713.58",f2A9Fd74aAebb06,3657,Leah,Fernandez,"Powers, Johns and Mccoy",New Joel,Cayman Islands,001-566-415-1181x12795,336.200.0732,calvinavery@burnett-davies.com,2020-02-28,http://burch.info/
19-Feb-2021,Transfer,00.00,"115,571.19","231,142.39",1da22c6e8C496C2,3783,Doris,Gallegos,Dawson-Stark,Hartmanview,Lebanon,795.909.0725,960-969-3254x25272,zromero@myers.net,2021-04-05,http://jacobson.com/
19-Feb-2021,IMPS,"5,165.00",00.00,"236,307.39",E4d3aCaF4be3BDF,4766,Brandon,Rogers,"Nguyen, Harris and Thornton",Rubenland,Guatemala,(982)992-3408,2254622139,mikaylaclay@berry-melendez.com,2022-03-30,http://www.grimes.com/
19-Feb-2021,ATM,"1,179,924.00",00.00,"1,416,231.39",79DF8dB5CBBe6BF,4130,Daniel,Peters,"Carr, Morton and Vega",Rodgerston,Kuwait,771.798.6577x68518,4763452300,tcarey@chaney.com,2022-04-17,http://www.day.net/
19-Feb-2021,Debit Card,84.70,00.00,"1,416,316.09",a7E40d6D4CDdeB7,6187,Kristin,Molina,Brock Inc,Kelliehaven,Chile,730-369-0015x622,001-902-805-5954x887,greersierra@kane.com,2021-06-06,http://fowler.com/
19-Feb-2021,Tax,"2,881.00",00.00,"1,419,197.09",a9dCa7ac9Ce2Ab2,987,Marvin,Fitzgerald,Matthews-Buckley,Stacytown,Martinique,+1-227-729-5055x928,(699)160-4397x611,eperez@thomas-montoya.com,2021-12-22,http://mays-saunders.com/
19-Feb-2021,Interest,00.00,"473,065.70","946,131.39",A8BCD5969FacBF7,9250,Edwin,Harrison,Hall-Mcgrath,Kristyville,Armenia,+1-600-634-9836x70055,+1-652-685-6293x7221,dennisstefanie@ortiz.com,2022-03-15,https://larsen.com/
19-Feb-2021,RTGS,00.00,"105,125.71","841,005.68",31B68C3A8c8c3Bb,6503,David,Page,Rivera-Rivera,New Normaland,United States Virgin Islands,001-751-614-9145x35749,304-445-3680,jacob41@pierce-cruz.com,2020-06-17,http://www.johnston.com/
19-Feb-2021,IMPS,00.00,"210,251.42","630,754.26",89Aa2b94dC05FB1,7612,Ross,Pham,Gentry-Soto,Port Tasha,Peru,001-339-302-4307x5895,001-333-586-7546x064,woodardjoe@keller.org,2020-10-12,https://blackwell.com/
20-Feb-2021,Reversal,56.26,00.00,"630,810.52",61cFB7af9728b8e,9819,Sara,Armstrong,Dennis-Wang,East Katelynmouth,Kenya,(172)442-9477,(663)085-1437,eugene05@foster.com,2020-10-28,http://www.cordova.org/
20-Feb-2021,Miscellaneous,"110,838.31",00.00,"741,648.83",9163deeC45020Fe,7635,Emily,Sharp,Anderson Inc,South Edwin,Taiwan,898.240.8662,358.268.7598,iwatkins@sanchez.com,2020-07-01,https://www.cantu.org/
20-Feb-2021,Tax,"48,191.00",00.00,"789,839.83",EDeEdC52ab405e0,3049,Yesenia,Cochran,"Welch, Villarreal and Morrison",Lesterbury,American Samoa,(089)608-0820x9309,850.809.3733,hstevens@choi.info,2021-09-21,http://www.ramirez-schultz.info/
20-Feb-2021,Tax,"1,182,284.00",00.00,"1,972,123.83",0fD1c65a1abF091,2853,Vicki,Logan,Roberts PLC,West Joannamouth,Germany,684.504.6094x1033,987-687-7123x338,claudia88@morrow-coleman.info,2022-02-08,https://www.harrell.info/
20-Feb-2021,Reversal,30.23,00.00,"1,972,154.06",5193CdE8DDEBE31,992,Darius,Collier,Mullen and Sons,Sotomouth,Gabon,001-114-652-1153,121.092.6078,bblack@hancock-haley.com,2021-11-21,http://www.walters.com/
20-Feb-2021,Reversal,00.00,"281,736.29","1,690,417.77",4A0ACec7f3B17aA,1017,Joyce,Levy,Madden PLC,Pearsontown,Monaco,(830)148-4987x243,001-330-441-0680x321,bradleyhenderson@huerta-coffey.com,2021-08-08,http://www.edwards.org/
20-Feb-2021,Purchase,00.00,"1,690,417.77",00.00,2b94E0a823C2FeF,206,Jose,Morse,Ford-Dixon,West Brendan,Chad,849-351-2710x10812,001-684-502-1388,woodsdevin@maldonado.org,2020-05-17,https://www.wheeler-wong.com/
20-Feb-2021,Commission,"426,551.00",00.00,"426,551.00",d3FDFE18BfdBaaD,3168,Johnathan,Reeves,Franco-Buckley,North Kirkburgh,Cote d'Ivoire,001-159-347-2040x3572,+1-472-358-2426x381,deanralph@christian.com,2021-02-24,https://www.velazquez-hays.com/
20-Feb-2021,IMPS,00.00,"42,655.10","383,895.90",ECe2F5b98efaCa0,7972,Lynn,Vazquez,Ingram-Johnston,West Veronica,Iceland,001-036-887-3388x31593,728-598-8470,nmeza@beltran.info,2020-06-10,http://mccann-hoover.info/
20-Feb-2021,Debit Card,185.00,00.00,"384,080.90",63FA0cEb1cf0fF2,4886,Tara,Mckay,Branch and Sons,Rogerschester,Japan,001-063-286-9894x889,397.921.0407x83516,vfloyd@dunn-spears.com,2020-12-30,http://morse-lara.com/
20-Feb-2021,IMPS,00.00,"128,026.97","256,053.93",fb1F714EFBff0cA,5620,Rita,Porter,Browning-Fletcher,South Roger,Malta,001-673-264-0198x51464,7657635773,dominguezkatherine@hensley.biz,2022-04-15,http://www.gilbert.com/
20-Feb-2021,RTGS,00.00,"85,351.31","170,702.62",ECde3d39D47C0d6,9224,Roger,Graves,"Mcgee, Robinson and Callahan",Barronstad,Lao People's Democratic Republic,(733)829-6418,5789093821,wesley80@dudley.com,2020-08-26,http://cannon-hutchinson.org/
20-Feb-2021,ATM,02.00,00.00,"170,704.62",0c98adECafef27E,3889,Latasha,Cherry,Werner-Myers,Mckenzieview,Norfolk Island,930-242-1249x2899,(836)822-7583x0076,reginald12@stanton-dougherty.com,2021-04-06,http://www.delgado.com/
20-Feb-2021,Debit Card,00.00,"34,140.92","136,563.70",d6e8c838F9ba64b,7553,Alfred,Ferguson,"Shepherd, Franklin and Buchanan",South Jakestad,Ukraine,(478)808-7409,818-024-0687,garciavirginia@ramsey.com,2020-06-30,https://walter.com/
20-Feb-2021,Commission,00.00,"136,563.70",00.00,2141FcDE042dFdd,3234,Suzanne,Vasquez,"Hester, Shah and Wilkins",South Martha,Norway,821-718-2287x85602,(728)645-2908x90115,ashleypowell@howe.com,2020-02-21,https://herrera.com/
21-Feb-2021,ATM,"3,167.00",00.00,"3,167.00",E311a1f2E7dBABb,3369,Phillip,Travis,Richard-Fleming,Maxwellmouth,Luxembourg,+1-241-475-1726,(708)201-9142x230,qrubio@bean.net,2022-03-26,https://guerra.org/
21-Feb-2021,Commission,07.30,00.00,"3,174.30",E9C8790fD0dD6DC,6193,Tristan,Mccoy,Silva-Barnes,Franklinville,Portugal,001-021-023-7986,381-553-4337,wgreer@mckenzie.info,2021-05-17,https://www.murphy.com/
21-Feb-2021,Reversal,"1,350.00",00.00,"4,524.30",61cFB7af9728b8e,9819,Sara,Armstrong,Dennis-Wang,East Katelynmouth,Kenya,(172)442-9477,(663)085-1437,eugene05@foster.com,2020-10-28,http://www.cordova.org/
21-Feb-2021,IMPS,00.00,452.43,"4,071.87",bBB6Bb4194361cC,122,Holly,Fletcher,Ford and Sons,Newmanbury,Thailand,001-583-336-8021x57385,+1-072-547-1221x03876,pammorales@james-benjamin.net,2021-03-17,http://werner.org/
21-Feb-2021,Interest,02.00,00.00,"4,073.87",E6d4b802f69cBE7,4585,Todd,Huff,Harding-Garner,Batesstad,Brunei Darussalam,+1-118-741-3029x2047,001-459-484-5733,rbates@brock.org,2022-01-15,http://goodwin-arias.org/
21-Feb-2021,Tax,00.00,407.39,"3,666.48",a0bBBB555f96CAe,4498,Mariah,Prince,Sexton-Norton,Jackmouth,Macao,001-317-108-3296x077,(410)057-9950x987,riverabrad@hurst.com,2021-12-28,https://brooks-schaefer.com/
22-Feb-2021,Debit Card,00.00,523.78,"3,142.70",Aef541889C939f6,7258,Diana,Duran,Barry Inc,Spearstown,Denmark,135.963.5086x115,+1-115-925-6730x6549,jorgehess@key-fitzpatrick.org,2021-11-02,http://cook.org/
22-Feb-2021,Cheque,"23,344.64",00.00,"26,487.34",E1abaEB221Fc958,8293,Kathy,Gilbert,"Haas, Guzman and Hicks",South Katrina,Isle of Man,904.385.5514,042-210-6358,rdavidson@noble-glover.com,2020-03-22,https://www.bridges.biz/
22-Feb-2021,Purchase,00.00,"6,621.84","19,865.50",DFcFcA6a4C8f4Ef,7186,Andre,Benitez,Jenkins and Sons,Arthurton,Gambia,057.819.2015x6701,3829629415,matthewhowell@dodson-fitzpatrick.com,2022-04-30,http://haas.biz/
22-Feb-2021,Reversal,00.00,"6,621.83","13,243.67",84F54fBbCb6CC11,8759,Alejandra,Holden,Krause-Johnson,East Jody,Saint Lucia,011-015-0897x4782,+1-903-918-1253x958,vincentwendy@prince.com,2021-04-13,http://jordan.org/
22-Feb-2021,IMPS,"1,954,740.50",00.00,"1,967,984.17",B47F1eBf52B2E7A,8937,Cheyenne,Grimes,Black-Benson,Port Adrienne,British Indian Ocean Territory (Chagos Archipelago),001-819-270-5276x94829,376.937.3156x66712,ralph05@whitaker.com,2022-05-04,https://hickman-morgan.com/
22-Feb-2021,NEFT,316.23,00.00,"1,968,300.40",c9fcEe4acE76E14,5477,Javier,Brandt,Ware Ltd,Chavezland,United States Virgin Islands,152.277.8766,001-180-716-4168,qsmith@newton.com,2021-09-20,http://mclaughlin-meyers.com/
22-Feb-2021,Cheque,05.40,00.00,"1,968,305.80",Ad79e23EE8ba1b7,6011,Allen,Garcia,"Downs, Lynch and Tran",North Margaret,Trinidad and Tobago,335-821-0963x6467,6115909210,carlybryant@hendrix.com,2020-09-16,http://www.vega.net/
22-Feb-2021,Purchase,00.00,"218,700.64","1,749,605.16",6CDef9Ed36B58D4,1861,Shelley,Bruce,Kelley Ltd,South Jesus,Ecuador,416-808-2413,(912)391-7872,mpayne@villegas-french.com,2021-06-09,https://mcintosh.com/
22-Feb-2021,Tax,00.00,"249,943.59","1,499,661.57",c8C0DC6B1b1cbDF,6825,Christina,Morris,"Schneider, Mcintosh and Key",Kellerville,Oman,001-894-357-8906x48091,523-259-6018,marilynsloan@duncan.com,2020-12-11,http://sandoval-gallegos.com/
23-Feb-2021,NEFT,17.00,00.00,"1,499,678.57",AeEaeDc36fAa1BC,6409,Jade,Sweeney,Rowe Ltd,Karenton,Cayman Islands,653-114-8608,(103)292-6514x7370,jose41@mora.com,2020-02-09,https://www.harmon.com/
23-Feb-2021,Interest,"1,293,273.00",00.00,"2,792,951.57",eB286eFAd2e38ba,8178,Javier,Pugh,"Goodwin, Parrish and Huff",New Desiree,Paraguay,+1-340-936-1428x8937,(433)648-4568,alextodd@barron.com,2021-02-11,https://www.blankenship.info/
23-Feb-2021,Cash,400.98,00.00,"2,793,352.55",B9EDeCA8DBD5cE6,8297,Evan,Michael,"Mitchell, Crawford and Cobb",Port Kendrafurt,Myanmar,+1-927-817-7560,759.170.5580,qhinton@shepherd.com,2021-11-18,https://www.nixon-valenzuela.com/
23-Feb-2021,Reversal,00.00,"2,793,352.55",00.00,C4BA7bcACe4A939,8452,Jane,Vasquez,Bass LLC,South Robinburgh,Armenia,475.542.9046,790.656.5425x52031,adrian90@williams.com,2022-04-25,http://www.hays-winters.net/
23-Feb-2021,Tax,"3,719.00",00.00,"3,719.00",e010b9FAAFa6366,8315,Chloe,Anderson,Rhodes-Durham,Mosesstad,Brunei Darussalam,001-486-712-6029x6810,(110)537-0452,karinacaldwell@hull.biz,2020-02-14,http://www.thomas.com/
23-Feb-2021,Debit Card,03.32,00.00,"3,722.32",CaceDdc7aBd7e6A,1451,Austin,Shepherd,Salinas-Pham,Bonillamouth,Fiji,(876)120-5712,556.220.9826x071,yglass@stanley.com,2020-05-29,http://king-velazquez.org/
23-Feb-2021,NEFT,"87,046.00",00.00,"90,768.32",2f66C4FcE68caca,915,Mercedes,Cochran,"Sanders, Savage and Aguirre",North Geoffrey,Nigeria,008.420.1914,+1-181-166-7267,claudia30@lewis-hart.info,2022-04-03,https://solis.org/
23-Feb-2021,Tax,"21,650.60",00.00,"112,418.92",b913E1515bFEDC3,124,Duane,Brock,Beltran LLC,East Rebeccashire,French Guiana,503.800.5804x8397,001-296-131-0612x3322,sarahpotts@bradford.com,2020-05-07,https://alvarado.com/
23-Feb-2021,Reversal,02.00,00.00,"112,420.92",F55308bdbcB2230,4436,David,Stephens,"Acosta, Santiago and Newman",Hernandezburgh,Aruba,+1-965-357-7162x27711,001-770-529-1592,jaime60@keller.org,2021-09-03,http://castaneda-pope.com/
23-Feb-2021,IMPS,00.00,"37,473.64","74,947.28",71ddadEfB8ce6cf,9506,Carl,Ray,Stafford-Figueroa,West Summer,Chad,+1-625-385-1844x180,001-464-130-7168,benjaminkim@holder-blake.com,2020-02-07,https://www.huffman-wilcox.com/
23-Feb-2021,Purchase,"2,556.70",00.00,"77,503.98",cfDF24BE81fE1F0,6617,Kristy,Hopkins,Heath-Macias,South Lynnburgh,Timor-Leste,+1-711-884-9926,+1-934-144-7817x894,ana45@roth.com,2021-08-11,https://quinn-wilkins.com/
23-Feb-2021,ATM,365.00,00.00,"77,868.98",cE19c4B101cD7bF,3075,John,Fields,Sandoval-Ponce,West Lisa,Ireland,563.414.4375,(287)463-1916,jessicasimpson@ewing.org,2021-11-05,https://curtis-rocha.org/
23-Feb-2021,Bill,00.00,"9,733.62","68,135.36",3FDaAab7c3Ae621,8076,Beverly,Hunter,Cooper-Jennings,Craigtown,Botswana,001-073-574-8178,+1-812-908-4666x36569,margaret16@blevins.com,2020-11-23,http://www.sampson.com/
23-Feb-2021,Reversal,05.00,00.00,"68,140.36",e35ca1611b0C97E,4787,Amanda,Guerra,"Escobar, Butler and Juarez",Lake Mikaylamouth,Svalbard & Jan Mayen Islands,+1-475-733-0714x5436,+1-293-332-1273,zjames@greer.biz,2021-01-11,https://kirby.org/
23-Feb-2021,Tax,"3,741.00",00.00,"71,881.36",F8a905EbEE8cFCf,8848,Adam,Spears,Yu-Hahn,East Stephenstad,Comoros,9313302703,319.667.5392x145,luke67@garrett.com,2022-04-03,https://www.ball-sosa.org/
23-Feb-2021,Purchase,00.00,"11,980.23","59,901.13",7a3FF6A4eFd1fAa,3870,Dorothy,Mccarthy,Cantrell-Mercer,Wayneport,Mali,516-260-6483x35644,1259168069,eric28@benton.com,2021-07-23,http://www.griffith.com/
23-Feb-2021,Cash,00.00,"5,990.11","53,911.02",50f4C6E1c44Da9E,4505,Tom,Gray,Douglas PLC,Sierraview,Jordan,487-609-3455,7803375412,vhuffman@odonnell.com,2022-05-09,https://www.hinton.net/
23-Feb-2021,Commission,00.00,"17,970.34","35,940.68",6d1de21C407B2f4,9497,Jeffrey,Costa,"Howe, Berg and Brewer",Alexandertown,Bulgaria,389-590-6544,(345)309-5112,jaydominguez@molina-sharp.com,2020-01-05,https://walker.com/
23-Feb-2021,Interest,00.00,"35,940.68",00.00,beBc0D24B8b8cc2,8274,Shelby,Randall,Gregory-Austin,Mercadoton,Bahamas,(985)420-5968x907,(443)233-4721,fraymond@ali.biz,2021-09-09,http://www.cochran.com/
23-Feb-2021,ATM,180.10,00.00,180.10,5ab036db472aB64,6769,Todd,Branch,Aguirre-Hill,Lanechester,Northern Mariana Islands,183-821-8581x855,001-947-416-8656x4227,meaganmcclure@carlson.com,2020-07-27,https://www.dickerson.net/
23-Feb-2021,ATM,09.80,00.00,189.90,f8E52B7f9ADc80d,8687,Jonathon,White,Barron-Charles,Lake Rebeccaton,Indonesia,+1-597-546-8804,4876597307,velasquezgwendolyn@keller-johnston.com,2020-05-11,https://beasley.net/
23-Feb-2021,Purchase,"2,354.20",00.00,"2,544.10",B8bc43817e65d5e,9591,Nichole,Flowers,"Compton, Gregory and Greene",South Matthew,Marshall Islands,836-618-8958x89328,(186)733-8324x626,groman@miranda.com,2021-03-23,http://www.farley.com/
23-Feb-2021,Commission,"4,802.90",00.00,"7,347.00",BFeb7E4CD56e21F,950,Johnny,Chapman,Rivas Inc,East Jaredland,Jamaica,496-712-6734,752.927.2754,shelly22@holland-doyle.net,2020-02-22,http://www.dennis.info/
23-Feb-2021,Commission,"89,194.20",00.00,"96,541.20",4a8A2BeCB61dC00,1556,Maureen,Ewing,Barber Inc,Port Angie,Sierra Leone,001-103-054-9356x84861,001-421-053-3079x09754,albert39@guerrero.net,2020-06-13,https://werner.org/
23-Feb-2021,Tax,48.10,00.00,"96,589.30",CdFECf4FE6aFfD4,7290,Brent,Ponce,"Cannon, Riggs and Parsons",South Kathy,Iceland,001-036-890-8672x2325,887.653.7589,scastro@collins.com,2020-03-24,http://www.rivera.com/
23-Feb-2021,Cheque,00.00,"96,589.30",00.00,63AfBfFC1Ea62b2,3011,Shane,Carson,"Hawkins, Petty and Bishop",North Tommy,Grenada,001-990-151-3942x679,565.635.3197,qcohen@nicholson.com,2020-11-11,https://www.mays.com/
23-Feb-2021,Bill,"3,026.20",00.00,"3,026.20",B2ECE6Cc7f2deC0,640,Alan,Villegas,"Alvarado, Kaufman and Lamb",North Ericburgh,Cote d'Ivoire,+1-249-979-3562x95692,+1-618-504-7515x57239,uwebb@carroll.com,2022-05-09,http://yates.com/
23-Feb-2021,Debit Card,00.00,504.37,"2,521.83",DAFE4aEB6c2eD69,4876,Kaitlyn,May,"Guerra, Washington and Mcfarland",Port Sheliaberg,Benin,(121)530-1014x978,451-217-2296x76566,jimmyanderson@casey-liu.com,2020-09-01,http://www.terrell.biz/
23-Feb-2021,Miscellaneous,00.00,360.26,"2,161.57",6afCD0fEBa8cdF3,6349,Earl,Chung,Matthews and Sons,Port Nathanside,Ireland,1744209887,(019)792-9458x82070,maxwell79@dorsey-gregory.com,2020-07-25,https://www.hickman-pena.com/
23-Feb-2021,Bill,00.00,360.26,"1,801.31",2d2E8e0fE60Cd74,9742,Stacey,Deleon,Fletcher LLC,Garnerfurt,Malawi,+1-528-620-6362x4202,001-086-873-3510x59114,erik33@wilson.info,2020-11-30,https://www.cook.com/
23-Feb-2021,Reversal,"164,760.20",00.00,"166,561.51",C03446cc839bFEe,7023,Melinda,Kelly,Dennis-Richardson,Bergview,Macao,001-134-209-1820x0690,(826)792-6625x2908,ypotter@hobbs.com,2021-12-15,http://www.cline-hall.com/
23-Feb-2021,ATM,00.00,"83,280.76","83,280.76",9aD772d3c5dBeF3,4295,Sarah,Duffy,Blankenship Ltd,Tonymouth,Tonga,757.561.7313x7076,001-564-372-4578x938,sdalton@summers-orr.com,2020-02-02,http://www.zuniga.com/
23-Feb-2021,Commission,00.00,"10,410.10","72,870.66",5741d21F44f895e,4911,Mary,Hawkins,"Larsen, Dixon and Ellison",Singhbury,Greece,+1-275-931-7124,+1-426-966-1731x92727,kellie00@taylor.org,2021-06-10,https://www.lucas.info/
23-Feb-2021,ATM,05.00,00.00,"72,875.66",cCdaaCEff7ab4a0,1818,Timothy,Shaffer,"Mullins, Cisneros and Boyd",West Jesus,Wallis and Futuna,001-686-209-7368x12737,+1-117-660-4653,laneandres@gilbert.com,2020-02-12,http://www.wilcox.com/
23-Feb-2021,Miscellaneous,210.40,00.00,"73,086.06",ae69ced3afAFD5a,2838,Jane,Brandt,"Meyers, Compton and Lucero",Sanchezmouth,Pitcairn Islands,007.112.8036x95749,540-998-1408x87295,kristina76@nash.net,2022-02-11,http://pierce-ryan.com/
23-Feb-2021,IMPS,00.00,"36,543.03","36,543.03",97DE4aDEeAE20ea,8495,Tanya,Padilla,Montes-Andrade,Derekmouth,Canada,815.611.0339x11358,780.016.1349,heidirosario@wise.com,2020-06-06,http://benjamin-francis.com/
23-Feb-2021,RTGS,00.00,"4,567.88","31,975.15",d7f67f3cC13506c,8632,Nichole,Miranda,Bell-Giles,Mejiamouth,Djibouti,592.999.2729,(163)887-3896x3933,zkey@small-hickman.com,2021-12-25,http://www.fitzpatrick-haynes.com/
23-Feb-2021,Reversal,00.00,"7,993.79","23,981.36",42c3A93DC8C1aa7,8267,Derek,Wells,Meadows-Lin,Jonmouth,Albania,623.371.0194x423,(421)585-6710,duanegarcia@meadows-robbins.com,2021-05-27,https://blake-crane.com/
23-Feb-2021,IMPS,00.00,"23,981.36",00.00,578bff300a7Db6B,5346,Adam,Neal,Allen Ltd,Port Melanie,Israel,+1-469-898-4348x20145,+1-500-120-3500x041,randolphpaula@richards.com,2022-02-28,http://www.ochoa.com/
24-Feb-2021,Commission,297.70,00.00,297.70,09aC7f4Eb2d49CA,8052,Parker,Rocha,Vang LLC,Pennytown,Niue,001-734-621-6219x00253,8594502516,bill23@robinson.org,2021-06-05,http://price.com/
24-Feb-2021,Transfer,00.00,99.23,198.47,70ace5bad5Ce2a7,373,Sally,Golden,Rios and Sons,Jeanneview,Morocco,074.545.4625,412.164.8140x5271,stricklandregina@perez.info,2020-04-21,http://nichols.com/
24-Feb-2021,Purchase,"43,965.00",00.00,"44,163.47",EFE1d55abF0Aae1,9975,Jasmin,Delacruz,Ramos PLC,Cummingsshire,Saudi Arabia,1924373362,365-441-8393x39837,kmalone@rivas-logan.biz,2021-03-27,http://chapman.net/
24-Feb-2021,Transfer,11.20,00.00,"44,174.67",Bacdad22DFCC4a4,3282,Eddie,Arias,"Castillo, Davis and Arnold",Port Robyn,Mauritius,(467)116-2386x230,621-505-3000x794,marshallbrenda@matthews.com,2020-01-29,http://hunter-mclean.com/
24-Feb-2021,RTGS,"586,552.50",00.00,"630,727.17",B2DC6ad9e8bFff9,8557,Dan,Ortiz,"Mcpherson, Montgomery and Khan",Lake Dariustown,Togo,(937)468-6840,159-618-8218,villanuevadakota@bowers-lopez.com,2022-01-25,http://www.morse.com/
24-Feb-2021,Commission,30.77,00.00,"630,757.94",0aA5e9F1edda48f,7313,Tabitha,Cameron,Carney LLC,Lake Brandyberg,Brunei Darussalam,038-520-5566x947,0382115577,justinmccormick@spence.info,2021-08-16,http://www.bradley.com/
24-Feb-2021,ATM,00.00,"78,844.74","551,913.20",1dEc03AD36cb506,6855,Nancy,Kelley,Griffin Ltd,South Monicaview,Indonesia,341-250-5312,(169)932-5690x585,ocox@figueroa.com,2020-09-05,http://brooks-stephenson.info/
24-Feb-2021,Cheque,00.00,"55,191.32","496,721.88",f5E80Bd7e96b5D6,7696,Edwin,Wang,Mcknight LLC,Jodimouth,Gabon,379-077-6024x411,852-408-8261,dsheppard@mcintyre.info,2020-02-29,http://www.whitney.com/
24-Feb-2021,Miscellaneous,00.00,"165,573.96","331,147.92",eDe45bf6aC8ADf2,2165,Daniel,Saunders,Deleon PLC,Murillomouth,Anguilla,+1-303-100-7355x72073,(339)014-6677x12329,lshea@davis.biz,2020-11-09,http://espinoza.com/
24-Feb-2021,Transfer,"189,318.00",00.00,"520,465.92",28D7BcC82d076F2,21,Barry,Meadows,"Weiss, King and Morrison",Wallston,Congo,629.168.7457,001-092-440-6540,basschristian@faulkner.com,2020-01-01,https://chavez.com/
24-Feb-2021,Interest,"12,090.45",00.00,"532,556.37",4C657EFbce24508,406,Mercedes,Hester,Olsen-Humphrey,Amandahaven,Eritrea,008.963.8003,(756)588-4888x2158,thomas95@watson.info,2022-02-19,http://www.solis-villa.info/
25-Feb-2021,Debit Card,00.00,"133,139.09","399,417.28",a3AdE5d1fD0ebbb,8212,Wesley,Hebert,Nguyen-Mcgrath,Carolhaven,Namibia,764-200-9500,(303)383-9420,aford@gilbert-mcclain.biz,2021-06-07,http://www.velez.com/
25-Feb-2021,RTGS,142.00,00.00,"399,559.28",21bAD5deAffd240,7281,Hayley,Mueller,"Herring, Thompson and Burton",Jillianville,Montserrat,+1-238-912-7961x552,9704910038,ohampton@roberts.com,2020-10-28,http://www.bradley.org/
25-Feb-2021,Debit Card,00.00,"44,395.48","355,163.80",EB54EF1154C3A78,1,Heather,Callahan,Mosley-David,Lake Jeffborough,Norway,043-797-5229,915.112.1727,urangel@espinoza-francis.net,2020-08-26,http://www.escobar.org/
25-Feb-2021,Miscellaneous,00.00,"59,193.97","295,969.83",ebed34126980Cb7,7339,Frank,Bruce,Nolan-Gallegos,East Kiarahaven,Chile,622.949.5024,713-104-0496x891,johnathan64@bradshaw-nelson.com,2020-02-03,http://quinn-may.info/
25-Feb-2021,Transfer,00.00,"49,328.31","246,641.53",A8B3f3AB539AF11,7264,Ronnie,Bryant,Ali-Coffey,North Crystalfort,Dominican Republic,288.848.5745x9536,647-502-9617x337,sarah35@combs-krause.com,2021-08-09,http://www.pollard-jefferson.net/
25-Feb-2021,Debit Card,117.00,00.00,"246,758.53",07eea61711B52EE,7644,Abigail,Douglas,Evans PLC,Lake Coleview,Madagascar,0397487452,5464484049,cindyfranco@wyatt.com,2021-03-08,https://www.roy-archer.com/
25-Feb-2021,Purchase,"1,900,377.25",00.00,"2,147,135.78",Bb4e0E83744a227,9170,Anna,Estes,Sloan-Christensen,Amandaburgh,Cuba,(708)515-5250x679,045-668-0385,mackenziemartinez@bush.info,2020-02-05,http://www.walters.com/
25-Feb-2021,Bill,00.00,"214,713.58","1,932,422.20",6d3d9e8F86679fb,4031,Ana,Paul,Humphrey and Sons,East Amandashire,Vanuatu,660-177-1599,261.516.7150x59456,edwinkey@benson.com,2022-02-10,http://www.monroe.com/
25-Feb-2021,Miscellaneous,00.00,"322,070.37","1,610,351.83",d9F553DCAea9a42,7946,Alan,Mooney,Mcdaniel Inc,Dukehaven,Bulgaria,+1-472-103-4051,469-085-9969,vgoodman@galvan.biz,2021-06-16,http://cordova-lester.com/
25-Feb-2021,Purchase,00.00,"201,293.98","1,409,057.85",7e15Fe803feCEFB,6553,Marcus,Delacruz,Burnett PLC,Jesuschester,Paraguay,(275)896-6813x56899,(461)194-3624x492,arianahayes@stein.com,2021-04-09,https://cain-spence.biz/
25-Feb-2021,Reversal,"737,500.25",00.00,"2,146,558.10",968eaaF635127C2,6259,Bruce,Vasquez,Mckinney-Odom,Dannyside,Swaziland,001-296-967-2533,396-032-5446,hcarrillo@rush-lozano.com,2022-05-27,https://vang.com/
25-Feb-2021,Purchase,"20,143.50",00.00,"2,166,701.60",A458cb8Bee0b7Ea,3671,Michelle,Crane,"Ellison, Berg and Bridges",North Gabriel,Malawi,+1-321-868-2800x04575,+1-856-647-3509x753,nsingh@mccann.com,2021-07-09,https://www.kane.org/
25-Feb-2021,Cash,"206,011.22",00.00,"2,372,712.82",A52acbbEd963AE2,5115,Garrett,Roberson,"Hayden, Boyle and Lester",East Mikayla,French Guiana,154.347.6477,001-179-796-9134x12922,lopezvanessa@villa.com,2020-04-25,http://www.proctor-palmer.net/
25-Feb-2021,Debit Card,00.00,"338,958.97","2,033,753.85",6baB4aA113eB446,5521,Shelley,Phelps,"Riggs, Contreras and Allen",South Steve,Netherlands,275.069.6731,779.885.2413x25416,dominic75@may.com,2022-05-08,http://www.avila.com/
26-Feb-2021,Tax,00.00,"225,972.65","1,807,781.20",35c8C0eEa4C9a8E,7716,William,Knox,Perez Inc,Nunezburgh,Finland,182.722.1578x393,+1-784-819-7762x21619,eho@gross.com,2020-09-15,http://mccarthy-marquez.com/
26-Feb-2021,NEFT,00.00,"301,296.87","1,506,484.33",4167Bd6cCacB3a1,1919,Isabella,Koch,Gould-Montes,Lake Melody,Togo,739.874.7103x5216,816.128.1343x4758,angela09@herman.com,2022-04-26,https://burke-jarvis.com/
26-Feb-2021,Cash,00.00,"251,080.72","1,255,403.61",dEd3cA84E2baa77,8292,Brenda,Lowery,Fritz-Hodges,East Gracebury,Mali,(649)433-2277x68552,620.546.2797,hunteryolanda@oconnell-hess.com,2021-04-04,http://www.mahoney-mercer.com/
26-Feb-2021,Transfer,00.00,"209,233.94","1,046,169.68",f2BDB1FdA5a7b3e,4132,Tara,Hensley,Mosley Group,East Susan,Papua New Guinea,633-333-2193x1792,(783)388-5277,kaufmankristie@thornton.org,2021-10-04,http://hays.biz/
26-Feb-2021,Interest,00.00,"174,361.61","871,808.07",dfFC3535040bB1b,2656,Cassandra,Washington,"Simpson, Flowers and Li",Clarkeport,Germany,(897)789-3116,143-888-9884x2883,duffykristen@becker.com,2020-12-24,https://owens-underwood.com/
26-Feb-2021,Tax,00.00,"871,808.07",00.00,8e7B7aea003B8f9,6876,Bob,Underwood,Jarvis-Espinoza,Rogerville,Germany,+1-588-574-3302x87331,744-916-7959x017,blakezhang@pollard.info,2021-04-12,https://carlson-mcintosh.com/
26-Feb-2021,Reversal,"66,507.97",00.00,"66,507.97",f612fDc204BDfdd,3229,Raven,Hughes,Liu-Perez,Curryburgh,Finland,001-865-313-3310x498,174.140.7461x521,tanya20@jacobs.org,2021-11-17,https://www.drake.net/
26-Feb-2021,Cheque,00.00,"33,253.99","33,253.98",9e787efb97980CC,6220,Perry,Sweeney,Owen-Weiss,New Julian,Jersey,937-562-5373,701.148.2260x27445,bushkatrina@cordova.com,2021-05-22,http://www.carroll.com/
26-Feb-2021,Commission,00.00,"4,156.75","29,097.23",dD4be1A5bef3FA2,9716,Diamond,Gaines,Webster-Schaefer,East Gina,Maldives,215-788-0180x4567,(791)687-8276,ernestluna@hays-ford.com,2020-02-14,https://www.hess.org/
26-Feb-2021,Debit Card,00.00,"3,637.15","25,460.08",BE0E1c7FD8d54D9,6285,Maria,Bean,Nixon-Walters,West Charleneburgh,Vietnam,815-225-4166x1872,+1-952-402-5101,lauragriffin@dennis.info,2022-02-09,http://www.henry-gomez.com/
27-Feb-2021,Purchase,00.00,"6,365.02","19,095.06",5f89eA882De2A2F,4378,Shelby,Davies,"Yates, Haynes and Owens",New Marie,Belize,(148)971-7249,001-849-022-3880,rubenwatson@berry.biz,2022-01-12,https://www.howard.com/
27-Feb-2021,Tax,"212,978.00",00.00,"232,073.06",CE9f1D6A90C8F0D,5068,Candice,Woodward,Duke-Cooley,Lake Erica,Bulgaria,001-629-277-9092,939.356.3660x87915,etorres@shepard-farley.info,2020-03-25,http://moran.info/
27-Feb-2021,Interest,"88,357.00",00.00,"320,430.06",Ad9FAaCB57D6a1c,5503,Rachael,Copeland,Norris-Olson,South Adriennefort,Hong Kong,796-477-4506x9339,(190)943-0787x40225,lance78@walters-bradley.com,2021-11-14,http://warren.com/
27-Feb-2021,Cash,03.36,00.00,"320,433.42",fe5fAbBDD1D2eFD,4930,Christie,Sandoval,"Harvey, Bauer and Weaver",East Roberto,Cyprus,892.912.7067,(178)155-2534x49676,emoran@shields.biz,2021-06-30,http://www.beard.biz/
27-Feb-2021,Cheque,00.00,"45,776.20","274,657.22",0aD4b216cedaAf3,3972,Jamie,Beard,"Perez, Macias and Howard",Tannerside,France,+1-006-618-0193,6360887544,rayhinton@warner.com,2021-03-26,https://www.knox-dyer.info/
27-Feb-2021,Debit Card,140.00,00.00,"274,797.22",Ed3DDEE0De1b769,875,Becky,Obrien,"Dunlap, Page and Duke",North Billfort,Andorra,256.124.9882,+1-503-703-0457x21281,wileygordon@salinas.com,2020-05-02,https://merritt.com/
27-Feb-2021,Cash,00.00,"91,599.07","183,198.15",cC1baa2d0BddEB7,766,Dan,Barber,Mathis and Sons,Briggshaven,Switzerland,001-710-173-9658,+1-830-896-5800,fgillespie@bird.com,2022-03-13,http://best-hart.org/
27-Feb-2021,Interest,00.00,"20,355.35","162,842.80",AC8c81220eCdE45,7392,Meghan,Spence,"Mcbride, Barnes and Horton",Derrickside,Chile,(003)857-6952,068.655.2359x8834,ronaldacosta@lewis.com,2021-02-07,https://www.oneal.biz/
27-Feb-2021,Interest,"1,944.90",00.00,"164,787.70",9931eB23F1CdDC9,2190,Judy,Rivas,Haas Ltd,Lake Rodney,Netherlands,397.535.8713x219,(499)453-8284,alexa93@love.net,2021-09-19,http://www.bolton-mcbride.com/
27-Feb-2021,IMPS,"1,795,814.00",00.00,"1,960,601.70",Ce126FdefebEdA6,8154,Kerry,Archer,Case and Sons,New Ericaberg,Greece,(170)852-5993x163,+1-626-628-1591,raymonddunlap@murray.net,2021-06-24,https://www.dodson.com/
27-Feb-2021,Miscellaneous,445.82,00.00,"1,961,047.52",aa33eC810F514FC,5541,Terrence,Mccormick,Haas-Dudley,Port Marie,Faroe Islands,001-034-154-9497,309.718.3964x3048,goldendonna@castillo.com,2020-07-02,https://stark.org/
27-Feb-2021,Reversal,"8,601.00",00.00,"1,969,648.52",D738bdE54ce14f6,9592,Jasmine,Hammond,Weaver LLC,South Marcview,Kazakhstan,(363)137-4115x33296,630.027.3000x23175,lvillanueva@orr-gutierrez.com,2020-06-11,http://bush.info/
27-Feb-2021,Transfer,00.00,"218,849.84","1,750,798.68",aFCABc1d6d7eEDc,4273,Yvette,Stephens,Ali-Gill,Goodwinhaven,New Caledonia,001-294-638-4800x771,982-359-9426x9656,morrisemily@brandt-myers.com,2021-01-19,http://www.sweeney.com/
27-Feb-2021,Transfer,"238,082.00",00.00,"1,988,880.68",757F48b20BF246d,4258,Tony,Jackson,"Ingram, Gray and Rich",New Seth,Saint Martin,3252201649,+1-219-501-8892x650,maynardsean@shepard.com,2020-11-20,http://moore.biz/
27-Feb-2021,IMPS,00.00,"198,888.07","1,789,992.61",025Bf24de10CC49,3231,Rita,Rosario,Hicks-Orozco,North Joan,Central African Republic,512.371.6327,+1-791-953-2179x2154,ibarr@potts-carey.com,2022-03-27,https://www.ellis.com/
27-Feb-2021,Miscellaneous,60.40,00.00,"1,790,053.01",BF71CCFa5FD9e50,6575,Pamela,Wilkinson,Kerr Inc,Andresborough,Montenegro,319-889-9659,+1-190-797-8864x0765,dominguezholly@paul.com,2022-04-22,https://www.durham.com/
27-Feb-2021,Interest,00.00,"447,513.25","1,342,539.76",A94DDeD7ce4CB0f,1587,Tanner,Zamora,Hanna Group,West Marissaland,Oman,530.022.9932x68483,575.582.9910,howardrobertson@chase.info,2022-01-30,http://elliott-barrett.com/
27-Feb-2021,NEFT,00.00,"335,634.94","1,006,904.82",C9B279dC9D067DB,8985,Kellie,Noble,"Montgomery, Rubio and French",North Douglas,Guam,(875)077-2634,714-753-3696,lgarza@griffith.biz,2021-04-07,https://short.biz/
27-Feb-2021,Miscellaneous,"17,390.00",00.00,"1,024,294.82",61DbE2f2f4CfA55,1785,Emma,Douglas,Mccullough-Harrison,Jeffhaven,Tonga,(447)750-0364,(925)023-5928x97748,jermainesherman@weeks.com,2022-01-13,https://www.mcclain.com/
27-Feb-2021,Bill,00.00,"170,715.80","853,579.02",dA74AfF69d1Bd52,2881,Carl,Ochoa,Nguyen PLC,Katherinebury,Zimbabwe,256.115.9477x5119,(287)292-2464x253,gravesthomas@curry.com,2021-04-01,http://santos-johnson.com/
27-Feb-2021,Transfer,00.00,"853,579.02",00.00,868d2E9F6fc1822,4574,Glenda,Shepard,"Holland, Murray and Rhodes",South Kelliview,Belarus,238.004.6564,634-378-2522,jensenbreanna@craig.com,2020-07-15,http://bennett-ashley.com/
27-Feb-2021,IMPS,"3,585.55",00.00,"3,585.55",7Bd0fC9e49Beb35,575,Teresa,Drake,Riley-Ali,Lake Lucastown,Romania,001-771-089-7065x537,001-964-762-7963,qpierce@hoffman.com,2020-09-28,http://www.petty-shea.biz/
27-Feb-2021,Interest,00.00,358.56,"3,227.00",2Dd8fC29aAAdd9F,2031,Connor,Whitaker,Burgess-Meyers,Baileystad,Malta,153-064-8088x054,001-646-033-7800,joyrusso@hendricks.com,2020-06-17,https://pham.com/
27-Feb-2021,Reversal,00.00,461.00,"2,766.00",0cbb5Ac5DDBDE8d,7304,Frank,Daniel,Arias-Stanley,Lake Natalie,New Zealand,488-233-1146x7821,001-671-573-3842x2848,sho@johnson.org,2021-05-27,https://www.blankenship.com/
27-Feb-2021,IMPS,00.00,307.33,"2,458.67",cB352926e6120A6,1369,Samuel,Duarte,Craig Inc,New Angela,French Guiana,706.424.6408x013,4407540208,felicia65@frederick.info,2020-01-25,https://mcgrath.net/
27-Feb-2021,Interest,00.00,"2,458.67",00.00,7C3f86AE2cE64E2,8467,Andrea,Zhang,Rangel Inc,West Alisontown,Kazakhstan,3025619001,0690659125,cbrandt@copeland.org,2021-10-27,https://mueller.com/
27-Feb-2021,IMPS,"1,999,962.20",00.00,"1,999,962.20",AB0a97Eb0acCd5b,7053,Kirsten,Pollard,"Sharp, Castillo and Curry",North Savannahmouth,Zambia,+1-389-353-9715x9585,(747)913-5076,richmondrick@armstrong.com,2022-03-19,https://thomas.com/
27-Feb-2021,IMPS,00.00,"399,992.44","1,599,969.76",38C4ab36bbDffcE,9926,Alejandra,Mendez,Horton-Ferrell,North Laurie,Palestinian Territory,783.780.6390,+1-293-726-8000x82793,mbruce@lawrence.net,2020-10-15,http://www.esparza-santos.com/
27-Feb-2021,Purchase,00.00,"177,774.42","1,422,195.34",E0Dcf11fEBf29f8,4494,Bernard,Walls,Knox LLC,North Jeffreyport,Kiribati,+1-136-234-5210,001-054-480-5863x67674,darryl31@mendez.com,2020-03-17,https://cortez-chandler.com/
27-Feb-2021,ATM,00.30,00.00,"1,422,195.64",9Ef4b844bE94e6B,736,Jocelyn,Holmes,Fleming Group,North Craigport,Armenia,001-400-411-6114x297,(429)210-9605x47980,martha80@oconnell.net,2021-12-19,https://www.reed.com/
27-Feb-2021,Reversal,00.00,"284,439.13","1,137,756.51",3e78ee8F80d83D5,3826,Lee,Barnett,"Hester, Dean and Delacruz",Hickmanport,United States Virgin Islands,(802)905-0639x68681,663.840.7745x598,dunlapjennifer@riddle.com,2020-11-19,http://winters.biz/
27-Feb-2021,Miscellaneous,00.00,"126,417.39","1,011,339.12",6eA0979dA445FAA,1692,Jessica,Carney,Gallegos Group,Weissfort,France,759.269.3995x076,8269936424,zlarsen@zimmerman.com,2020-06-22,http://www.gross.com/
27-Feb-2021,Interest,00.00,"1,011,339.12",00.00,8aedA4145da6782,2840,Suzanne,Simmons,"Ayers, Austin and Castaneda",Barbaramouth,Haiti,368-461-6723,(092)929-3855x9656,isharp@hull.info,2020-02-21,http://www.pugh.com/
27-Feb-2021,Bill,"127,976.00",00.00,"127,976.00",FFbDa4Bbc2A1edc,8768,Howard,Kline,Valencia-Wong,North Henrybury,Micronesia,9478077311,076-899-1459x77464,parkertammie@perkins-hebert.biz,2022-01-31,https://hogan.com/
27-Feb-2021,Cheque,00.00,"127,976.00",00.00,cf4DAA75cd7AC14,747,Betty,Soto,Roberson PLC,South Guy,Uzbekistan,3719042212,434-533-6969x900,lcooper@ball-pittman.org,2020-08-29,http://patterson-huerta.com/
27-Feb-2021,Transfer,03.00,00.00,03.00,f377Be635b8C0F1,8137,Sylvia,Hansen,Molina LLC,East Darrenton,Niue,9693572360,8910662770,nixonbrian@patton-hancock.com,2021-04-25,http://www.lowery.com/
27-Feb-2021,Cash,"24,569.96",00.00,"24,572.96",14Bd8abd7779aec,7040,Bob,Austin,"Calderon, Zavala and Harmon",Whiteheadview,Guatemala,001-374-444-9239x847,109-051-7004,charlottebenitez@donovan.biz,2020-03-28,https://rocha.info/
27-Feb-2021,Miscellaneous,"1,376.00",00.00,"25,948.96",AF38f1cBA82bcef,9490,Jenny,Clements,"Byrd, Paul and Newton",North Makayla,Saint Vincent and the Grenadines,359.408.2206,689.476.2473x96771,robert21@turner.biz,2020-10-19,https://ponce.com/
27-Feb-2021,IMPS,07.20,00.00,"25,956.16",bCCD73E1AE34DDD,278,Miguel,Morales,Mack-Barnett,Benitezville,Gibraltar,001-050-193-7638x166,490-549-4144,joan09@hart.com,2020-11-23,https://www.best.info/
27-Feb-2021,Bill,00.00,"6,489.04","19,467.12",90397AE3c2Dd1D4,5017,Roberta,Mckay,Soto and Sons,Jeremiahburgh,Azerbaijan,+1-564-887-7636x89509,+1-591-386-2942,danny92@baxter.org,2021-03-05,https://www.murphy.info/
27-Feb-2021,IMPS,00.00,"9,733.56","9,733.56",CE70B2Bb909D00f,7323,April,Pennington,"Espinoza, Dodson and Mack",Krystalstad,American Samoa,006.638.3335x919,001-346-234-1919x472,wblevins@ashley.info,2020-07-08,http://www.koch.com/
28-Feb-2021,Bill,53.67,00.00,"9,787.23",dC26cDe880F3Cf7,1178,Glenn,Hartman,Mcknight-Giles,Perryville,Benin,001-986-894-8752x738,032-725-1174x4602,michaela64@schaefer.com,2021-03-06,https://roth-odonnell.info/
28-Feb-2021,Cash,00.00,"1,087.47","8,699.76",3d50150d02477c6,2226,Rick,Melton,Tucker-Bonilla,Kristinetown,Bulgaria,699.545.4978,262-805-8457x928,mirandadennis@strickland-burnett.net,2020-01-04,https://www.solis.com/
28-Feb-2021,Miscellaneous,"238,051.00",00.00,"246,750.76",FFbA6930F97B9ce,1323,Adriana,Cortez,"Cochran, Dougherty and Bishop",Skinnermouth,Chile,038.719.7686x728,(531)142-9214,mathewswanda@poole.com,2020-10-08,https://guerrero-rhodes.com/
28-Feb-2021,Purchase,00.00,"27,416.75","219,334.01",C5DDd86f74EcCF4,8660,Nicole,Watson,Barker-Moody,Priscillafurt,Brazil,001-472-121-7688x9393,2319065584,yjacobs@sloan.com,2022-02-27,https://terrell.biz/
28-Feb-2021,Cheque,00.00,"27,416.75","191,917.26",2b6d11f4b7317Df,4185,Isabel,Mercado,"Daniels, Brown and Chen",Paceview,Palau,001-493-878-3213x96767,871.513.2204,gwendolyn12@stevenson.org,2022-01-12,http://www.ellison.com/
28-Feb-2021,Miscellaneous,00.00,"31,986.21","159,931.05",01DAd2cf14AF90a,6928,Duane,Farley,Brennan-Johnson,East Madelinemouth,Guatemala,001-251-402-2117,(386)427-6158,dwatts@norman.info,2022-05-11,http://www.baxter.org/
28-Feb-2021,Commission,00.00,"19,991.38","139,939.67",ad4Aedd7EFDd55d,7294,Caitlyn,Mccarty,"Gonzales, Mann and Fernandez",Timothyfort,Andorra,011.787.0580x31630,470-046-7935,shannon72@mahoney-stark.com,2021-06-11,http://cohen.net/
28-Feb-2021,Tax,"31,458.86",00.00,"171,398.53",e9a848B5aC0AF49,4020,Andrea,Barber,Rodgers-Esparza,Sosaside,Mauritius,+1-485-221-3970x99426,+1-594-685-2290x082,ocastro@dickson.com,2020-12-20,https://www.jones-bailey.info/
28-Feb-2021,Cheque,08.00,00.00,"171,406.53",4d41c0F3D0f7Ea0,4997,Paige,Greene,Padilla PLC,Port Frederickbury,Israel,(146)941-9706,058.822.7544,abarajas@bright-yates.com,2020-01-01,http://www.roach.net/
28-Feb-2021,Commission,58.73,00.00,"171,465.26",Ed3Cd4E4ac82cfd,4453,Joanna,Mercado,Wang-Rios,Aimeeland,Hong Kong,530-940-3896x3661,0664740652,ojennings@wong-hampton.com,2020-02-03,http://www.stephenson-rogers.org/
28-Feb-2021,RTGS,00.82,00.00,"171,466.08",70C6A2D2a742DDD,251,Rose,Case,"Mcintyre, Yang and Dyer",Gileshaven,Marshall Islands,+1-805-686-4122x815,+1-703-536-7421x7079,cassandrastrong@ramos.com,2020-12-08,https://cabrera.biz/
28-Feb-2021,IMPS,984.02,00.00,"172,450.10",0667bEA3df55ABe,5002,Jeanne,Roth,Chapman Ltd,Lake Latashahaven,Cocos (Keeling) Islands,+1-145-247-4461x2054,(143)302-0131x40724,tpage@cox.com,2021-09-06,http://www.riley.com/
28-Feb-2021,IMPS,04.00,00.00,"172,454.10",CC58B8d6CBbCAB3,9015,Stephanie,Mckee,Francis-Braun,Sabrinaside,Serbia,062.157.6998,762-702-5283x4944,omcneil@cortez.org,2020-12-25,https://conner-peterson.org/
28-Feb-2021,Interest,00.00,"19,161.57","153,292.53",DE662Ecaa7A0cbf,8336,Lindsey,Benson,Mccoy-Weeks,Hooperbury,Latvia,301.026.7927x189,(497)678-6161x3375,jaclynchase@rangel.com,2021-07-17,http://www.pruitt.com/
28-Feb-2021,Interest,165.00,00.00,"153,457.53",4B9B8D49fAf7cae,261,Kristi,Chen,Obrien LLC,East Alyssaville,Japan,+1-549-824-0031x02701,723-705-9698,woodscollin@vargas.com,2020-06-20,http://www.mueller.net/
28-Feb-2021,Tax,00.00,"76,728.77","76,728.76",3Ede0A8B4B9bDdb,6615,Tami,Raymond,Sparks and Sons,Port Rogermouth,Cameroon,0341339429,574-480-1628,cvalenzuela@stafford.com,2021-01-04,https://www.chan-munoz.info/
28-Feb-2021,NEFT,00.00,"25,576.25","51,152.51",eF6db5b6C33Cad3,9168,Lisa,Schultz,Cochran-Wiggins,West Janeshire,Costa Rica,001-754-068-5069x13673,+1-370-374-5127x263,mccartyrickey@jennings.com,2021-05-08,http://dudley.com/
28-Feb-2021,Reversal,"3,112.47",00.00,"54,264.98",30C1d7FB333c119,6687,Jermaine,Bell,"Dixon, Clements and Forbes",Clayside,Yemen,+1-488-738-0205x70007,7753374479,mario69@crawford-whitaker.com,2020-03-20,https://www.hinton.com/
28-Feb-2021,RTGS,00.00,"54,264.98",00.00,C3EfcED8116f39B,7153,Andre,Carney,Figueroa-Galloway,Conradmouth,New Zealand,(913)260-8838,(698)478-7432,rebekahphillips@conrad.com,2021-11-23,http://mays.com/
28-Feb-2021,Debit Card,"116,625.97",00.00,"116,625.97",B6C4c4C8ad25D0E,8500,Tiffany,Russo,Jefferson-Macias,Timothyville,Togo,100.276.3866x37687,(068)355-6323,adamssylvia@patterson.info,2020-10-20,https://www.vazquez.com/
28-Feb-2021,Miscellaneous,313.00,00.00,"116,938.97",D7f6EEf65Ee9A42,4543,Samuel,Andrews,Valdez Group,Port Sheryl,Myanmar,288.271.8428x8436,+1-960-477-6880x157,alicia80@knapp-jones.com,2020-09-18,http://www.kirk-perkins.info/
28-Feb-2021,Cheque,"446,549.00",00.00,"563,487.97",Cf8eB8Fc16D5e63,7512,Drew,Chandler,Chaney-Osborn,West Devon,Belize,+1-725-219-9535x5009,(425)566-6461x32745,mckenzievance@kelly.com,2020-11-03,https://odom.org/
28-Feb-2021,Bill,03.20,00.00,"563,491.17",4E3eCe63fdfA6dd,5729,Sheri,Vincent,Mcintosh-Powers,Marvinport,Lao People's Democratic Republic,001-434-912-8550x7945,885.794.6967x237,xduarte@franco.net,2021-10-25,http://www.maddox.net/
28-Feb-2021,Purchase,06.00,00.00,"563,497.17",6caacf331ABCe2C,599,Eileen,Mcbride,Holmes-Collier,Seanland,Oman,(053)653-2276,458-174-3711x70664,betty39@edwards.com,2020-02-29,http://www.weeks.net/
28-Feb-2021,Miscellaneous,"203,272.00",00.00,"766,769.17",1cbFE9b26CB9dDE,7819,Leon,Hayes,Howe-Reilly,Doylehaven,Thailand,001-610-157-8212,424-355-3490x20151,townsendcole@olsen-daniels.com,2021-10-06,https://stafford-cisneros.com/
28-Feb-2021,Bill,"626,264.00",00.00,"1,393,033.17",c6E0fcBebfbd29C,2319,Victoria,Jennings,"Marshall, Herman and Boyle",Prestonmouth,Georgia,013-641-6467,001-308-378-7174x71840,mccartydillon@hinton-bruce.com,2020-07-20,http://www.gallegos.org/
28-Feb-2021,Reversal,00.00,"464,344.39","928,688.78",d0bf5EFba97d42f,5198,Antonio,Dudley,Pham-Wilkins,East Audrey,El Salvador,(372)191-8219x86542,001-745-318-3056,yfinley@shea-randall.info,2021-01-17,https://whitaker.com/
28-Feb-2021,Reversal,71.00,00.00,"928,759.78",D3Ad7c5856dbEfd,5919,Rhonda,Lutz,Arnold PLC,East Erik,Uganda,(050)579-3402,800.156.9570,christensenmackenzie@gay-zhang.com,2022-04-18,http://hebert-mercer.info/
28-Feb-2021,Transfer,"54,595.40",00.00,"983,355.18",DEBe2627fFf8D05,3040,Kellie,Brandt,Harris Inc,Orozcohaven,Switzerland,+1-833-112-9224x818,(614)376-7264x1293,meyersroberto@villarreal.org,2021-04-13,https://www.barajas.biz/
28-Feb-2021,Purchase,811.49,00.00,"984,166.67",a0df65cFec6dDC0,8506,Dylan,Crawford,Hancock-Mooney,Port Kimberlyland,Reunion,184-460-7393,001-384-200-4601x2611,rodneyclayton@zhang-lin.com,2020-07-17,http://www.dean-mays.com/
28-Feb-2021,Cheque,00.00,"109,351.85","874,814.82",5B65b13dcDeBFa4,579,Jermaine,Pittman,"Calderon, Bradford and Caldwell",Caitlinland,Turkey,(826)772-7605x725,966.816.3434x2156,gcobb@mcclure-weber.com,2022-03-14,https://benjamin-dudley.com/
28-Feb-2021,Bill,"68,033.09",00.00,"942,847.91",C4EbFcdc2ca405d,7784,Shelby,Martin,Rhodes Inc,Gainesberg,Cote d'Ivoire,+1-290-098-9706x9990,+1-357-341-5510,tvalencia@day-patel.com,2021-10-15,http://graham.com/
01-Mar-2021,Transfer,00.00,"94,284.79","848,563.12",0507bEE6705B1Be,2239,Janice,Walsh,Hall PLC,Curtisshire,Hong Kong,339.659.9922,292-296-2107x486,millsariana@vincent-pittman.com,2022-04-02,https://www.camacho-george.com/
01-Mar-2021,NEFT,343.40,00.00,"848,906.52",fDbB79FAB142707,36,Francis,Hubbard,Barron Group,West Makaylaton,Seychelles,+1-895-654-6918x3859,(182)766-9394x4641,savannah10@simpson.com,2021-03-17,https://www.velazquez-wright.com/
01-Mar-2021,Miscellaneous,00.00,"282,968.84","565,937.68",F68eDCB42Bdc4BC,7265,Tonya,Figueroa,"Schultz, Wilson and Collins",Cathyport,Namibia,040-734-1331x554,001-016-768-2386x2816,priscillali@adams.com,2020-01-29,https://www.mooney.com/
01-Mar-2021,Cash,02.20,00.00,"565,939.88",Febc05dC9CcDe4C,3317,Joe,Washington,Coleman-Novak,West Oscar,New Zealand,(361)505-1495x54506,001-749-396-7340x12302,marshalllogan@hogan-castro.info,2020-06-03,https://www.osborn.net/
01-Mar-2021,Cheque,00.00,"62,882.21","503,057.67",C22BAe73Dd8d379,4487,Melanie,Gallagher,Simon LLC,North Karaton,South Georgia and the South Sandwich Islands,(046)532-8519,7313934638,todd71@hensley.com,2020-04-29,https://mullins.com/
02-Mar-2021,Miscellaneous,35.00,00.00,"503,092.67",ffce5F9eaCCba01,6071,Louis,Sharp,Roberts Ltd,Meghanville,Kyrgyz Republic,(785)729-9645x25020,+1-595-910-7806,hoopertommy@joyce-powell.com,2020-05-03,http://www.hensley.org/
02-Mar-2021,Transfer,00.00,"503,092.67",00.00,3C9A07DC726AB57,8389,Juan,Miller,Mclaughlin-Waller,East Maxwell,Sri Lanka,+1-346-829-5392x612,335.407.3749,charlesjoan@burke-santos.org,2021-02-10,https://huber-callahan.com/
02-Mar-2021,RTGS,54.00,00.00,54.00,BedC837d11cA8FE,4102,Katrina,Baxter,Haynes-Mills,South Mandy,Syrian Arab Republic,001-953-879-8597,(631)831-8428,jeanne87@bolton.org,2021-10-29,http://www.haney.com/
02-Mar-2021,Tax,"1,706.70",00.00,"1,760.70",b478ac4b91Ad874,9379,Calvin,Kelley,Marks and Sons,Lake Zacharyland,Pitcairn Islands,(428)206-2318,435.668.4121x7468,coxraymond@li.net,2022-02-25,https://www.conley.com/
02-Mar-2021,ATM,"1,076.32",00.00,"2,837.02",bcE70d90B1a37af,6393,Alexa,Bowman,Stephens-Wells,Oliverborough,Mauritania,2252663424,9381382559,waynechoi@morgan-vasquez.org,2021-07-02,http://www.glass.com/
02-Mar-2021,Transfer,00.00,"2,837.02",00.00,EacdbFBC2D60aB1,2291,Colleen,Salinas,Nelson-Adams,Wangborough,Mauritius,267-817-8381,001-583-738-5618x179,qhuber@webster.com,2021-12-18,https://www.beasley-clay.net/
02-Mar-2021,Cheque,"1,221.00",00.00,"1,221.00",C1B0285B3B8f99e,8896,Tara,Wade,Durham-Fernandez,Wisehaven,Cote d'Ivoire,+1-802-235-3552,(124)555-5289x94265,desireemorales@howell.com,2020-05-07,https://james.com/
02-Mar-2021,Cheque,00.00,305.25,915.75,94fe337cb0DdceA,7305,Jackson,Stafford,"Gilbert, Webb and Franklin",Lake Ann,Dominican Republic,091-190-7733,+1-975-713-5232x6021,eblack@deleon.info,2020-05-18,http://www.johnston.biz/
02-Mar-2021,Cash,00.00,305.25,610.50,DC450d0a2bDAcda,9891,Perry,Moon,Horn-Kim,Port Jay,Netherlands Antilles,001-564-166-7158x0428,(207)678-0218x226,hooperedgar@strickland-wilcox.info,2022-05-11,https://trevino-raymond.info/
02-Mar-2021,RTGS,"422,673.00",00.00,"423,283.50",5EbFF009b32311a,6362,Jake,Rhodes,"Daniel, George and Vargas",North Francis,Zambia,071-595-7224x328,(506)360-0270x1306,kgeorge@guerra.org,2020-08-22,https://www.cherry-yang.com/
02-Mar-2021,Debit Card,"5,176.30",00.00,"428,459.80",e0A95AAc175f189,847,Margaret,Norton,"Blackwell, Marshall and Summers",Lake Caitlinport,Comoros,521-727-6174x36953,+1-706-892-6648,ucoffey@hoffman-russo.biz,2021-03-18,http://wise.com/
02-Mar-2021,NEFT,00.00,"42,845.98","385,613.82",C2cAAFaE651c7b0,3205,Taylor,Jefferson,"Lawrence, Cardenas and Lutz",Andradeville,Finland,446-424-1199x44154,851-840-5219x652,perkinscaleb@little.com,2021-01-16,http://johnston-frey.info/
02-Mar-2021,ATM,"23,318.00",00.00,"408,931.82",9Acb8bB6F39D723,6656,Allen,Shepherd,Griffith Ltd,East Autumnburgh,Macao,001-708-622-4633,928-146-7159x148,becky65@hess-stokes.com,2022-04-11,http://mccoy-rosales.com/
02-Mar-2021,Transfer,00.00,"51,116.48","357,815.34",AbA0f3b2f1D74Fd,687,Brady,Rice,"Butler, Mora and Mcdowell",Gibbsberg,Lithuania,001-724-141-7988x582,(273)136-7307x3915,sbonilla@potts-fitzpatrick.net,2020-09-08,https://zimmerman.com/
02-Mar-2021,Cash,00.00,"39,757.26","318,058.08",Ad13C3a372D7dbe,8151,Fred,Dunlap,"Strickland, Edwards and Chambers",East Dalton,Saint Vincent and the Grenadines,(703)764-8701,(438)683-4357x638,erin07@cherry.biz,2020-05-27,https://www.lloyd-greene.net/
02-Mar-2021,Transfer,00.00,"31,805.81","286,252.27",15f4FAF78D4db6f,2262,Amber,Blanchard,Newton-Moody,North Kara,French Southern Territories,+1-931-571-4784x36862,+1-436-488-7041x3130,madison64@caldwell.com,2022-03-14,https://buckley.com/
02-Mar-2021,Debit Card,"1,411,565.20",00.00,"1,697,817.47",bDA665C16366DC8,9322,Jordan,Leonard,Perry-Mora,North Dakotafort,French Guiana,857.290.1217,+1-544-474-8424,damoncooley@powell.com,2020-01-25,http://www.shah.com/
02-Mar-2021,Reversal,"259,399.00",00.00,"1,957,216.47",ADDAf477e64FAFE,4016,Lydia,Franco,"Morse, Skinner and Russo",Lake Gabriella,Norway,(589)348-4544x04244,001-036-271-5681x156,parrishjaime@weiss-foley.net,2022-04-10,https://cherry.biz/
02-Mar-2021,Bill,03.90,00.00,"1,957,220.37",af70bc9D99DE9aD,8697,Hector,Hubbard,Wall LLC,Tapiafort,United Kingdom,2659846705,+1-938-297-5537x551,nedwards@jennings.net,2020-06-18,https://www.molina-weaver.net/
02-Mar-2021,Purchase,45.16,00.00,"1,957,265.53",3f50Fe6E4C05edb,2127,Cheryl,Juarez,Marsh-Sims,Davebury,Germany,+1-089-557-1139x93718,727-427-2556x7274,katherinecolon@byrd-hickman.org,2022-02-22,https://gomez-patrick.org/
02-Mar-2021,Debit Card,07.23,00.00,"1,957,272.76",BB1c9c1C5ADCc31,9054,Autumn,Oconnor,Holden and Sons,Port Bettyhaven,Mauritius,030.225.3531x74091,321.666.5487,ashley14@frye-meza.com,2020-01-18,http://cooke.com/
02-Mar-2021,Interest,00.00,"195,727.28","1,761,545.48",BE2B0535cb0eC6E,4145,Katelyn,Barron,Elliott Ltd,North Danielletown,Tanzania,(748)084-0149,072.334.9817x96838,alison24@blevins.com,2021-12-25,http://huang.com/
02-Mar-2021,Debit Card,"1,114,286.00",00.00,"2,875,831.48",4AbF920ee97fC80,4165,Jeff,Hall,Yates Inc,Port Shaun,Belize,207.975.8515x18474,(949)124-5687x932,holly82@andrews.com,2021-12-07,http://rosario.com/
02-Mar-2021,Cheque,"167,790.40",00.00,"3,043,621.88",Ab81AbCD48C3ebd,7968,Adam,Thompson,Obrien Ltd,Grantchester,Cuba,001-273-434-5500,097.697.9900x56715,max16@kim.com,2020-01-30,http://larsen.com/
02-Mar-2021,Commission,00.00,"1,014,540.63","2,029,081.25",caAdAedAdd0eC1A,913,Kristina,Bass,Zavala-Leon,Yangside,French Guiana,001-885-323-1323,+1-996-003-4479x94926,kpotts@williams.com,2022-04-19,http://frazier-decker.biz/
02-Mar-2021,Reversal,00.00,"225,453.47","1,803,627.78",aEdcfa6aB7Aa3b8,3976,Nicolas,Vincent,Kaiser-Bridges,Lake Damonfurt,Reunion,001-181-243-2461x8147,001-957-890-0834x291,lauren77@poole.net,2020-10-29,https://www.wolf.com/
02-Mar-2021,IMPS,03.40,00.00,"1,803,631.18",A7784bF3F61Abbc,1819,Carl,Byrd,Hartman-Zhang,Simonmouth,Hong Kong,+1-821-085-8923x576,+1-093-110-9428x1078,arthurnguyen@mendez-kennedy.net,2020-06-26,http://www.wheeler.com/
02-Mar-2021,IMPS,00.00,"1,803,631.18",00.00,21C1a2E1e9Cf6cC,71,Brandon,Robbins,"Stark, Deleon and Mann",West Erikview,Netherlands,422-099-2274x577,634.035.7567x20178,qmcdaniel@cruz.net,2020-12-20,https://www.acevedo-macdonald.net/
02-Mar-2021,ATM,62.49,00.00,62.49,c84FA04FDD3dB8C,2471,Troy,Leonard,Woodward LLC,Dalebury,Guam,932-151-9287x2271,218.337.0847,ipruitt@hartman.com,2020-06-04,https://larsen-gonzales.com/
02-Mar-2021,Bill,00.00,62.49,00.00,7ee8cCFceE7BE18,1952,Roger,Maddox,Baldwin-Wagner,Suttonburgh,Peru,001-151-266-7565x87681,+1-070-661-1556x48988,yarcher@noble-valencia.com,2020-10-14,https://daugherty.info/
02-Mar-2021,IMPS,"3,710.10",00.00,"3,710.10",C516FcAcE1E24f1,8717,Beverly,Myers,Pittman LLC,Stephensmouth,Syrian Arab Republic,825.290.7682x7257,703.098.5097x640,cespinoza@ponce.com,2020-01-13,http://davis.com/
02-Mar-2021,Reversal,00.00,"1,236.70","2,473.40",5Ee667C0CcFD8c7,7587,Nathaniel,Molina,Ingram LLC,West Mariah,Lebanon,001-165-434-3525,433.396.4633,robert88@boyd.biz,2020-05-11,http://riggs.info/
02-Mar-2021,ATM,43.00,00.00,"2,516.40",C24caA81ad61d6c,2409,Shawna,Erickson,Chen Inc,Port Gwendolynhaven,Seychelles,358.460.4582x773,7553849200,rodney94@vance.biz,2021-02-14,https://www.sparks.info/
02-Mar-2021,Debit Card,"1,334,579.00",00.00,"1,337,095.40",3bfEE48D2A38B98,111,Chad,Henry,"Gaines, Galvan and Goodwin",Hansonburgh,Cyprus,001-014-140-8925x13758,(560)696-8482,mathisgloria@house-hamilton.org,2020-07-05,https://silva.com/
02-Mar-2021,Miscellaneous,00.00,"222,849.23","1,114,246.17",b52B9003Cf493D0,5580,Willie,Bird,Andrews Ltd,Joannamouth,Cote d'Ivoire,628-113-0516x92684,302.480.9289,nathan18@hayes-bradford.com,2020-11-27,http://holland-walter.net/
02-Mar-2021,Reversal,00.00,"222,849.23","891,396.94",5faDDad87B098f7,2221,Collin,Flynn,Nguyen-Ryan,New Carol,Angola,(738)353-2672x25311,001-122-957-8137,xpham@banks.com,2021-03-21,https://caldwell-schmitt.net/
02-Mar-2021,Miscellaneous,161.70,00.00,"891,558.64",DECfDCC65BbbAda,5583,Cassandra,Lamb,Cole-Randolph,Mikaylaside,Jersey,(734)558-1033x96722,543.865.6813x9270,glenda74@oconnell-gates.org,2022-02-23,http://www.grimes-sheppard.com/
02-Mar-2021,Miscellaneous,00.00,"445,779.32","445,779.32",b52146EeE2ffdf7,2431,Brittany,Nelson,Choi and Sons,Michaelton,Denmark,773.512.0983x90656,+1-490-384-9488x7362,rhawkins@griffin-hancock.net,2022-01-02,https://www.murphy.com/
02-Mar-2021,Debit Card,00.00,"148,593.11","297,186.21",4936DCFe8cCFF8A,3183,Candace,Burke,"Hess, Wong and Bond",Rosemouth,Slovenia,001-381-627-3619x8306,099.828.3204,roy08@hampton.biz,2022-02-14,https://savage.com/
02-Mar-2021,NEFT,00.00,"297,186.21",00.00,cAa8f8C30204Cf9,4426,Loretta,Dixon,Bishop-Eaton,Jasminside,Mozambique,+1-606-368-1789x195,(650)331-8716,gabriel77@dennis-archer.net,2021-05-15,https://jacobs.com/
02-Mar-2021,Cash,00.40,00.00,00.40,43CBf9ff825E10f,3308,Kari,Mercer,"Dodson, Baxter and Raymond",Hodgesshire,Montenegro,+1-788-058-7303,288.830.4455,annawu@vasquez.net,2020-12-30,http://vargas.info/
02-Mar-2021,Transfer,00.00,00.40,00.00,aC3E4d6Ceedca2b,5581,Brenda,Ford,Madden-Livingston,West Raymondmouth,Chad,004-455-0074x784,(930)341-7583,villareginald@taylor.com,2020-02-14,https://boyle.com/
02-Mar-2021,IMPS,"21,425.00",00.00,"21,425.00",9fb821FAC0BC4a9,2628,Paige,James,Norton Inc,North Victor,Angola,139-540-9443,559-588-4466x91092,summer43@ball.com,2022-05-05,http://mccann.com/
02-Mar-2021,Purchase,"257,027.31",00.00,"278,452.31",f173fC284c3bB3f,2990,Christine,Anderson,Bright-Flores,West Kerri,Somalia,198-667-9682,584.494.9112x2408,fmoyer@warner.com,2021-08-16,https://www.zuniga.com/
02-Mar-2021,Transfer,36.00,00.00,"278,488.31",d5d3Ecb7cEADA2a,5282,Taylor,Contreras,Hayes-Santiago,Lake Glenn,Venezuela,158-136-5092,563-686-1494x70599,swansonkelsey@mahoney-ryan.com,2020-09-22,https://mercado.com/
02-Mar-2021,Purchase,00.00,"69,622.08","208,866.23",3dcD2320355d6eF,4719,Julian,Oconnor,Oneal Ltd,Leeville,Northern Mariana Islands,528-293-8215,475.106.3703x2179,fhuang@prince.com,2020-03-17,http://baxter.com/
02-Mar-2021,Debit Card,"29,675.00",00.00,"238,541.23",148babFdcf2aef6,9184,Hayden,Rhodes,"Curry, Dunn and Travis",Julieland,New Caledonia,448-115-8504,032-319-0348,tabithaglover@adkins.com,2022-03-17,http://www.barrera-lam.com/
02-Mar-2021,Debit Card,04.13,00.00,"238,545.36",c69D4ddf5e0C3B3,3677,William,Farrell,"Zamora, Butler and Lozano",Drakeland,Bangladesh,+1-491-496-5204x967,572.440.9062x095,wernergarrett@trevino.org,2020-12-25,https://www.prince.com/
02-Mar-2021,Commission,00.00,"34,077.91","204,467.45",F7CFa3DA1a6Fceb,7881,Jeremiah,Brock,"Hart, Bates and Sanders",Port Kristenfurt,Malawi,001-741-915-9694x19681,001-531-716-1358x947,sally78@curry.net,2020-04-29,http://little.com/
02-Mar-2021,Bill,"3,728.00",00.00,"208,195.45",e1EBfFE5daDFe39,7539,Phillip,Guerra,Fuentes Group,South Jeremyland,Suriname,(182)505-3290,169-109-5243,nandersen@norris.com,2022-03-22,https://mooney.com/
02-Mar-2021,Tax,"3,465.00",00.00,"211,660.45",C0daA8f2320026C,9332,Leroy,Allison,Maynard Inc,Port Annette,Benin,+1-175-852-6118,702.884.8836,craig58@wilkins.com,2020-08-08,http://www.hooper.com/
02-Mar-2021,Transfer,05.00,00.00,"211,665.45",BCbB100AB438e1e,6076,Stephen,Wagner,"Bautista, Beck and Chavez",New Brian,Uruguay,(286)265-2443x734,101.010.5680,turnerbeth@reilly-jenkins.com,2022-02-24,http://www.ruiz.biz/
02-Mar-2021,NEFT,00.00,"35,277.58","176,387.88",0eD7Cc1F849CD62,2357,Bryce,Haley,Atkins LLC,Boydfort,Uganda,767.724.5099x68495,+1-512-614-1882,pittmangerald@miller.com,2020-05-07,https://guerrero.com/
02-Mar-2021,Cash,00.00,"176,387.88",00.00,9f3793d6cDae5fc,6638,Tyler,Reeves,"Leon, Ayers and Baldwin",Jerryview,Netherlands Antilles,(615)006-4199x002,1440428366,vernonturner@murphy-holt.com,2022-01-24,https://www.faulkner-austin.com/
02-Mar-2021,Debit Card,"178,104.72",00.00,"178,104.72",De0F737156Ef1Ae,3630,Shawn,Hicks,"Weaver, Rivas and Henderson",Ashleytown,Congo,(175)142-9758x13452,001-386-627-4241x06757,kurt98@brady-reyes.com,2021-06-07,https://wheeler.net/
02-Mar-2021,Miscellaneous,00.00,"44,526.18","133,578.54",01f7Cb51B4aa8bE,7331,Shawna,Winters,Matthews Group,Barkershire,Australia,001-870-372-3317,645.438.8705x8457,fskinner@boyer.info,2021-12-17,https://www.kidd.com/
02-Mar-2021,Reversal,"235,717.00",00.00,"369,295.54",3B2e81d930d1AE3,608,Elizabeth,Casey,Ochoa Ltd,West Williamview,Namibia,+1-201-703-4225x834,+1-992-562-2917x01075,lutzkrista@boyd-braun.com,2022-03-14,https://neal.org/
02-Mar-2021,Interest,00.00,"123,098.51","246,197.03",Bae5CC8CbdC1ccc,8313,Gary,Wilkinson,"Fritz, Landry and Landry",Lake Danielhaven,Zambia,642.341.7372x420,413-412-4021,tarabrooks@pennington-patterson.com,2021-05-26,http://middleton.com/
02-Mar-2021,NEFT,00.00,"49,239.41","196,957.62",AF1d84BDD5eD29A,9720,Jermaine,Frey,"Robles, Hodge and Morgan",Deniseside,Zimbabwe,624-760-7794x2672,+1-788-426-6007x901,vmaxwell@hooper.com,2020-03-11,https://knapp.net/
02-Mar-2021,NEFT,00.00,"24,619.70","172,337.92",2d675B74feedFd0,564,Susan,Avila,Mack Group,Joanmouth,United Arab Emirates,+1-144-390-5960,001-629-691-4766,tgould@mckee-shepard.org,2021-07-19,http://www.carney.com/
02-Mar-2021,Cheque,282.96,00.00,"172,620.88",F6AcbBE8Cc9E19c,1976,Antonio,Reeves,Carroll-Frazier,Port Lancefurt,British Indian Ocean Territory (Chagos Archipelago),197-003-7791x170,(560)103-8338,paulweaver@day-coleman.biz,2020-12-03,http://www.pope-burch.com/
02-Mar-2021,Tax,"96,672.00",00.00,"269,292.88",Cc7fDD0640ebfa8,2897,Bill,Foley,"Benjamin, Boone and Kidd",Dodsonton,Greece,001-851-560-9830x6751,341.533.2270,nnolan@mcmillan.com,2021-07-30,https://cisneros.com/
02-Mar-2021,Transfer,248.20,00.00,"269,541.08",BC8Cbf2AeD7EF0b,6745,Ian,Ramsey,Hickman-Cross,New Kathleentown,Tuvalu,(055)954-9609x77967,564-854-6123,zamoragabrielle@forbes-barber.net,2020-08-05,http://www.oliver.com/
02-Mar-2021,Debit Card,00.00,"38,505.87","231,035.21",D4b6bD4dd767b8b,8678,Jenny,Larson,"Mejia, Moss and Wright",Carlyhaven,Vietnam,(569)714-2863,(568)824-3292x9208,mariamccullough@dalton.com,2020-05-01,https://www.park.com/
02-Mar-2021,RTGS,"1,342,289.00",00.00,"1,573,324.21",6D719Cd56854ff2,3235,Daryl,Sexton,"Scott, Camacho and Martin",New Steve,Lithuania,(112)957-3267x141,(487)766-1594,zpoole@blanchard.biz,2020-03-24,https://hendricks-rosario.com/
02-Mar-2021,Debit Card,00.00,"524,441.40","1,048,882.81",15f4FAF78D4db6f,2262,Amber,Blanchard,Newton-Moody,North Kara,French Southern Territories,+1-931-571-4784x36862,+1-436-488-7041x3130,madison64@caldwell.com,2022-03-14,https://buckley.com/
02-Mar-2021,Commission,00.00,"1,048,882.81",00.00,E111cEB5CAf5Aed,2871,Molly,King,Dixon-Allison,West Dennis,Montenegro,001-738-259-2253x0123,090.357.9393x118,icompton@johnston-murphy.com,2020-03-12,https://booth.com/
02-Mar-2021,IMPS,"29,368.40",00.00,"29,368.40",6031baa7b9DF130,3765,Crystal,Davis,Tran-Zavala,Port Savannah,Poland,309-417-0204x611,001-164-880-6032x7398,chelsea91@good-morgan.org,2021-11-08,https://www.galvan.net/
02-Mar-2021,Interest,52.92,00.00,"29,421.32",39da4E98D47D392,2540,Bonnie,Oconnor,"Mitchell, Mayer and Perry",New Austin,Seychelles,+1-788-954-1073x507,340.812.2881,monroecarol@bowers-hatfield.com,2021-08-19,http://www.atkinson-klein.com/
02-Mar-2021,Miscellaneous,00.00,"14,710.66","14,710.66",D4b6bD4dd767b8b,8678,Jenny,Larson,"Mejia, Moss and Wright",Carlyhaven,Vietnam,(569)714-2863,(568)824-3292x9208,mariamccullough@dalton.com,2020-05-01,https://www.park.com/
02-Mar-2021,Debit Card,00.00,"2,451.78","12,258.88",9aD8552188B0FCc,2009,Sally,Brown,"Underwood, Zavala and Baker",Floydstad,Kazakhstan,(298)370-0672x84793,9472010514,andreschultz@howe-flowers.biz,2020-10-08,http://www.giles.com/
02-Mar-2021,Purchase,00.00,"2,451.78","9,807.10",BdB0e3D5a0De8a7,4509,Kayla,Pineda,Mccarthy-Tran,Haroldville,Finland,148-988-3788x6603,001-798-980-9733x6788,maryblackburn@zamora-duffy.info,2021-12-27,http://www.scott-ruiz.com/
02-Mar-2021,Tax,00.00,"1,089.68","8,717.42",cAa8f8C30204Cf9,4426,Loretta,Dixon,Bishop-Eaton,Jasminside,Mozambique,+1-606-368-1789x195,(650)331-8716,gabriel77@dennis-archer.net,2021-05-15,https://jacobs.com/
02-Mar-2021,Miscellaneous,00.00,"1,245.35","7,472.07",6BefAaDaa443B53,4894,Hunter,Manning,Kennedy Inc,North Dennis,Libyan Arab Jamahiriya,001-171-693-3187x283,182-925-5101x2389,wdudley@combs.com,2021-10-14,http://price.com/
02-Mar-2021,ATM,"97,864.59",00.00,"105,336.66",F1a1e69a40B9c5d,3716,Perry,Lewis,"Choi, Werner and Wade",Port Matthewbury,Seychelles,571-082-8742,+1-504-958-6760,mullencolton@barton-morrison.com,2021-06-11,http://www.fitzgerald-stevenson.biz/
02-Mar-2021,Commission,00.00,"105,336.66",00.00,83BC5c5dDFb512c,7045,Nicole,Hicks,Juarez-Eaton,Eileenmouth,Belarus,387.012.2204x387,047-154-3706x6260,christie55@ramsey.com,2022-01-16,http://shah-mcdonald.com/
02-Mar-2021,Cheque,"108,218.20",00.00,"108,218.20",3354010Fe8ABBdb,9415,Abigail,Chapman,"Lam, Reilly and Mahoney",East Melody,Ethiopia,565.402.5570,+1-286-913-6114,cjacobs@mcdaniel.net,2020-02-03,https://gillespie.com/
02-Mar-2021,Miscellaneous,"1,003,788.00",00.00,"1,112,006.20",F884B5F5C06b83F,838,Shelby,Huynh,"Banks, Wright and Montgomery",Manningville,Kazakhstan,(449)603-6483x775,+1-206-262-0110,meghan36@aguirre.com,2022-01-09,http://yu.info/
02-Mar-2021,Cheque,00.00,"370,668.73","741,337.47",91Deb3B6aEF604b,7786,Frederick,Waters,"Horn, Harding and Gentry",Wangberg,Mongolia,9908330589,1190167938,mercadoautumn@cobb.com,2020-06-18,http://www.blankenship.info/
02-Mar-2021,ATM,00.00,"148,267.49","593,069.98",b22dDabD39d209E,2738,Deborah,Huang,"Chambers, Kirk and Whitaker",Lake Lorettahaven,Sudan,003-840-6878x4867,727.670.9473x5294,ernest59@waters.com,2022-01-07,https://sawyer.com/
02-Mar-2021,Commission,00.00,"65,896.66","527,173.32",34F05a988E1cfC6,6600,Kristie,Carroll,Gallegos Group,South Selenaside,Bangladesh,(402)045-4960,(347)363-7467,bushdarlene@ali-lowery.org,2020-01-23,http://fischer-harrell.com/
02-Mar-2021,RTGS,00.00,"263,586.66","263,586.66",737E34C6641E9cf,1453,Haley,Andersen,Hoover Ltd,Davefort,Taiwan,634-053-6025,(294)018-9239x2553,jpeters@shaw.com,2021-01-04,http://www.sellers.com/
02-Mar-2021,RTGS,00.00,"37,655.24","225,931.42",9fCAb51Caf9A4C7,8419,Christopher,Curry,"Allison, Farrell and Weaver",Brettport,Saint Pierre and Miquelon,+1-062-833-9170x77901,315.418.4391,zkidd@jacobson.com,2020-11-15,https://www.frazier-hawkins.com/
02-Mar-2021,ATM,"447,816.50",00.00,"673,747.92",Aa31dDC99911aFE,8879,Carla,Richard,"Pratt, Cowan and Grimes",Kristinemouth,Italy,(665)813-4793x9528,+1-162-345-7801x926,guerrerokaylee@curry-briggs.com,2021-11-29,https://www.avery.com/
02-Mar-2021,Miscellaneous,00.00,"336,873.96","336,873.96",85F54DA3e4A4cFD,1999,Norma,Ortega,Abbott-Grant,Carlborough,Nicaragua,+1-152-975-9065x2069,632-815-1673x980,patty06@marsh-mcclure.com,2022-04-06,http://www.barker-larsen.com/
02-Mar-2021,Purchase,"1,148,546.00",00.00,"1,485,419.96",EaE5A05FbC7AaDd,4711,Jillian,Costa,"Rangel, Fox and Cruz",New Martha,New Caledonia,454-745-8206x350,484-200-2005x5666,wilcoxkarina@little.com,2020-11-16,https://www.freeman.com/
02-Mar-2021,Cash,00.00,"371,354.99","1,114,064.97",cbFD3bF79C2eC99,8887,Johnny,Reyes,"Wiley, Richardson and Schultz",Ericton,Romania,001-605-049-6190,+1-204-362-2429,reneemcmahon@gray-anthony.com,2021-01-22,https://hardy.com/
02-Mar-2021,Cash,12.00,00.00,"1,114,076.97",2CB212FfbeFFBA3,8583,Meredith,Stone,Huff and Sons,West Shellyburgh,Holy See (Vatican City State),145-942-1798x2145,189-864-6411x97643,ann36@odonnell.biz,2022-02-01,http://www.potts.com/
02-Mar-2021,Cash,00.00,"1,114,076.97",00.00,6de09ab5dE8e6B8,1993,Fred,Taylor,Cordova Inc,West Joann,Ethiopia,858-569-1816x84261,8168211377,roberto35@forbes-liu.com,2022-05-15,https://espinoza.biz/
02-Mar-2021,RTGS,364.00,00.00,364.00,eD9BaB908ba2a3b,5485,Daryl,Jacobson,"Sullivan, Rhodes and Walls",Andersonmouth,Anguilla,074-906-2040x7211,554-652-2500x36897,vanessa53@spears.org,2021-11-05,https://www.gay.com/
02-Mar-2021,Debit Card,210.00,00.00,574.00,8f22c9cA5a0bac0,1367,Kim,Terry,"Vargas, Roman and Washington",Port Sean,Solomon Islands,438.732.2394x185,7579914194,espinozamelissa@gutierrez.org,2020-04-01,https://underwood.com/
02-Mar-2021,Purchase,00.00,63.78,510.22,aB1e33EBe4Fb7ed,5388,Paige,Saunders,Lang-Alexander,West Philipland,Panama,498.129.7550x047,980-443-6703,knapptammy@everett.org,2020-12-01,http://cabrera.info/
02-Mar-2021,Purchase,00.00,255.11,255.11,E6E45eBf1c0CdE3,5749,Jenna,Garrett,Guerrero-Combs,Estradaside,Niger,877.392.9112,+1-105-248-0807,rodgerspeter@arias-graham.com,2020-02-14,http://www.french.com/
02-Mar-2021,Transfer,00.00,25.51,229.60,A3cCFd318b1daDf,8539,Alexandria,Lynn,"Pearson, Woodard and Fitzpatrick",Port Faithstad,Panama,(174)183-3720,(672)487-9019x32309,emccann@walton.biz,2022-03-12,https://www.shepard.com/
02-Mar-2021,NEFT,387.10,00.00,616.70,acef23dcfdcaf3e,8024,Gina,Rios,Skinner LLC,New Tracystad,Latvia,+1-995-821-2394x5733,(439)497-6957x1195,glenn12@mccoy.com,2020-03-19,https://www.brock-jimenez.com/
02-Mar-2021,Tax,47.71,00.00,664.41,bcd6D1c06caC16B,5628,Sonia,Wilkerson,Mcdonald Ltd,Vangshire,Mongolia,493-775-2867x6957,(017)519-4071x285,autumn55@schaefer.net,2021-07-28,https://www.blake-bray.com/
02-Mar-2021,Cash,01.80,00.00,666.21,F4EC5D3eB51Aba1,5739,Dalton,Yates,"Heath, Hicks and Madden",Frankport,Mozambique,128-835-7266x15739,159-520-1045x547,cameron54@brennan-greene.org,2021-01-23,http://www.randolph.org/
02-Mar-2021,Bill,"3,008.40",00.00,"3,674.61",8F8a207fcE83c41,3010,Troy,Wallace,Huff Inc,Santiagoville,Mali,001-189-435-0246x724,377-826-7229x32265,jerickson@foster.info,2020-09-07,http://www.molina-patrick.com/
02-Mar-2021,Commission,"68,387.00",00.00,"72,061.61",EFcA3215C3be911,5184,Leonard,Ball,Stephens-Griffith,South Genestad,Bangladesh,927-310-2239x608,+1-627-097-5858x334,doris44@gallegos-bartlett.biz,2020-02-04,http://www.silva.com/
02-Mar-2021,Miscellaneous,00.00,"18,015.40","54,046.21",00Ba3F0aC1bDbaE,5779,Christina,Patterson,Livingston Inc,South Danielfort,Macao,001-006-772-8187x398,182-230-0952x903,ana02@tanner.org,2021-03-09,https://www.barnett.info/
02-Mar-2021,Cash,00.00,"9,007.70","45,038.51",07E2BD29dB1ab90,2956,Bridget,Day,Conrad-Cooke,Nicolasbury,Brunei Darussalam,5753001233,(543)089-7935x282,jocelyn33@dickson.com,2020-06-09,http://www.rosales.com/
02-Mar-2021,Reversal,"2,994.50",00.00,"48,033.01",fAcEead42a0D6bb,651,Jonathon,Rojas,Reynolds-Montgomery,Sheilahaven,Croatia,001-357-247-1139x7480,+1-612-995-1530x0834,wayneoconnell@carson-sweeney.net,2021-02-23,https://www.hinton-newton.com/
02-Mar-2021,Miscellaneous,00.00,"6,004.13","42,028.88",42eBBea2a40a4d2,3102,Karina,Hendricks,Pennington LLC,New Anna,Panama,7311959252,(995)275-2720x15149,chavezricky@rivas.com,2021-07-31,http://sims-booth.net/
02-Mar-2021,Commission,00.00,"10,507.22","31,521.66",03bA0eefc0cdA69,526,Cheyenne,Tran,Stevenson-Marquez,Marciaside,Burkina Faso,+1-922-403-8033x36790,798-343-3180,daryl88@simon.com,2020-04-13,http://www.gregory.org/
02-Mar-2021,Interest,30.00,00.00,"31,551.66",497A81a8Bc137FF,8464,Joel,Ho,Goodman-Osborne,Lawsonmouth,Guam,6680074387,(334)717-7618,cody23@robinson-mooney.com,2021-08-13,http://www.ortega.biz/
02-Mar-2021,Cheque,"23,914.00",00.00,"55,465.66",539C67dE0EAF5f3,1679,Eduardo,Singleton,Fox-Guerrero,West Bryanfurt,Chile,(922)548-4683x6622,040-627-0820,caitlyn50@house.com,2021-08-18,http://www.giles.com/
02-Mar-2021,IMPS,00.00,"55,465.66",00.00,AeedE93A2bf57Ab,5866,Clarence,Hinton,"Johns, Mclean and Harmon",Allisonland,Georgia,361-507-5650,243-977-2224,margaret18@morris-ware.com,2020-06-28,http://sawyer-cervantes.org/
02-Mar-2021,Reversal,"1,801,418.00",00.00,"1,801,418.00",7F87b0968BC0217,617,Janet,Mccann,Rios Group,South Karl,Slovenia,1309088872,+1-343-813-1969x25447,mdominguez@nolan.com,2021-07-14,http://phillips-gilbert.com/
02-Mar-2021,Debit Card,00.00,"180,141.80","1,621,276.20",bE00d844431Eee3,5568,Lonnie,Mccormick,"Schwartz, Beck and Carr",Carrollchester,United States of America,545-882-5871,861-342-8132x85593,bill74@jarvis-dunn.com,2021-06-18,http://cooke-horton.com/
02-Mar-2021,Commission,00.00,"162,127.62","1,459,148.58",fdf93ecBB75e990,3625,Dominic,Fuller,"Harmon, Navarro and Winters",South Earl,Italy,(846)203-9829,328-584-9755x5174,mackenzie79@rowe.com,2020-06-04,http://www.glenn-benjamin.com/
02-Mar-2021,Reversal,00.00,"208,449.80","1,250,698.78",deCee1d8035D612,862,Gregg,Golden,"Stark, Pace and Fernandez",Coltonville,Liechtenstein,+1-898-361-3070x329,001-432-199-7893x4363,eugene22@lamb-thomas.com,2021-10-04,https://www.velazquez.info/
02-Mar-2021,Reversal,00.00,"250,139.76","1,000,559.02",Aaa65bcDf93aeDd,9335,Jackie,Decker,Holt Group,South Shellybury,Congo,001-010-385-8318x20864,724-293-1020x117,gritter@whitaker-benton.com,2021-12-21,https://www.kennedy.com/
02-Mar-2021,Reversal,00.00,"100,055.90","900,503.12",c435Ac3fDD61509,9826,Patricia,Fox,Avila-Dalton,Savageberg,Equatorial Guinea,398.126.2466x9242,001-077-001-3840x3789,murraykerri@cobb.net,2021-02-27,https://french.com/
02-Mar-2021,NEFT,00.00,"180,100.62","720,402.50",2D5E1ee98d4EfDe,6104,Kyle,Carney,"Foster, Huber and Torres",Lake Alejandro,Sierra Leone,(748)934-3172,+1-513-642-4682,penamikayla@vega-chambers.biz,2022-01-13,http://www.charles.com/
02-Mar-2021,Reversal,00.00,"120,067.08","600,335.42",b3C55F7d8AA91eC,4311,Gina,Barber,Meadows Inc,Makaylaland,Syrian Arab Republic,969-954-8610x0061,437-294-3330x09064,doylegarrett@salas.org,2021-06-11,http://www.washington-jacobs.biz/
02-Mar-2021,Reversal,00.00,"200,111.81","400,223.61",77cF6E1DCA1dBCB,6207,Patrick,Hendricks,James-Brooks,Janicemouth,Kuwait,+1-742-919-4800x973,(718)570-0006x2284,wilkinsondwayne@singh.com,2020-12-04,http://www.ali-herman.net/
02-Mar-2021,Interest,"456,888.20",00.00,"857,111.81",e9A5A0fa9BDE8f5,3044,Max,Fitzpatrick,Barton-Duarte,Port Diamondmouth,Macao,001-783-850-6728x03276,815-776-3679,sheri17@terrell.org,2020-01-21,http://www.holt.com/
02-Mar-2021,Reversal,00.10,00.00,"857,111.91",72A962E3a3A1908,2015,Tiffany,Bird,"Cochran, Barrett and Pierce",Annburgh,Chile,357-784-7136x12025,259.252.6874x5666,jodilara@chang.biz,2022-05-18,https://richards.com/
02-Mar-2021,Commission,"62,974.72",00.00,"920,086.63",94cBBcACcafe18A,6299,Shane,Frey,"Duran, Dennis and Henson",Alexisberg,Monaco,593.066.6419x0837,(495)879-0555x923,sally81@herring.biz,2020-03-05,https://santiago-west.net/
02-Mar-2021,Debit Card,50.75,00.00,"920,137.38",2c5eBF3da13Ee49,1655,Bob,Oconnell,Mills LLC,North Jordantown,Namibia,(517)321-9679x21611,552.734.8814x704,yreid@salazar.org,2020-05-14,http://www.rollins-mayo.com/
02-Mar-2021,NEFT,00.00,"230,034.35","690,103.04",2c0E2652Fd72FbA,8120,Wyatt,Santana,"Mathews, Rice and Harmon",New Paulville,El Salvador,500-825-5584,334.416.2236x28046,mlucas@lester.com,2020-01-05,https://sheppard-phelps.com/
02-Mar-2021,Interest,00.00,"690,103.04",00.00,719CAD2fc78D6ee,2829,Breanna,Hubbard,"Haley, Bauer and Mullen",North Bradville,Palau,3812036106,(233)213-0706x2389,dbeard@gordon-lewis.com,2021-06-19,http://www.montoya-serrano.biz/
02-Mar-2021,Commission,00.00,00.00,00.00,9da3d344D1F759B,1903,Jack,Franco,Blackburn and Sons,Alisontown,Poland,+1-178-419-0745x12857,+1-594-929-5302,watersanna@dudley.net,2020-01-26,http://www.berry-berg.org/
02-Mar-2021,Transfer,202.50,00.00,202.50,9E0375Ff1c3Cf4f,2864,Chad,Wilson,"Rojas, Greer and Davenport",New Anitashire,Tuvalu,+1-377-470-5985x56363,001-071-786-7214x717,joannevillarreal@mata.org,2022-01-04,http://gilmore-chung.com/
02-Mar-2021,Cash,265.00,00.00,467.50,e2Ab05778cd1BeA,4490,Harry,Jimenez,Reese Group,Lake Alisonside,Macao,599-481-0198,153.726.7862,oestes@alvarado.com,2021-08-05,https://www.hubbard-barrera.com/
02-Mar-2021,NEFT,00.00,66.79,400.71,C8Aa24e3B9E8B0d,2509,Sherry,Kim,"Martinez, Moyer and Downs",South Tamishire,Netherlands Antilles,7149656013,847.889.2372,dbarnett@weiss.com,2020-05-08,http://www.cunningham.com/
02-Mar-2021,Reversal,04.00,00.00,404.71,06aF3Ee76B1E9bB,5997,Marc,Malone,Brown LLC,Port Brooke,France,+1-872-544-4001x8131,(293)814-1929,xferguson@holmes.com,2022-01-04,http://www.archer.com/
02-Mar-2021,Debit Card,"11,896.30",00.00,"12,301.01",7ABdCFcdfAE49Bf,567,Marc,Sanford,Collier-Young,East Miranda,Cocos (Keeling) Islands,012-321-2959,001-299-399-3529x725,alisondalton@hess-cline.com,2021-11-14,https://www.aguirre-sanders.com/
02-Mar-2021,Commission,751.00,00.00,"13,052.01",0dAEF35b5cCAa82,6915,Aaron,Ortiz,"Gill, Roman and Blair",West Bradleyberg,Vanuatu,489-652-6564x3529,+1-694-510-8865x85848,jenniferleon@santos-atkinson.biz,2020-07-19,https://simon-hendricks.com/
02-Mar-2021,IMPS,00.00,"1,631.50","11,420.51",4074461C1abdbE3,1254,Tina,Galloway,"Bird, Fox and Houston",Port Glendaland,Pakistan,9754745347,450.961.9090x5803,rick04@allen-foster.net,2021-11-21,https://www.munoz-chen.com/
02-Mar-2021,Interest,00.00,"11,420.51",00.00,eaaBfa86a5c3F3D,6926,Tracey,Levine,Ferguson Ltd,Schneiderchester,Holy See (Vatican City State),(535)842-7173,001-649-748-9555x8755,dwayne08@dennis.org,2022-04-24,http://johnson.net/
02-Mar-2021,Cash,"3,027.00",00.00,"3,027.00",9701dac44aAeBA7,2883,Amy,Owen,"Macias, Roman and Knight",Lake Tiffanytown,Micronesia,543.503.6547,(691)167-5516x502,theresa69@mcpherson.info,2020-03-26,http://henson.com/
02-Mar-2021,Bill,"7,308.00",00.00,"10,335.00",317B4Ead3580275,1048,Darren,Stokes,"Fleming, Krueger and Brady",Haysmouth,United States Virgin Islands,(685)455-5608x56247,325-101-4569x7233,eileenandersen@herring.com,2020-02-16,http://francis.info/
02-Mar-2021,Cash,"1,535,942.00",00.00,"1,546,277.00",EDB60f4CA5b339F,9353,Raven,Barrera,"Tran, Atkins and Mathews",Luiston,Morocco,+1-150-995-3106x9463,(602)961-4124x248,brendarios@camacho.com,2020-08-13,http://www.brooks.com/
02-Mar-2021,ATM,33.54,00.00,"1,546,310.54",61Cb08E7F99C1A3,6217,Tanner,Terry,"Cameron, Bolton and Crane",New Natalie,Mauritania,210.369.9372x187,+1-541-306-3180x06908,billsilva@beasley.com,2021-02-07,http://www.watson.org/
02-Mar-2021,Tax,00.00,"386,577.64","1,159,732.90",DC47c79b3FF93C4,6431,Warren,Chase,Sosa-Sanchez,Lindseymouth,New Zealand,3609640034,001-193-513-3293x3951,ryan80@fox.com,2022-04-05,http://www.copeland.com/
02-Mar-2021,Purchase,00.00,"165,676.13","994,056.77",A8bA1E0E2ede6aB,947,Rachel,Mills,Carroll LLC,Valentinetown,French Polynesia,+1-416-039-1617x561,(707)376-9925,brianaashley@mccoy.info,2020-04-11,https://larsen.com/
02-Mar-2021,NEFT,00.00,"994,056.77",00.00,10E5cd5a792BFbD,5936,Eduardo,Burch,Copeland-Little,Adriennefort,Maldives,(546)680-6837x197,296.346.4906x5006,camachoamanda@singh.org,2022-05-22,https://www.fox-mccarthy.com/
02-Mar-2021,Bill,03.90,00.00,03.90,Ff17C5290ADCc5C,4549,Sabrina,Barajas,Vaughn Inc,South Kyle,Yemen,(479)374-5020x24597,001-840-151-2675,hunterrhonda@curry.info,2021-05-23,https://www.cohen.com/
02-Mar-2021,Cash,00.00,01.30,02.60,2a55220cAfA8b65,1078,Heidi,Mcbride,"Riley, Thompson and Casey",Lake Alexandra,Lithuania,+1-230-866-5577,(690)812-6493x79399,joannemcdonald@conrad-gutierrez.info,2022-02-13,http://www.mcbride.biz/
02-Mar-2021,Miscellaneous,"3,988.00",00.00,"3,990.60",867Cfa58aFAce9c,9390,Stuart,Sullivan,Griffith PLC,North Whitney,Eritrea,7901395150,+1-376-506-0069x048,joanne68@mclean-mccoy.com,2020-08-05,https://www.shea-li.biz/
02-Mar-2021,Cheque,00.00,798.12,"3,192.48",9Fd7aA5fB6cDeD4,8541,Raymond,Rivera,"Lindsey, Wright and Powell",East Jon,Comoros,001-960-484-1870x34001,001-312-937-4992,yucharlotte@hanson.net,2020-08-02,https://mcintyre.com/
02-Mar-2021,IMPS,00.00,354.72,"2,837.76",B29FCfBfD746fF7,2475,Susan,Mendoza,Golden LLC,Hurleybury,Albania,272.960.6989,001-644-278-2645,jared30@mays-clarke.com,2021-07-16,https://pittman.com/
02-Mar-2021,Reversal,00.00,709.44,"2,128.32",124F2cA1a5dB547,4633,Fred,Wilkerson,"Pham, Livingston and Orozco",Birdfurt,Falkland Islands (Malvinas),385-302-1786,(778)532-0426x1190,rita88@rowe-bush.net,2022-04-14,https://www.lane.net/
02-Mar-2021,Commission,07.25,00.00,"2,135.57",e586A2D67bcdB48,12,Sara,Shaffer,"Dudley, Coleman and Green",Orrland,Gambia,4229986278,001-028-824-7381x56737,gabrielaleach@rose.net,2021-04-07,https://www.hoffman-rubio.com/
02-Mar-2021,Interest,00.00,266.95,"1,868.62",CAF3A0ECDd960C4,3387,Tanya,Guerra,"Whitaker, Farmer and Compton",East Jacqueline,Slovenia,(625)009-7856x277,001-390-167-2327,lgomez@roach.org,2021-01-19,http://stokes.com/
02-Mar-2021,RTGS,00.00,467.16,"1,401.46",d7a1c828dc04Ff7,515,Bonnie,Booker,"Pearson, Hubbard and Alvarez",South Christine,India,6961498901,412-244-1070x4570,penafrancisco@flowers.org,2021-02-25,https://gray-bowers.net/
02-Mar-2021,Interest,00.00,233.58,"1,167.88",B4f75e00EcEdC35,8681,Cheyenne,Arroyo,Barrera-Huynh,New Brandi,Liberia,001-795-834-4538x30390,(618)743-2429,gloriafarmer@bailey-ray.info,2020-12-28,https://herman.org/
02-Mar-2021,RTGS,00.00,166.84,"1,001.04",dEa1CBf47C3bFF2,3607,Luke,Ashley,Lewis-Ferrell,Grayborough,Guinea-Bissau,(884)878-2877x6628,+1-789-995-6497x4375,owentheresa@leonard.com,2021-08-09,http://www.sutton.com/
02-Mar-2021,NEFT,00.00,333.68,667.36,14D38c2Ddce1015,6474,Joyce,Forbes,Mathis PLC,Lake Joe,Finland,718-575-7707x598,435-030-2970,riverslauren@hall.com,2020-05-24,http://www.cordova.com/
02-Mar-2021,Cheque,00.00,333.68,333.68,e9F2D82313f41a7,2719,Matthew,Merritt,"Nguyen, Vance and Cooper",Prattstad,Estonia,001-397-206-6737x65423,303.941.3398,kristiemoses@curry.org,2020-02-20,https://www.rivers.com/
02-Mar-2021,Reversal,"2,019,539.50",00.00,"2,019,873.18",0F116b0fA9632cB,6121,Edwin,Santos,Tran-Anthony,West Theresachester,Gibraltar,601-927-4898x85682,+1-604-991-4692x43657,nathaniel16@downs.com,2021-03-12,http://www.webster.com/
02-Mar-2021,ATM,34.00,00.00,"2,019,907.18",BaEfBAd2DAf54F1,5829,Madison,Carter,Pruitt-Osborne,Haydenberg,China,(843)278-3452x86514,244-990-7712,dmarshall@mcdowell.info,2020-02-04,https://figueroa.com/
02-Mar-2021,Cash,00.60,00.00,"2,019,907.78",e5C0aF7f408aCa5,9955,Christy,Glenn,Blackburn-Rowe,Ritaview,Aruba,802-088-7303x131,(426)667-7241x6345,robertsongeorge@thomas-fuller.com,2020-12-22,https://melendez-downs.com/
02-Mar-2021,Reversal,00.00,"2,019,907.78",00.00,AB22af9bc344D4F,707,Peter,Vargas,"Fischer, Gonzales and Vasquez",Joeview,Malawi,886.228.7626,001-439-240-0551x5525,schaefertabitha@reynolds-curry.com,2021-01-30,https://www.ashley-mcclain.info/
02-Mar-2021,IMPS,"6,605.23",00.00,"6,605.23",0eb8FccC3bCE1B9,3699,Andrea,Franklin,Padilla Group,Wolfhaven,New Caledonia,(071)003-2126x68784,8210383101,qsanchez@silva-roberson.com,2022-01-04,https://rollins-moyer.net/
02-Mar-2021,Cash,"106,022.80",00.00,"112,628.03",DeF4B9e08eAE8a7,229,Olivia,Saunders,"Sanchez, Coleman and Leon",Lisaville,Korea,298.311.2706x59582,+1-498-562-7577x9389,triciarichards@shelton.net,2021-03-30,http://www.hurley.com/
02-Mar-2021,Debit Card,47.10,00.00,"112,675.13",c7FE37C2b87dC2A,2318,Stanley,Adkins,"Rodgers, Graham and Henson",Hardingside,Iraq,(427)277-5365x584,913-907-3335,rquinn@macias.biz,2021-04-04,http://gould.com/
02-Mar-2021,RTGS,"1,540.30",00.00,"114,215.43",DEBCf7eED3fe621,7412,Nicole,Paul,Wilkinson-Oconnor,Huangmouth,San Marino,008-548-7862x4363,699.115.3385,bryanjordan@schmidt-browning.com,2021-11-02,https://higgins.org/
02-Mar-2021,IMPS,14.57,00.00,"114,230.00",14Ff4b63A2fecF4,2222,Manuel,Patterson,Lin LLC,West Diamondview,Oman,583-835-8064x3404,776-881-4871,ohaney@fields.org,2022-02-04,https://www.aguilar.biz/
02-Mar-2021,RTGS,"65,923.16",00.00,"180,153.16",6ccBc0dFCF2C416,6235,Shirley,Shaw,Crosby-Cross,West Darrell,Saint Vincent and the Grenadines,001-507-394-7248x1522,001-376-963-2276x669,valenciacalvin@maddox.com,2021-07-22,https://www.harris-marshall.com/
02-Mar-2021,Debit Card,00.00,"180,153.16",00.00,dFb9ECdafbF55fF,5630,Sergio,Trujillo,Good and Sons,Pamelafort,Antigua and Barbuda,412-836-9934x494,(947)271-6763,wburke@greene-curtis.com,2021-10-05,https://www.barr.org/
02-Mar-2021,NEFT,65.58,00.00,65.58,B5075de9B6FbFA5,8320,Dana,Best,"Ibarra, Rojas and Benitez",New Meagan,Papua New Guinea,8241625087,+1-582-334-2552,vstanley@garrett.biz,2022-05-14,http://www.barrera.com/
02-Mar-2021,Cash,"1,408,804.50",00.00,"1,408,870.08",520fEc82d6FC65f,4687,Howard,Jarvis,Mcfarland Group,New Graceborough,India,656-493-9413,220.992.3081,maurice95@cooper.com,2020-04-16,http://www.stephenson.biz/
02-Mar-2021,Cheque,"2,490.81",00.00,"1,411,360.89",0cb0ceC431291Ef,6863,Adam,Rose,Hunt-Acosta,Lake Lydiabury,French Southern Territories,835.884.1985x2582,+1-353-856-7100,kylie90@berger.info,2021-05-20,https://www.velez-nielsen.org/
02-Mar-2021,NEFT,00.00,"156,817.88","1,254,543.01",aAC0dEdc22BBa83,2166,Max,Osborn,"Cole, Gibson and Duffy",Meyerbury,Brazil,862-825-9146x0710,(003)701-7242,vhammond@carrillo.com,2021-10-04,http://www.archer-cross.com/
02-Mar-2021,Tax,00.00,"156,817.88","1,097,725.13",E3a886752F9Ced1,7706,Jenna,Ward,Knapp-Lucero,North Terri,Somalia,001-375-246-9830x9031,001-339-037-0128x922,kyle23@brooks.com,2022-02-13,https://www.bowers.com/
02-Mar-2021,Transfer,"12,034.00",00.00,"1,109,759.13",0afAA5D950e833c,2605,Caroline,Rivas,Randolph Ltd,Richmondborough,Malawi,7763494220,+1-653-804-6493,phillip19@robbins.biz,2022-01-09,http://christian.com/
02-Mar-2021,Interest,"195,007.20",00.00,"1,304,766.33",d47D9cf5dFA3813,1780,Corey,Melton,Jacobson-Wade,Port Bailey,New Zealand,+1-104-581-5426x4237,001-614-999-8183x785,kemplaurie@bradshaw.com,2022-03-17,http://morales-brewer.net/
02-Mar-2021,Cheque,"84,553.10",00.00,"1,389,319.43",CfD5ED9Ce8b8777,4382,Jennifer,Marquez,Nicholson-Rowland,Lanceville,Equatorial Guinea,935-496-6952,001-624-704-7014x34974,robersoncurtis@huynh-blankenship.com,2020-01-31,https://www.schneider.com/
02-Mar-2021,Tax,"12,242.20",00.00,"1,401,561.63",18EC22b40be4f24,8030,Isabel,Humphrey,Vance-Ford,West Kathryn,Russian Federation,089-851-2862x322,9737557872,curtisalexandra@vasquez.com,2020-09-22,http://www.bender.org/
02-Mar-2021,ATM,"27,878.00",00.00,"1,429,439.63",e71B43A66df8636,1276,Bill,Mcconnell,Wolf-Gonzalez,North Mariah,Honduras,+1-246-033-4748x494,+1-197-051-6862,dunlapdeborah@olson.com,2020-12-09,https://www.donaldson-fernandez.com/
02-Mar-2021,NEFT,00.00,"142,943.96","1,286,495.67",FeCF8b0bEccaB9F,3455,Jackie,Schaefer,Cooke Ltd,East Bill,Slovenia,738-990-2176,211.765.2040x8507,mason17@rivers.org,2020-01-18,http://www.vasquez.com/
02-Mar-2021,IMPS,00.00,"142,943.96","1,143,551.71",B12F96Fd9FD84B0,4776,Andres,Alexander,Gaines-Silva,Lawrenceberg,Israel,+1-731-326-4061,(440)205-1691x6035,yvilla@patel.biz,2020-02-05,https://nelson.com/
02-Mar-2021,NEFT,40.68,00.00,"1,143,592.39",ce24B24fe544a83,2245,Kellie,Juarez,"Ferguson, Schroeder and Roach",Shawnstad,Grenada,131.316.1562x044,7820080329,audrey02@bowers.com,2022-02-08,https://harrington-tyler.com/
02-Mar-2021,Miscellaneous,"1,807,893.50",00.00,"2,951,485.89",3FdFa713B9AF4Ea,6051,Gabrielle,Baldwin,"Kerr, Riggs and Stone",North Lonnieport,Brunei Darussalam,001-844-781-0565x2178,664-731-7066,garycarr@shea.com,2021-12-21,http://mccullough.com/
02-Mar-2021,IMPS,00.00,"737,871.47","2,213,614.42",40AEe659A3629aF,4983,Ivan,Butler,"Summers, House and Adams",Bobton,Italy,+1-378-049-9570,001-364-671-4220x644,castrocheyenne@hudson-ortega.net,2021-09-05,https://www.jacobson.com/
02-Mar-2021,Purchase,00.00,"276,701.80","1,936,912.62",5Dcf15C6f5de2aC,2616,Kathy,Petty,Santiago LLC,West Kellistad,Estonia,382-284-1007,(016)386-1876x7857,debbiefaulkner@ferguson.net,2021-12-21,https://www.lewis.biz/
02-Mar-2021,Debit Card,00.00,"215,212.51","1,721,700.11",4E2A194a47c3C94,223,Holly,Ford,Walker Group,Mcgeemouth,India,674-359-8368x3113,001-386-467-9110x19533,sabrinaerickson@wise.info,2020-09-10,http://odom.info/
02-Mar-2021,Bill,00.00,"191,300.01","1,530,400.10",bd2FCeDCa54DA5a,5819,Geoffrey,Logan,Poole-Bowen,East Betty,Fiji,+1-362-389-3511,001-836-852-1579x270,kathleenjames@wilson.org,2021-07-10,https://www.rivera-maynard.com/
02-Mar-2021,Miscellaneous,"46,013.00",00.00,"1,576,413.10",B6Ef430Fdd87Cb4,7823,Mercedes,Thompson,Underwood-Gaines,Derekchester,Dominica,(235)129-6652,2938767088,ymelendez@mcgee.biz,2021-02-07,http://www.kelley.info/
02-Mar-2021,IMPS,500.20,00.00,"1,576,913.30",1dfBCfbbab0B7f7,6483,Jesus,Cortez,Carey-Acevedo,Wesleytown,Gabon,(076)600-9054x77352,651-649-7033,alishablevins@bell.com,2021-07-05,https://www.benson.net/
02-Mar-2021,Transfer,00.00,"175,212.59","1,401,700.71",F08D0610937E87c,9732,Tracie,Donovan,Carson-Glass,Elizabethside,El Salvador,+1-514-562-6430,524-284-9296,curtisjones@bush.biz,2020-06-23,http://bowen.com/
02-Mar-2021,RTGS,00.00,"280,340.14","1,121,360.57",63Dff8b8eAB0BC6,6021,Frank,Murillo,Decker Group,New Lonnieville,Iceland,401.222.0429x4189,073-705-2158x5471,bergmelanie@lawrence.com,2020-07-07,http://www.shepard.net/
03-Mar-2021,Reversal,00.00,"224,272.11","897,088.46",D8BEFBDBC2f37B1,5594,Cheryl,Reilly,Newton-Aguirre,Port Brady,South Georgia and the South Sandwich Islands,+1-583-584-5528x07142,001-568-514-0368x227,blake59@edwards.com,2020-04-13,http://www.barrett.info/
03-Mar-2021,Debit Card,02.55,00.00,"897,091.01",b588B5edb16bCfC,2572,Casey,Lopez,Ibarra Group,Donnamouth,Romania,156-426-2258x7241,3084054550,miacampos@weeks.com,2022-04-02,https://www.castillo-weaver.com/
03-Mar-2021,Debit Card,08.00,00.00,"897,099.01",DEeB660E2e47C36,2603,Charlotte,Trevino,Guerrero-Parrish,East Margaretville,American Samoa,+1-291-842-8280x99257,(040)725-6579,kraymond@ashley-mckee.com,2020-01-09,https://barton.com/
03-Mar-2021,IMPS,00.00,"897,099.01",00.00,d03d0321A8DC6aD,2135,Selena,Sharp,Hensley Inc,Gomezview,Nepal,(101)802-6962x32896,001-457-528-2087x81533,yskinner@barber.com,2022-03-09,http://www.newton.com/
03-Mar-2021,NEFT,288.11,00.00,288.11,8D4A1B8aDd8eCec,3279,Andres,Rubio,"Willis, Burton and Griffith",East Dawn,Tonga,143-893-7884,114.962.9738x85245,sharon62@pace-barr.com,2021-01-19,http://jones-mayer.org/
03-Mar-2021,Purchase,134.50,00.00,422.61,Fd3c711ceFcf949,1418,Kari,Blackwell,Briggs-Estrada,Port Juan,Lesotho,(386)152-0806,(309)175-0038x74405,lobrien@herring.com,2021-12-11,https://www.vang.com/
03-Mar-2021,Reversal,14.37,00.00,436.98,fCDd81Aa0cADD38,9959,Caitlin,Tate,"Howe, Bates and Forbes",North Latoyafurt,Norway,5274550159,(586)291-2525x0018,gwendolynlam@chang.com,2021-09-29,http://gonzalez.com/
03-Mar-2021,Transfer,00.00,436.98,00.00,c08d8F81d57ccAC,7022,Kylie,Moran,House LLC,Karlamouth,Saint Vincent and the Grenadines,+1-414-174-2290x7628,(980)269-5927,ppollard@cox.info,2020-05-05,http://mayo.com/
03-Mar-2021,Cheque,"385,457.00",00.00,"385,457.00",70eCEd2CAB2961E,7691,Dean,Lynch,Jefferson Group,Dakotaberg,Ghana,482.466.8022x74240,720.917.5455x11388,alishabarker@conley.com,2021-02-01,http://sherman-cabrera.info/
03-Mar-2021,Interest,00.00,"96,364.25","289,092.75",2Eea6cb109d9d3A,2477,Shane,Kidd,"Donaldson, Duke and James",Rileyville,Guadeloupe,512.313.0252,+1-121-432-4001x0082,rachelwalsh@long-stuart.com,2021-10-30,https://ibarra-wall.net/
03-Mar-2021,ATM,"7,893.50",00.00,"296,986.25",Cd6e22F50BEFe36,8472,Julian,Collier,"Patel, Martin and Hess",Kristopherchester,Saudi Arabia,001-270-665-7663x61315,(994)286-0534x2976,pgalloway@santos.com,2021-03-20,http://bridges.com/
03-Mar-2021,Tax,00.00,"29,698.63","267,287.62",DCBeedCbEb93C88,8343,Luis,Fox,Mueller Ltd,West Anthonyfurt,Swaziland,001-687-822-3353x22417,625.931.3925,rachaelwashington@hayes.com,2020-05-31,http://lane.com/
03-Mar-2021,Tax,00.00,"53,457.52","213,830.10",D0333ff4BD86DeA,3792,Blake,Hudson,Stanton-Castro,New Tammyfurt,Bhutan,(354)293-9920,877.154.9497,weberalfred@frederick.com,2020-04-14,https://patton.org/
03-Mar-2021,NEFT,"3,679.00",00.00,"217,509.10",F1c119b4E27b68B,7300,Victor,Clayton,James-Phelps,New Anthonymouth,India,+1-821-397-5906x16426,(483)585-5791,rebekah14@mcdaniel.com,2022-03-14,https://trevino.biz/
03-Mar-2021,Debit Card,23.98,00.00,"217,533.08",b38DA3B9d2419a3,2714,Leah,Mckenzie,Lawrence LLC,North Meagan,Peru,001-035-337-7443x92890,061-768-0736x306,brianarandolph@webb.net,2021-09-25,http://roy-holden.org/
03-Mar-2021,Purchase,00.00,"217,533.08",00.00,F79265697C9fFcc,563,Clarence,Frye,Zimmerman-Wagner,Terrifurt,Saint Vincent and the Grenadines,(713)720-7205,+1-876-156-6443x620,suttonroy@snyder.com,2022-01-21,https://www.montes.com/
03-Mar-2021,Debit Card,"1,276,247.00",00.00,"1,276,247.00",Fbf89bACC9D82a4,5751,Larry,Patterson,Clayton-Page,East Cameronfort,Jersey,075.098.0124x8399,+1-717-292-1322x57840,johnmartin@calderon.org,2021-04-25,http://cervantes.com/
03-Mar-2021,Cash,"11,176.50",00.00,"1,287,423.50",Ad9E80698c5b908,9344,Daisy,Pitts,Patel-Joseph,Gentryside,Somalia,+1-506-458-7905,+1-486-589-0943,bensoncalvin@garrett.com,2022-04-11,https://www.farmer-norris.com/
03-Mar-2021,IMPS,249.67,00.00,"1,287,673.17",ba7aCbA2f4CfEf4,2800,Alexa,Burton,Morse-Mclean,Port Ralphfurt,Cook Islands,537-812-9009,658-668-5354x1770,nmeadows@schroeder.com,2020-11-28,http://pena.org/
03-Mar-2021,Cheque,04.11,00.00,"1,287,677.28",FFf6Ad9dC7079Cb,4691,Rodney,Hatfield,"Baxter, Sawyer and Gardner",Lake Corey,Ukraine,+1-594-075-5781x09010,(274)026-2836,donaldhorne@cross.biz,2022-04-18,https://www.reynolds.com/
03-Mar-2021,Reversal,"125,219.28",00.00,"1,412,896.56",BCAba51C23BB78C,1598,Kristin,Estes,Miles-Benson,East Maureen,Iceland,+1-049-168-1943x525,378-955-3678,timothystrickland@jefferson-mendez.net,2021-12-26,https://www.moon.org/
03-Mar-2021,RTGS,00.00,"176,612.07","1,236,284.49",5820deAdCF23EFe,5,Kathleen,Mccormick,Carson-Burch,Andresmouth,Macao,001-184-153-9683x1497,552.051.2979x342,alvaradojesse@rangel-shields.com,2021-01-17,https://welch.info/
03-Mar-2021,IMPS,"1,544,759.80",00.00,"2,781,044.29",5FD087094D61F20,2218,Destiny,Cohen,Krueger-Holland,Philipton,Taiwan,+1-759-880-4716x3322,(008)374-6605x08110,charleneabbott@mcintosh.biz,2020-09-03,http://www.cordova.com/
03-Mar-2021,Miscellaneous,"197,550.00",00.00,"2,978,594.29",a5aAb4a242a01e1,4213,Kim,Bridges,"Caldwell, Wilkinson and Schneider",Lucaschester,Ireland,0555058411,925.015.0829x3377,bherrera@cruz.com,2020-10-27,https://www.austin.org/
03-Mar-2021,NEFT,08.00,00.00,"2,978,602.29",a467BebB5becedf,5234,Andre,Best,"Franklin, Holder and Bauer",East Gina,United States Virgin Islands,308.751.2134,836-649-9262,jburns@schwartz.com,2021-10-22,http://www.gould.com/
03-Mar-2021,Purchase,00.00,"1,489,301.15","1,489,301.14",7abBE6A996BEacd,6312,Gregg,Figueroa,"Callahan, Cuevas and Mcintosh",North Breanna,Antigua and Barbuda,(385)234-1824x07091,(351)703-9937x8945,arthurbell@henry.net,2020-12-18,https://marshall.com/
03-Mar-2021,Purchase,"26,057.67",00.00,"1,515,358.81",DeF4B9e08eAE8a7,229,Olivia,Saunders,"Sanchez, Coleman and Leon",Lisaville,Korea,298.311.2706x59582,+1-498-562-7577x9389,triciarichards@shelton.net,2021-03-30,http://www.hurley.com/
03-Mar-2021,Cheque,00.00,"168,373.20","1,346,985.61",09dB4fA1a47f90a,6852,Bryan,Arroyo,Chung PLC,Elizabethmouth,Nigeria,323-597-9163,884.921.7945x21097,dramsey@ramos.com,2020-08-26,https://fuller-krause.com/
03-Mar-2021,Reversal,"1,109,120.20",00.00,"2,456,105.81",F79265697C9fFcc,563,Clarence,Frye,Zimmerman-Wagner,Terrifurt,Saint Vincent and the Grenadines,(713)720-7205,+1-876-156-6443x620,suttonroy@snyder.com,2022-01-21,https://www.montes.com/
03-Mar-2021,Miscellaneous,"2,052,578.00",00.00,"4,508,683.81",fD1e2d4BB1A3Add,1481,Crystal,Mcgee,Underwood-Kline,Staffordton,Falkland Islands (Malvinas),(276)700-6967,(025)035-7908,nayers@higgins.com,2021-11-29,http://peters.org/
03-Mar-2021,NEFT,00.00,"450,868.38","4,057,815.43",E6d410bF341CD2A,9169,Dennis,Benjamin,Joyce PLC,West Suzanne,Fiji,423.643.1091x97929,(781)182-4817x032,anna66@spears-harrison.com,2020-12-13,https://day-zhang.com/
03-Mar-2021,Purchase,00.00,"405,781.54","3,652,033.89",31B68C3A8c8c3Bb,6503,David,Page,Rivera-Rivera,New Normaland,United States Virgin Islands,001-751-614-9145x35749,304-445-3680,jacob41@pierce-cruz.com,2020-06-17,http://www.johnston.com/
03-Mar-2021,Cheque,00.00,"456,504.24","3,195,529.65",1A62Beadc43eA17,5815,Theresa,Bradley,Chandler Inc,Shelbyshire,Norfolk Island,(561)910-9633x4131,493-281-5926x6476,cassandra48@barker.com,2021-07-29,http://www.benjamin.com/
03-Mar-2021,Interest,376.00,00.00,"3,195,905.65",6de09ab5dE8e6B8,1993,Fred,Taylor,Cordova Inc,West Joann,Ethiopia,858-569-1816x84261,8168211377,roberto35@forbes-liu.com,2022-05-15,https://espinoza.biz/
03-Mar-2021,IMPS,00.00,"639,181.13","2,556,724.52",e3BC53e714ff83A,7073,Franklin,Conner,"Gould, Vincent and Huff",Madisonfurt,United States of America,747.853.9176x44490,261.665.5624x991,tamara82@khan.net,2021-12-31,http://gross.net/
03-Mar-2021,Interest,"452,606.50",00.00,"3,009,331.02",479Fbf73d78f24F,6487,Bruce,Howell,"Gomez, Higgins and Short",Alantown,Tokelau,(682)702-0132x079,294-780-9182,arose@noble.biz,2022-03-13,https://www.collins.net/
03-Mar-2021,Interest,05.93,00.00,"3,009,336.95",B63B9FAAAAab64e,7273,Carol,Thornton,"Mack, Harding and Combs",Estradamouth,Lithuania,346.461.7261x2102,(565)108-1459x2196,calvin02@morrison.net,2020-05-08,https://www.washington.info/
03-Mar-2021,Cheque,00.00,"1,003,112.32","2,006,224.63",abbaa374b64a13d,1764,Jesse,Gill,Fuentes-White,Salazarborough,French Guiana,848.113.3990x33531,+1-446-884-0474x407,prestonburns@chang.com,2021-03-04,https://www.cabrera-cooke.com/
03-Mar-2021,Reversal,06.00,00.00,"2,006,230.63",1c08e6dB6FB09B8,8866,Stefanie,Rosario,"Porter, Luna and Christian",Christinaside,Egypt,467-641-7345,1861203167,roachcarly@roy.net,2021-12-26,https://www.gates.com/
03-Mar-2021,Miscellaneous,44.70,00.00,"2,006,275.33",A4BA3935d481bfB,3644,Randy,Davies,"Malone, Larsen and Baird",Oconnorstad,Romania,001-985-438-9835x041,834-412-1122,brandi65@baldwin.org,2020-02-20,http://www.solis-powell.info/
03-Mar-2021,Cash,00.00,"250,784.42","1,755,490.91",2900d28b0bAEFC2,3844,Jesus,Oneal,"Maddox, Sanders and Burns",Charleneborough,Cook Islands,+1-033-633-4264x1125,6357255607,ginairwin@mcclain-ramsey.com,2020-11-06,http://waters.com/
03-Mar-2021,Commission,29.00,00.00,"1,755,519.91",F2Deca309F8E1cd,5741,Madeline,Rowe,"Townsend, Walsh and Sloan",Maciasstad,Dominican Republic,969.107.4039,949.285.2046x842,meganrobinson@tucker.com,2022-04-26,https://blair.net/
03-Mar-2021,NEFT,00.00,"877,759.96","877,759.96",9f34aBCdeCAB46e,3401,Daryl,Friedman,Banks-Randall,South Vernon,British Indian Ocean Territory (Chagos Archipelago),8262531638,001-118-973-9474x3280,montgomeryross@gilmore.net,2021-12-28,http://gamble.com/
03-Mar-2021,Cheque,"649,172.50",00.00,"1,526,932.46",a69EC70Ac9a6BFf,8551,Cameron,Nichols,Williamson PLC,Lake Tara,Marshall Islands,558.003.6796x276,(547)459-8798x37220,beasleyjorge@payne-hoover.com,2020-06-30,http://www.hayden.info/
03-Mar-2021,Cheque,00.00,"254,488.74","1,272,443.72",c36bE0DA8FbC4Ee,1654,Karla,Mccormick,Cole Inc,Lake Elizabeth,Saint Lucia,649-156-7076x66036,528.142.6204,wrandall@sweeney.com,2020-08-02,https://www.acevedo-may.com/
03-Mar-2021,ATM,00.00,"212,073.95","1,060,369.77",6DF7bb3e9a4ba9B,8463,Craig,Daniel,Conway-Maynard,East Molly,United States Minor Outlying Islands,+1-836-629-6510x5535,001-261-128-7802x265,lukeroach@cortez.biz,2021-03-03,http://holder-barber.com/
03-Mar-2021,Cash,00.00,"353,456.59","706,913.18",E4Adf8102aC4f40,7838,Theodore,Todd,"Shields, Estes and Klein",Lake Maxwellview,Morocco,(474)192-0956,001-269-580-1014x66860,carlylogan@estes-cole.org,2021-04-21,http://www.lynch-rowland.com/
03-Mar-2021,Miscellaneous,00.00,"353,456.59","353,456.59",FfBBFd5cFBbdF3A,1641,Tammie,Cunningham,Yu Ltd,North Billville,Peru,+1-726-124-9474x7924,840.027.3793,michaela61@sims-terry.net,2020-04-25,https://hicks.info/
03-Mar-2021,Cash,59.26,00.00,"353,515.85",B7C8Ac33DcDA629,166,Patty,Estes,Potter-Doyle,Lake Johnathanborough,Mozambique,555.786.9024x8126,(526)826-8221x0813,vincent58@norton.com,2021-02-08,https://www.mendez-duran.com/
03-Mar-2021,Miscellaneous,00.00,"39,279.54","314,236.31",6d7b787f2Fdcd5b,9752,Sierra,Middleton,Russo-Daniel,Jakebury,New Caledonia,+1-387-962-6228,(186)951-0086x53533,aduffy@weaver.org,2021-12-10,http://www.montes.info/
03-Mar-2021,IMPS,00.00,"52,372.72","261,863.59",f1fCDC389b6deF6,4409,Clifford,Duffy,Cooper and Sons,New Jenna,Guadeloupe,0861483008,001-388-309-6343x26974,priscillamoon@nash.com,2020-02-06,https://blackwell-bernard.org/
03-Mar-2021,Tax,00.00,"26,186.36","235,677.23",a26711e5794EAdb,5377,Michaela,Dillon,"Gutierrez, Cruz and Freeman",Lauraberg,Egypt,975-393-0290x83245,(304)406-9697x3947,kara47@mcclain.net,2021-05-10,http://www.mathews.biz/
03-Mar-2021,RTGS,28.67,00.00,"235,705.90",908aCB2ACee5B20,2989,Tammie,Bowers,"Melton, Petty and Archer",North Mackenzietown,Martinique,423-743-0682x9685,(385)963-4728x4571,wyatt84@dougherty-hays.info,2021-07-21,http://www.hendricks-martin.com/
03-Mar-2021,Debit Card,00.00,"23,570.59","212,135.31",EA8EBaBCA4F7D41,4006,Corey,Dawson,"Bauer, Glenn and Rivers",Bradchester,Qatar,001-162-735-3672x5682,(356)104-4479x64994,marissasampson@barnes.com,2020-08-11,https://www.pugh.com/
03-Mar-2021,Cash,00.00,"21,213.53","190,921.78",94fd798dC0d7D55,7775,Dominique,Ferrell,"Roberts, Moss and Crosby",Marisamouth,Faroe Islands,842-950-3087x051,(391)829-3509,wardcharlene@becker-cortez.com,2021-12-29,http://www.henry.biz/
03-Mar-2021,RTGS,00.00,"23,865.22","167,056.56",9aAAdf3Fa73D803,9808,Ricardo,Marsh,"Mullins, Meadows and Farrell",Boyleshire,Bolivia,001-791-205-3669x6618,+1-506-497-5891x00507,horr@bowman.com,2021-09-25,http://www.zuniga-vaughan.com/
03-Mar-2021,NEFT,"155,554.66",00.00,"322,611.22",9bB8eC5BF8d309e,5432,Natalie,Underwood,Dorsey-Kelley,Port Annaside,Swaziland,138-428-8532,535-214-1109x6296,cody84@watts.org,2022-05-22,http://daniels-barrera.com/
03-Mar-2021,RTGS,"177,222.00",00.00,"499,833.22",2BE9Fdcb52eCEFB,440,Samantha,Maddox,"Grimes, Morgan and Schneider",Rachelmouth,Bahamas,001-501-207-2471x684,(573)653-2044x89073,mortonsally@walls.info,2021-06-24,http://www.richard.com/
04-Mar-2021,Purchase,00.00,"55,537.02","444,296.20",eD30cdb4C0cac13,6013,Latoya,Olson,"Long, Odonnell and Zavala",Lake Loretta,Congo,313-376-7621x8994,134.526.0827x7896,bruce08@parrish.info,2021-06-01,https://www.mcdaniel.com/
04-Mar-2021,Cheque,16.65,00.00,"444,312.85",ceEabAe50A0f63b,8401,Steven,Barrett,"Robles, Gentry and Barker",West Grant,Singapore,962-837-9447x102,001-310-449-6675x619,jenniferbanks@floyd-frank.com,2021-10-27,http://mclean.com/
04-Mar-2021,Miscellaneous,00.00,"88,862.57","355,450.28",6c9eba9Aa2c86de,1467,Ruben,Wade,Howard Inc,Ricardoton,Nicaragua,179-122-5563,+1-812-385-1697x232,alicia14@acevedo.com,2020-09-19,https://www.bautista.info/
04-Mar-2021,Commission,00.00,"35,545.03","319,905.25",0c1cbAC211DA8CA,9121,Nancy,Cline,Joyce-Sheppard,Ashleyton,United States Minor Outlying Islands,791-865-2383x90000,001-613-701-4329,paulacortez@case.com,2021-08-25,http://andersen.com/
04-Mar-2021,Bill,"110,218.70",00.00,"430,123.95",adc155A42a8FEFa,1926,Janice,Garrison,Nunez Ltd,South Edwin,Mauritania,231-007-9710x4571,341-180-2305x81183,pedro48@page.com,2020-10-21,https://www.clayton.com/
04-Mar-2021,Miscellaneous,00.00,"107,530.99","322,592.96",79DBcd5b753Ab65,8533,Kelly,Sharp,Holland-Bruce,Rachelhaven,British Virgin Islands,027.793.1370x3799,652-323-5967,mhartman@holden.com,2022-01-10,https://www.wise.com/
04-Mar-2021,Bill,00.00,"107,530.99","215,061.97",7ee0955c09C42C5,1562,Lonnie,Shah,Conner-Cruz,West Blake,Palau,766.881.4499,148.159.5414x188,andrewstoni@whitehead.biz,2020-09-19,https://www.fox-reyes.com/
04-Mar-2021,Miscellaneous,00.00,"215,061.97",00.00,AbD453727d69b88,4816,Randy,Jimenez,Brock and Sons,South Kaitlynberg,Germany,725.115.9119,498.021.1063x2395,mendezpamela@velazquez.info,2020-09-30,https://robertson-pierce.org/
04-Mar-2021,NEFT,"11,259.10",00.00,"11,259.10",eBDcFCFCad97fE5,4978,Chase,Booker,"Strong, Ochoa and Ford",New Kristinehaven,Serbia,032.543.4977x60128,(663)149-0064x037,joycelarson@williamson.com,2021-06-02,http://www.rios.info/
04-Mar-2021,ATM,00.00,"1,876.52","9,382.58",a6B7BCABae4Aa10,1142,Jonathon,Townsend,"Cobb, Joseph and Singleton",South Jeremy,Swaziland,123-335-1098x38176,(369)763-3949x193,alexjackson@barron-mcneil.com,2021-04-08,https://www.ingram.com/
04-Mar-2021,Bill,00.00,"1,340.37","8,042.21",8F8a207fcE83c41,3010,Troy,Wallace,Huff Inc,Santiagoville,Mali,001-189-435-0246x724,377-826-7229x32265,jerickson@foster.info,2020-09-07,http://www.molina-patrick.com/
04-Mar-2021,Purchase,"476,848.00",00.00,"484,890.21",97B9A224fdeAedA,2170,Alec,Webb,Ballard Group,North Glendaton,Heard Island and McDonald Islands,+1-626-914-6702x9060,001-586-192-0781x158,sanfordfranklin@esparza.com,2021-09-17,http://lam.com/
04-Mar-2021,Debit Card,"196,283.50",00.00,"681,173.71",1c03aDeB798bCA8,7552,Cristian,Conrad,Fritz-Hancock,West Granttown,Macao,503.169.2944x532,436.036.2418,heatherchung@mathews.com,2021-12-15,http://www.holloway.net/
04-Mar-2021,Reversal,00.00,"75,685.97","605,487.74",C9dAB363AD3Fabe,6105,Mandy,Bailey,"Chaney, Hatfield and Rodgers",Lake Priscilla,Kiribati,001-120-616-7144x31841,001-458-872-0400x6180,trevor38@buckley.com,2021-04-27,https://www.holmes.com/
04-Mar-2021,NEFT,00.00,"86,498.25","518,989.49",151A6a7Deb33bcA,183,Stacy,Hayden,Rush and Sons,Port Shawna,Spain,001-383-579-5745,+1-222-830-3139x0809,gravesalisha@harrell.info,2021-11-24,https://www.li.biz/
04-Mar-2021,ATM,00.00,"259,494.75","259,494.74",aa1CD1AD0CB4dEf,153,Tyler,Oconnell,"Kemp, Mcpherson and Miranda",West Mariamouth,Indonesia,080.144.4110x65237,164-410-7696,lunakirsten@zimmerman-salinas.org,2020-06-15,https://howard-crawford.com/
04-Mar-2021,NEFT,294.35,00.00,"259,789.09",bdF9ED2ba4bFAcE,9593,Fernando,Navarro,Johnston-Bishop,South Ericachester,Saint Vincent and the Grenadines,9778449820,+1-192-027-5504,xbray@mayer.com,2022-05-05,https://www.miranda.com/
04-Mar-2021,IMPS,00.00,"43,298.18","216,490.91",eF6db5b6C33Cad3,9168,Lisa,Schultz,Cochran-Wiggins,West Janeshire,Costa Rica,001-754-068-5069x13673,+1-370-374-5127x263,mccartyrickey@jennings.com,2021-05-08,http://dudley.com/
04-Mar-2021,Transfer,"2,094.70",00.00,"218,585.61",EbaE5b543ECEB18,4179,Travis,Estes,Durham-Lamb,West Tonya,Seychelles,(301)417-6480x626,(335)128-0914x363,martinweber@berry.biz,2022-02-12,http://www.castro.com/
04-Mar-2021,Tax,00.00,"31,226.52","187,359.09",d3a6c01F6E695a6,5489,Shaun,Stuart,Spencer-Buchanan,Stacyport,Lithuania,625-643-0309x6458,(172)632-4350x204,gonzalesroberto@johnson.com,2021-06-28,https://www.walker.com/
04-Mar-2021,Cheque,00.00,"187,359.09",00.00,fbFCe3bEf074Ac1,5420,Robyn,Noble,Shields-Ball,Juliefurt,Oman,161-501-0848x12007,096-587-3193x699,brandon00@soto.com,2022-01-10,http://www.rice.org/
04-Mar-2021,Transfer,27.00,00.00,27.00,5Cf2DCACBF9bDEd,7767,Lorraine,Edwards,"Harmon, Roberts and Mcguire",Janiceport,Lithuania,001-859-829-0219,6230623365,harmonsarah@zavala-solis.com,2020-06-10,https://www.donovan-sandoval.org/
04-Mar-2021,IMPS,"208,400.90",00.00,"208,427.90",b1D5F0D054F65E8,6614,Kirsten,Downs,Bernard Group,Chelseyville,Kyrgyz Republic,(820)895-5438x87752,+1-121-169-8494x562,zavalajaclyn@summers-trujillo.com,2020-02-12,http://www.lowe-hampton.com/
04-Mar-2021,RTGS,00.00,"34,737.98","173,689.92",505F6632C3cFDD2,4479,Justin,Clarke,"Sandoval, Simpson and Lawson",South Rogerchester,Jamaica,048.629.6502,+1-344-284-6514x61302,yangcaitlin@franklin.com,2021-02-22,http://morales-bartlett.info/
04-Mar-2021,Cash,"12,667.30",00.00,"186,357.22",cF7F3FFD67aCC5d,6724,Jade,Hoover,"Robles, Horton and Banks",Tammiefort,Lebanon,3233292648,+1-871-415-3647x629,hickmancameron@moreno-randolph.net,2021-10-27,https://www.perez.com/
04-Mar-2021,Interest,00.00,"18,635.72","167,721.50",a895a9dfea93dD7,6979,Michael,Beasley,Schroeder LLC,New Cheryl,Togo,001-629-907-7727x336,199.675.0432x0753,jeanettemarshall@gay-haney.info,2020-12-19,https://ward.com/
04-Mar-2021,Commission,00.00,"27,953.58","139,767.92",a778DCf5C2d3193,2455,Regina,Boyd,"Carter, Rodriguez and Hurst",Lake Cory,Bosnia and Herzegovina,2878584638,036.235.6824,holly18@bautista.com,2022-01-02,https://price.com/
05-Mar-2021,Cheque,"677,404.00",00.00,"817,171.92",6efE2e5A94a8a4B,7220,Lydia,Abbott,Chandler-Long,Nancyshire,Nepal,740.931.8971,138-398-4179x5581,mterry@fletcher-allison.com,2020-07-18,https://www.thomas.com/
05-Mar-2021,Cheque,456.00,00.00,"817,627.92",0EEd0FAbc4fbBeB,8631,William,Greer,Powell-Floyd,Port Laurabury,Niue,541.506.7432x6879,(324)443-7606x0558,lauriereilly@stokes-hoffman.com,2021-02-18,https://thomas.com/
05-Mar-2021,Cash,00.00,"116,803.99","700,823.93",F3Ab3D80D7212e9,8284,Meredith,Hoffman,Reid Inc,Pattersonmouth,Brunei Darussalam,321-824-5673x3627,+1-164-108-5404x574,taylorbeltran@nixon.org,2021-09-22,https://www.harrell.com/
05-Mar-2021,Cheque,"3,963.00",00.00,"704,786.93",A5F38CfE6bff7d6,9766,Patrick,Reeves,Shaw Inc,Schultzfort,Belarus,623-086-5838x2370,083-297-3547,jackson81@waters-arroyo.org,2020-04-05,https://schaefer-howell.info/
05-Mar-2021,Transfer,00.00,"352,393.47","352,393.46",CedEF89c8fB6988,4357,Leslie,Richards,"Kim, Kelly and Freeman",Shafferfort,Morocco,436-977-0122,001-818-338-9698x28948,cameron42@gamble.net,2021-02-17,http://franklin.com/
05-Mar-2021,Interest,07.00,00.00,"352,400.46",b9486F1c7A71cC5,4751,Micheal,Lara,Dickson Group,New Rhondaborough,Guernsey,001-538-686-1526x327,7414425722,brittneyberg@marsh.com,2020-06-22,http://www.blair.com/
05-Mar-2021,ATM,469.00,00.00,"352,869.46",5bEDAd9D1F91e0c,9051,Erica,Zuniga,"Manning, Golden and Ellis",Port Frederick,Argentina,001-238-449-9212x6937,0288318936,gpatel@best-blackwell.com,2021-05-24,http://www.fischer.com/
05-Mar-2021,Miscellaneous,00.00,"44,108.68","308,760.78",eD1a22e3e4A2fd1,3998,Danny,Roy,"Gallegos, Nichols and Potter",Krystalchester,Fiji,290-528-8242x37712,(355)130-8488x7295,xchen@doyle.com,2021-08-03,http://www.crosby.com/
05-Mar-2021,Tax,00.00,"38,595.10","270,165.68",ff855Be3122eb3f,811,Kristine,Stevenson,"Mullen, Davila and Levy",Kellymouth,Eritrea,(704)514-8614x489,+1-996-387-1218x60157,vdavila@villegas-kline.com,2021-08-24,https://www.tran.biz/
05-Mar-2021,Reversal,"27,941.71",00.00,"298,107.39",2f1e7CAD9f76fae,2933,Mindy,Li,Cline Ltd,Eileenbury,Grenada,6343628698,001-519-899-1764,marshrachel@haley.com,2021-08-14,http://www.escobar.com/
05-Mar-2021,Cash,01.90,00.00,"298,109.29",ccdeE8EBFaD872D,6313,Edward,Sawyer,Stevens Inc,Steventon,American Samoa,(835)769-9706,(697)463-3120,manueldowns@dodson-wilkerson.com,2021-12-24,http://ryan.org/
05-Mar-2021,Debit Card,"1,406,803.25",00.00,"1,704,912.54",F4195E9e1621bD7,960,Alison,Riggs,Hall-Blackburn,Judithbury,Ethiopia,960.068.4536,(071)103-8359x4594,duranshawn@bowers.com,2022-03-30,http://www.mullen-morris.com/
05-Mar-2021,Cash,00.00,"189,434.73","1,515,477.81",0DB73c78CF89038,150,Jennifer,May,"Orozco, Suarez and Burnett",West Victoriaburgh,Benin,001-748-415-3943x99903,739.166.8202,cannonshirley@carson-dorsey.com,2021-09-08,https://www.brock.com/
05-Mar-2021,Tax,"624,864.80",00.00,"2,140,342.61",bF9309768Ec6fE6,1538,Kaitlin,Cooley,Whitaker LLC,Huynhfurt,Qatar,075.247.0199x0136,+1-775-265-6930x2828,xcisneros@powell-thomas.com,2020-02-27,http://madden-walker.org/
05-Mar-2021,Bill,"3,454.00",00.00,"2,143,796.61",a0f2eAedeaa74fA,3177,Sue,Mccall,"Trujillo, Marquez and Rubio",South Shane,Austria,038-831-8548x263,4541115638,erowe@henry.info,2020-07-22,https://www.owen.com/
05-Mar-2021,Bill,00.00,"1,071,898.31","1,071,898.30",D41318e62Bc6C2B,1155,Connie,Pratt,Bright PLC,East Lee,Bulgaria,4413956651,+1-711-873-6198x066,harrellgilbert@trujillo-henderson.com,2022-01-25,https://crosby-ryan.net/
05-Mar-2021,Tax,"2,559.80",00.00,"1,074,458.10",6D587a890f4C623,9500,Eric,Oneal,"Blanchard, Warren and Dixon",Port Tyronemouth,Sao Tome and Principe,001-648-222-0132,508.116.0101,hgreen@brady.biz,2021-10-12,https://www.mccoy.biz/
05-Mar-2021,Cash,07.40,00.00,"1,074,465.50",999FA8efffEbBA4,2900,Sean,Roman,"Mata, Chambers and Calderon",Lake Karenside,Bhutan,086-141-3487,6696386786,nathangregory@ballard-davidson.com,2020-06-26,http://vasquez.org/
05-Mar-2021,RTGS,10.00,00.00,"1,074,475.50",f40407457D6ae00,9651,Colin,Bray,"Harrell, Lambert and Sexton",Jamieton,Peru,(713)788-4612x78976,375.274.3108x970,franklin06@everett.com,2021-01-21,https://blankenship.biz/
05-Mar-2021,NEFT,"174,671.20",00.00,"1,249,146.70",Bd7EdABBb34a06B,9668,Mackenzie,Key,"Evans, Kent and Zamora",Haaston,Montenegro,(070)416-5168x8081,(407)030-6065,catherine40@wolf.com,2021-08-12,https://mckenzie.com/
05-Mar-2021,Bill,00.00,"1,249,146.70",00.00,c9BA51204D73c0F,4929,Pedro,Keith,"Nguyen, Randolph and Ortega",North Mandy,Guinea,1164549658,(021)061-7083x206,severett@olson.com,2021-11-21,http://alvarez-reid.com/
05-Mar-2021,Miscellaneous,19.00,00.00,19.00,f3d3A3948E6F743,3386,Deanna,Solis,Shah-Benson,Ryanport,Liberia,056.444.9550x6301,688-738-6468x0038,stephaniewhite@weeks.biz,2021-02-23,https://www.rice.com/
05-Mar-2021,Debit Card,"81,425.00",00.00,"81,444.00",de85BF9AE3DfFC5,3970,Shelia,Davies,"Morgan, Forbes and Flowers",New Kevinfort,Mauritius,598-752-2598x1467,+1-280-194-8705x644,audreycraig@riggs.com,2020-10-27,https://www.trujillo-gilbert.com/
05-Mar-2021,IMPS,00.00,"27,148.00","54,296.00",7343664912a4CdC,7214,Kristie,Trevino,"Rodgers, Blackburn and House",Millsberg,Central African Republic,(326)193-5548,(305)343-7390,swashington@barnes-perkins.net,2022-04-27,http://carson.com/
05-Mar-2021,Bill,"3,295.00",00.00,"57,591.00",eDACCb9ecaA5E73,3383,Stefanie,Castillo,Owens Group,Hardingfort,Norway,232.529.8173,949.536.7015,eyork@velez-valentine.info,2020-11-05,http://shannon-summers.com/
05-Mar-2021,Cheque,"1,249.50",00.00,"58,840.50",4efbCcDAD9F2a7c,4017,Brenda,Lam,"Kelly, Callahan and Ewing",South Jadeborough,Egypt,(598)071-6527x5131,(334)705-6719x383,kempshelia@hamilton.com,2022-04-23,https://www.burton-mendoza.com/
05-Mar-2021,RTGS,00.00,"8,405.79","50,434.71",ac0dE575ceFEcF9,6811,Brandon,Bonilla,"Haley, Marsh and Anderson",North Rogerfort,Liechtenstein,131-188-7387x494,893.815.7424x88218,dominic54@ochoa-harrington.com,2021-08-05,http://www.haas-villa.com/
05-Mar-2021,Tax,07.73,00.00,"50,442.44",345bb1727648cFC,2010,Angie,Weaver,Hansen-Baxter,Trujillomouth,Northern Mariana Islands,001-736-172-0169x63097,001-039-562-2083x664,pettysydney@rivas.com,2020-11-04,http://www.franklin.com/
05-Mar-2021,Tax,02.00,00.00,"50,444.44",c06cd63bCc0aC18,3597,Isabel,Andrews,Watts Inc,Kerritown,Iceland,911.996.0938,001-274-556-6364x00816,burnsjoy@edwards.com,2020-04-27,http://morton-jones.com/
05-Mar-2021,NEFT,"176,029.59",00.00,"226,474.03",Eb379529B2C12cc,3864,Dennis,Beard,Bean-Madden,Jacobsfurt,Cook Islands,(211)000-9444x8711,875.681.2066,lwarner@powell.com,2021-11-10,https://rice.net/
05-Mar-2021,Debit Card,00.00,"113,237.02","113,237.02",f16D0ef136bEaeC,6710,Steven,Rush,Gibson PLC,New Gailberg,Iceland,001-268-674-6368,(150)082-4425x44406,jeff90@jensen.com,2022-05-13,http://kelly.com/
05-Mar-2021,Tax,00.00,"18,872.84","94,364.18",208055eD4fEb05D,1187,Deanna,Bradley,Charles Group,East Emma,Nigeria,(763)137-0832x690,363.057.2699x186,glovereduardo@everett.biz,2022-03-22,https://www.flores-chaney.com/
05-Mar-2021,Debit Card,00.00,"18,872.84","75,491.34",3FBeABF4e0DF6B3,1228,Anita,Dickerson,"Hensley, Tanner and Mcneil",Carlsonchester,Russian Federation,+1-632-068-2455x9686,001-297-426-0190x0529,glennwarren@stone.com,2020-02-01,https://www.rasmussen.com/
05-Mar-2021,ATM,227.00,00.00,"75,718.34",8C4d0FE0D867CD6,2016,Cassie,Moody,Stevens-Mendoza,Booneville,Malawi,672.474.1985,2147105338,rcantu@pace.com,2020-06-25,https://kane.org/
05-Mar-2021,RTGS,00.00,"37,859.17","37,859.17",cdC79DdEcF0B52C,569,Dwayne,Kane,"Branch, Mcclain and Baker",Terrimouth,Saint Lucia,(307)645-5099,(380)435-1039x041,gamblemaria@humphrey.com,2020-09-22,http://richard-olson.com/
05-Mar-2021,Purchase,07.00,00.00,"37,866.17",2396CCC1D555fbe,9890,Meagan,Quinn,Preston and Sons,Howellton,Uganda,423-364-9804x6659,001-232-964-8142,chloe80@avila.com,2022-04-04,https://harrell.com/
05-Mar-2021,Miscellaneous,"74,171.88",00.00,"112,038.05",0AdA23e478AfDcd,9681,Colleen,Hurst,Meadows-Vang,Maddoxmouth,Gambia,001-079-510-0280x8988,(663)976-6268,serranoterri@lawson.info,2021-09-20,http://www.benjamin.com/
05-Mar-2021,Miscellaneous,04.00,00.00,"112,042.05",Ef03b9DcbFbe3Cd,1841,Yvette,Phillips,Dickerson and Sons,New Caitlinburgh,Montenegro,001-828-468-3820x51710,7632323716,tballard@carey.com,2020-03-22,http://carter.com/
05-Mar-2021,IMPS,00.00,"18,673.68","93,368.38",0Dff6c27C8049C4,5539,Chris,Buck,Bowman-Bowen,South Edgarberg,Gambia,948.512.2454x11348,001-472-421-9145x827,damon10@clarke.com,2020-09-29,http://www.santos.biz/
05-Mar-2021,Tax,06.00,00.00,"93,374.38",6b133ca2D3A1D00,1987,Donald,Ingram,"Sosa, Bolton and Macdonald",Tashafort,Anguilla,001-498-373-7008,6435716927,danny62@montgomery-rosales.com,2022-01-14,https://dyer.com/
05-Mar-2021,NEFT,00.00,"93,374.38",00.00,Abc372398aA47C7,5158,Cameron,Turner,"Mann, Woodard and Beltran",Leroymouth,Seychelles,688.701.6652x7737,219-552-6759,cesarschmidt@kelley-ford.com,2022-03-07,https://www.vaughn.org/
05-Mar-2021,Interest,"10,448.72",00.00,"10,448.72",c4bB4d80a45B3bC,6072,Jerome,Douglas,Robbins-Harvey,Port Sabrinatown,Turks and Caicos Islands,+1-253-612-1270x813,+1-268-764-6135x020,humphreyjodi@riddle-wiggins.com,2020-08-23,http://brennan.com/
06-Mar-2021,Bill,00.00,"2,089.74","8,358.98",d53ABB60D6CeafA,1303,Brady,Meyers,Bonilla LLC,Guerreroville,Sri Lanka,001-338-653-8914x59043,+1-953-565-1936x678,jeremiahirwin@pineda.com,2020-09-06,https://gillespie.com/
06-Mar-2021,RTGS,00.00,"1,044.87","7,314.11",8D56C41cEDD7fba,1333,Sherri,Hunter,Santos PLC,Lake Douglas,Croatia,+1-594-593-7132x27679,576-660-1577,czuniga@oconnor.com,2020-07-12,https://www.smith.com/
06-Mar-2021,Transfer,00.00,"3,657.06","3,657.06",94cBBcACcafe18A,6299,Shane,Frey,"Duran, Dennis and Henson",Alexisberg,Monaco,593.066.6419x0837,(495)879-0555x923,sally81@herring.biz,2020-03-05,https://santiago-west.net/
06-Mar-2021,NEFT,00.00,"1,828.53","1,828.53",BDc713e91375aeE,8014,Peggy,Brady,"Cruz, Lam and Day",Prattport,Poland,001-578-243-9473x47586,790.593.8042,farmerdominique@ball.net,2020-06-09,http://dickson-snow.biz/
06-Mar-2021,Tax,00.00,228.57,"1,599.96",3b623F0DC819b00,5825,Destiny,Francis,Gregory-Farley,Rhondachester,Korea,971-847-7386x69379,7558981030,ksanford@acevedo-crosby.com,2021-02-18,https://www.hartman.com/
06-Mar-2021,Purchase,461.30,00.00,"2,061.26",83F0B1D11A63aEB,7284,Ellen,Mcintosh,"Schroeder, Ramirez and Parker",Cynthiastad,Croatia,001-443-067-2044x65930,+1-051-015-0774x924,mullinstyrone@henry-weber.com,2020-06-06,https://www.winters.com/
06-Mar-2021,NEFT,114.00,00.00,"2,175.26",7e15Fe803feCEFB,6553,Marcus,Delacruz,Burnett PLC,Jesuschester,Paraguay,(275)896-6813x56899,(461)194-3624x492,arianahayes@stein.com,2021-04-09,https://cain-spence.biz/
06-Mar-2021,Purchase,00.00,"2,175.26",00.00,32c09ee95cfF33f,7966,Eileen,Rollins,English and Sons,Morganbury,Sierra Leone,745-225-1517,3047557780,erikschaefer@estes-hill.com,2020-12-29,http://mann.com/
06-Mar-2021,Bill,259.63,00.00,259.63,464d7A4111c6c1E,1190,Ethan,Rush,Lynn and Sons,West Bailey,Croatia,388-002-7080,631.312.0631x0682,debbieknight@fuentes.com,2020-08-22,https://www.coffey.com/
06-Mar-2021,IMPS,35.60,00.00,295.23,a593bDedD302bd7,4019,Pam,Owen,Glenn-Mcdonald,Kirstenburgh,United States Minor Outlying Islands,001-224-234-3119x8037,(692)202-5018,bescobar@english-mcdowell.net,2021-09-20,https://www.glass.org/
06-Mar-2021,Commission,00.00,295.23,00.00,A6DBe3b2c59edcF,6179,Jillian,Owen,"Elliott, Hester and Duran",Donmouth,Equatorial Guinea,715.305.9624x2348,1953439854,snownatalie@spencer.biz,2022-01-18,https://www.torres.com/
06-Mar-2021,Miscellaneous,27.40,00.00,27.40,5e835cb625CfCeD,2333,Beth,Wyatt,Rosario Inc,Port Kaitlyn,Antigua and Barbuda,(758)988-7140x04211,077.861.3842x279,tammiegonzales@gill-bowen.biz,2020-01-18,https://www.scott.com/
06-Mar-2021,ATM,"14,659.00",00.00,"14,686.40",d69cf4cC4ABb4e6,965,Bradley,Torres,Duncan-Navarro,North Meagan,United Arab Emirates,001-639-335-9537x3108,264-339-0859x80819,qperry@carey-figueroa.com,2020-05-31,https://hamilton.com/
06-Mar-2021,Tax,03.00,00.00,"14,689.40",087F7e1B651EFBC,7831,Cristina,Woods,Morales LLC,Waynechester,Falkland Islands (Malvinas),7985164709,667.031.1098x55676,rhuff@reyes-mcintosh.info,2020-08-04,http://www.duarte-rich.com/
06-Mar-2021,Bill,00.00,"1,632.16","13,057.24",6bbc5677CeFD28a,962,Caleb,Foley,"Huynh, Mcgrath and Casey",West Chase,Tonga,472.949.3011,001-211-706-9677x50750,cindy99@delgado.info,2020-08-09,https://www.lynn.com/
06-Mar-2021,Transfer,00.00,"1,865.32","11,191.92",61Eb34A4F01e6A2,4379,Patrick,Moses,Hatfield-Herring,New Kendra,Macedonia,596-915-5324x6921,7360891566,rschmitt@terry.com,2020-08-22,http://www.benjamin.com/
06-Mar-2021,Debit Card,"1,135,415.50",00.00,"1,146,607.42",DC47c79b3FF93C4,6431,Warren,Chase,Sosa-Sanchez,Lindseymouth,New Zealand,3609640034,001-193-513-3293x3951,ryan80@fox.com,2022-04-05,http://www.copeland.com/
06-Mar-2021,Debit Card,00.00,"573,303.71","573,303.71",e9a3a7dCecbD4AD,547,Ross,Scott,"Cohen, Galvan and Norman",South Valerie,Cayman Islands,939-581-0075,001-481-635-6808x5524,brett01@fields.biz,2020-05-17,https://www.hinton-parsons.com/
06-Mar-2021,IMPS,46.70,00.00,"573,350.41",0F22271c8046fc3,1311,Gloria,Kidd,Mack Ltd,New Carol,Tonga,2223600964,+1-049-985-5194x4283,rebecca56@taylor-acosta.info,2020-04-23,http://castro.net/
06-Mar-2021,Commission,00.00,"286,675.21","286,675.20",1BC4a00171e11De,8241,Brittany,Singleton,Edwards-Little,West Lynnland,Kenya,811.234.0707,+1-597-097-3103x8081,dbray@richards.org,2022-01-06,https://pittman-newman.com/
06-Mar-2021,Purchase,"1,846.60",00.00,"288,521.80",cdEdeFcac34a9B3,9342,Alice,Fletcher,Mack PLC,Weaverland,Sweden,999.548.6268,566.911.9071,ronaldmatthews@buchanan-keller.biz,2020-11-20,https://buchanan.biz/
06-Mar-2021,Commission,950.00,00.00,"289,471.80",2608baDBDaa8D3A,9709,Jody,Meza,Mays-Henson,Lake Catherinemouth,Australia,(791)053-3577x286,987-103-5082,pachecobrent@house.com,2022-04-18,https://www.holder-burgess.com/
07-Mar-2021,Miscellaneous,00.00,"96,490.60","192,981.20",dA3669d0BaD459C,9377,Jade,Beasley,Stafford-Rosario,Bruceburgh,Venezuela,026-852-0074x943,+1-145-399-8308x6996,jprice@dunlap.biz,2021-03-06,https://arias-barry.org/
07-Mar-2021,Purchase,00.00,"48,245.30","144,735.90",Bd8cD6A4407738f,5364,Julie,Stanley,"Weeks, Nixon and Hogan",South Tracy,Burundi,+1-913-451-7239x5900,304.831.8246,penningtonloretta@riddle.com,2022-01-14,http://www.paul-dickerson.com/
07-Mar-2021,IMPS,00.00,"144,735.90",00.00,0AE6a8a0e57Fafc,6662,Theodore,Ramsey,Bauer Inc,New Xaviershire,Niger,(651)313-6899,(671)092-2860x3161,bford@terrell.com,2022-03-04,https://www.petty-morrow.com/
07-Mar-2021,NEFT,59.76,00.00,59.76,a2f7bd4fb9752d2,164,Jeffrey,Molina,Copeland LLC,Port Noahmouth,France,+1-446-671-0095x139,(361)454-8756x93520,timothyrivera@wade-galloway.net,2020-09-18,https://www.bridges.biz/
07-Mar-2021,Cheque,53.70,00.00,113.46,7efa28813fd4261,1494,Whitney,Moody,Stokes-Rivas,Lake Gilbert,Zambia,2988550419,4754926632,floresangela@boyd-schaefer.com,2021-07-13,http://george.com/
07-Mar-2021,Miscellaneous,36.00,00.00,149.46,e93DBE2CE880b2f,3767,Brent,Buchanan,Campos Group,Rowlandshire,Canada,624.325.2854x2501,546-104-9451,alanhester@lynn.com,2020-02-01,http://www.figueroa.com/
07-Mar-2021,Debit Card,00.00,16.61,132.85,abF564950aaddbE,4770,Jocelyn,Buchanan,Munoz-Macias,Lake Perrymouth,Honduras,001-202-160-8632x8457,705-444-2110,byrdkim@guerrero.com,2020-04-22,https://www.lyons-baker.info/
07-Mar-2021,Reversal,00.00,44.28,88.57,8FdcaAECdDA09cA,7495,Colleen,Mcguire,Barnes-Brown,East Donside,Christmas Island,123.651.1333x387,056.198.9163,snowjanet@butler.org,2020-06-25,https://www.eaton.info/
07-Mar-2021,Cash,00.00,12.65,75.92,bEA3eCe8B4A7e9e,9086,Barry,Parks,"Baxter, Robinson and Bean",East Jacob,Canada,7359307397,+1-594-468-5084x4905,theresagonzalez@roberson-flores.org,2020-11-29,https://www.blair.com/
07-Mar-2021,Miscellaneous,46.84,00.00,122.76,8cC6CD209d9ff55,6777,Logan,Keith,"Potts, Levine and Ballard",Gilesborough,Morocco,388-354-6528x498,754-225-4273,bonnieneal@henderson.com,2020-07-03,https://brooks.org/
07-Mar-2021,Cash,00.00,15.35,107.42,cb5c56Dc41c5caD,2032,Harry,York,Kirk-Moon,Mosesburgh,Benin,+1-276-456-1332x570,(846)105-4696x0459,macosta@waters-barton.biz,2022-02-02,https://mccann-burgess.com/
07-Mar-2021,IMPS,00.00,26.86,80.56,bd57BaAdcc701Ec,7232,Lynn,Juarez,Blevins-Hill,Drewview,Uganda,578.295.4229x285,001-226-505-7732,stewartnancy@franco-reyes.biz,2020-10-19,http://www.fuller.com/
07-Mar-2021,RTGS,00.00,16.11,64.45,bd7Da4B82F28279,405,Zachary,Shaffer,"Haynes, Lara and Lara",Mccormickmouth,Czech Republic,(713)867-5810x3140,540.738.7911x210,avilasummer@hensley-richmond.net,2022-01-30,https://www.burgess.org/
07-Mar-2021,Reversal,"2,058.53",00.00,"2,122.98",06Fbf62135CbBF9,6731,Anna,Park,Montgomery Inc,New Ralphfort,Indonesia,001-700-209-7838x110,(013)684-9462x43229,edward24@fischer.biz,2020-06-11,https://hess.org/
07-Mar-2021,Cheque,00.67,00.00,"2,123.65",6bA06DbacbD7eDf,7471,Roberta,Lyons,Ward Group,West Tamarastad,Madagascar,1215914756,(129)222-3655x5901,kkeith@mccann.net,2021-08-25,https://www.alvarez-woodward.org/
07-Mar-2021,Transfer,00.00,303.38,"1,820.27",10Ebdedd3382F3E,4815,Blake,Terry,Bean and Sons,Schneidermouth,Mozambique,668.926.0577x84130,4580480087,adrienne84@skinner-mullen.com,2020-11-27,http://faulkner.com/
07-Mar-2021,Cheque,49.30,00.00,"1,869.57",d5879ba7DfE7cE2,4365,Anne,Quinn,"Silva, Watts and Pitts",West Lynn,Finland,001-701-644-2601x20012,799.253.9286x2490,orichardson@mayer.biz,2021-12-15,http://barnes-hendricks.com/
07-Mar-2021,ATM,436.70,00.00,"2,306.27",6f9D7EeFbDDc0d1,5451,Heidi,Newton,Levy-Oliver,East Kathy,Sudan,145-183-3283x771,152-669-3193x69380,peggy64@walsh-andrews.com,2020-11-03,https://stein.com/
07-Mar-2021,Miscellaneous,00.00,329.47,"1,976.80",83f8924AEa5aBc2,1921,Marilyn,Huerta,Heath-Cummings,Arthurberg,Yemen,001-564-986-8605x792,354-293-9198x36238,sreeves@maddox-fry.biz,2020-09-24,http://www.daniel.net/
07-Mar-2021,Cheque,00.00,"1,976.80",00.00,D840b3fd766ff8b,4725,Gwendolyn,Dunlap,"Ingram, Bridges and Conrad",Hicksside,Comoros,717-563-1573,573.400.1059x8581,sarah99@norris-parks.com,2020-11-18,http://www.keith-galvan.org/
07-Mar-2021,Purchase,"231,924.38",00.00,"231,924.38",f8e9987B620cCcb,4247,Amber,Simon,Lynch-Wilcox,North Meganview,Guinea-Bissau,855.449.4884x5481,001-934-722-7319,mitchellvernon@wilkins.org,2021-10-21,http://www.boone.com/
07-Mar-2021,Debit Card,"2,445.00",00.00,"234,369.38",F3DcCA3FBEd02b6,5241,Traci,Gonzales,"Roth, Arroyo and Castillo",Normanshire,Bosnia and Herzegovina,(097)647-1505x923,958-019-1644x328,vanessa32@nash.net,2020-01-09,http://www.cordova-chandler.biz/
07-Mar-2021,Cash,00.00,"33,481.34","200,888.04",e090f2CAF78D1fa,2497,Erica,Sloan,Rowland LLC,West Noahview,Botswana,+1-092-286-3619x944,001-666-132-2734x6100,hendrixshelby@gallagher-villanueva.com,2021-12-15,http://vargas.com/
07-Mar-2021,Commission,00.00,"25,111.01","175,777.04",4A1DaFdd15ecF6C,1619,Alan,Harrell,"Werner, Sparks and Harrell",Goodwinhaven,Senegal,7531543408,001-030-384-3274,feliciablake@oconnell.com,2021-09-30,https://www.rojas.com/
07-Mar-2021,RTGS,00.00,"29,296.17","146,480.87",bA6dAf3E4eCcD3F,5314,Jennifer,Conrad,Gamble-Mathews,Lunaberg,Poland,(262)644-5494,9639722985,zhooper@buckley.biz,2020-06-15,http://www.gordon.net/
07-Mar-2021,Tax,00.00,"16,275.65","130,205.22",ff1a40cA96beB0F,7209,Sherry,Kent,"Craig, Herrera and Benton",North Johnathan,Reunion,699.766.2169x702,+1-761-068-9064x31331,egill@payne.com,2020-09-01,http://petersen.com/
07-Mar-2021,Interest,07.04,00.00,"130,212.26",52aC7BadBdD4823,1365,Phyllis,Hatfield,Montes-Bradford,Port Alexisside,Moldova,6137332375,976.302.2855x34054,wigginsnatasha@compton.org,2021-10-26,http://www.oconnell.com/
07-Mar-2021,Purchase,00.00,"43,404.09","86,808.17",E5AB71C2Ccfa4B8,4871,Tony,Norton,"Crosby, Jenkins and Rodgers",Mckaystad,Turkey,446.686.6955,(590)870-3452,tony73@yoder.com,2020-01-22,http://soto-lozano.biz/
07-Mar-2021,NEFT,00.00,"12,401.17","74,407.00",0Bcc10Db76BaC9b,1374,Brett,Alexander,Tyler-Dunlap,East Mckenzie,Samoa,273.460.7716,+1-193-006-7024,gmorgan@proctor-dillon.biz,2022-05-20,https://www.morse.org/
07-Mar-2021,Bill,00.00,"10,629.57","63,777.43",8ed8fc5a8aAfc7a,6242,Rhonda,Henry,Tapia-Pace,Lake Meganside,Philippines,(312)175-3304x3350,+1-944-121-8449x871,mckinneychristy@duncan.com,2020-03-06,http://www.medina-bradley.com/
07-Mar-2021,Tax,00.00,"10,629.57","53,147.86",8aadeCD2FA2B9Af,2133,Daryl,Chan,Ho LLC,Lake Melissahaven,Iceland,432.909.0882x25851,(742)443-2812,hunter57@small-mathis.org,2020-06-28,http://www.hill-gomez.info/
07-Mar-2021,Reversal,"595,986.25",00.00,"649,134.11",15B4dFBCFFFe863,6892,Ross,Cross,Scott and Sons,Lynnbury,Lebanon,+1-440-680-0239x558,968.990.8519,holtfrank@hughes-newman.com,2021-09-30,http://www.duffy-estrada.com/
07-Mar-2021,IMPS,"8,530.56",00.00,"657,664.67",2fEAcdbcC15cc74,247,Renee,Serrano,"Phillips, Hutchinson and Walter",West Erika,Ethiopia,501.240.0629x1686,684.959.9553x518,tammyspence@day.org,2020-03-28,https://www.haley.info/
07-Mar-2021,Interest,"66,102.00",00.00,"723,766.67",c0faDfd4cb01781,6153,Kyle,Klein,Leblanc Inc,Walterfurt,Argentina,103.202.0031x739,001-870-938-8376x5050,wernermiranda@lara.com,2022-05-26,https://trujillo-porter.com/
07-Mar-2021,Commission,"88,613.50",00.00,"812,380.17",70ace5bad5Ce2a7,373,Sally,Golden,Rios and Sons,Jeanneview,Morocco,074.545.4625,412.164.8140x5271,stricklandregina@perez.info,2020-04-21,http://nichols.com/
07-Mar-2021,ATM,"6,766.66",00.00,"819,146.83",04A4BfE1a3E2cD5,1586,Sergio,Robertson,"Ayala, Obrien and Pennington",New Lindafurt,Papua New Guinea,(422)662-1344,(784)511-3949,drew52@barker.biz,2020-11-23,https://www.hawkins-hancock.com/
07-Mar-2021,Cheque,36.00,00.00,"819,182.83",8dd2B3e57B7FfeF,9349,Kaitlin,Barnes,Moses-Silva,Mosleyport,Macedonia,762-451-0085x59003,(672)076-3413x053,olsenzoe@vance-galloway.com,2021-06-18,https://www.bell.net/
08-Mar-2021,RTGS,00.00,"102,397.85","716,784.98",4bFE54FbDef41bb,1287,Tiffany,Mata,Andrews-Gentry,Barreraberg,Ethiopia,+1-884-460-1194x799,(032)977-9608,howard62@morales.com,2021-09-30,https://robinson.biz/
08-Mar-2021,Cash,05.00,00.00,"716,789.98",f17Dae7B892cA3F,511,Gregory,Flores,"Dunlap, Dudley and Ross",Marcoburgh,Luxembourg,001-954-868-0518x8904,001-495-894-4167,barajasfrederick@escobar-bradford.info,2021-06-22,http://www.deleon-fowler.info/
09-Mar-2021,ATM,"1,334.00",00.00,"718,123.98",CbbC851e4dc35B9,3868,Alison,Arellano,Fowler-Goodman,Daltonview,British Indian Ocean Territory (Chagos Archipelago),001-792-784-5969,687-685-7672x76300,darrell44@le.info,2022-02-23,http://www.french-maddox.net/
10-Mar-2021,Interest,01.43,00.00,"718,125.41",baBDfE3ACE109be,8924,Mikayla,Roach,Yang-Alvarado,East Karen,Chad,(287)827-6054x274,7878571847,dpowers@wolfe.org,2020-12-18,https://caldwell.com/
10-Mar-2021,NEFT,00.00,"102,589.34","615,536.07",53cde8434CdEf4f,5870,Duane,Sharp,Shepherd Inc,Josephview,Japan,(928)213-4721x34875,(708)274-9680,kiara01@phillips.com,2020-04-08,https://www.osborn.com/
10-Mar-2021,RTGS,00.00,"68,392.90","547,143.17",3904f5A8f654ee9,9022,Brittany,Ochoa,Velazquez and Sons,Ravenburgh,Ireland,(246)497-0979x1769,9357872000,rhodeswhitney@bond-estrada.net,2020-04-20,https://www.pruitt.com/
10-Mar-2021,RTGS,00.00,"547,143.17",00.00,Ea49DA23fbff14E,2942,Emily,Cook,Black Inc,Frederickbury,Belarus,+1-705-087-6661x4505,8252275486,gregstewart@torres.biz,2022-01-29,https://matthews.net/
10-Mar-2021,Purchase,05.27,00.00,05.27,21296ee3eE1Ff8a,87,Marcia,Vaughan,Yu-Roy,Petersbury,Equatorial Guinea,742.373.3173,001-302-878-6175x08344,ellen80@bonilla.com,2020-10-22,http://jefferson.com/
10-Mar-2021,Debit Card,00.00,01.76,03.51,aD9F315DC731A64,4433,Vickie,Williamson,Bell LLC,Port Joanna,Northern Mariana Islands,7986205656,757-894-9056,toddbuchanan@cruz.com,2022-01-13,https://www.holland.com/
10-Mar-2021,Bill,00.00,00.59,02.92,e7aBC4BAb40BCd7,3259,Autumn,Manning,Hampton-Case,Wagnermouth,Paraguay,001-376-537-9526x88080,340-737-5874,robin07@wallace.info,2021-11-14,https://www.daugherty.biz/
10-Mar-2021,Miscellaneous,12.00,00.00,14.92,Dfff4aCFD064d0d,4035,Darrell,Richmond,"Kirby, West and Escobar",Lake Alan,Pitcairn Islands,834-090-8658x3305,278-827-8392,robbinsheidi@patrick-hess.info,2021-05-25,http://www.garner.com/
10-Mar-2021,Interest,"4,930.00",00.00,"4,944.92",fC9B1bB207d6F73,9411,Arthur,Strong,"Pennington, Whitney and Hendricks",Jillianhaven,Sri Lanka,(580)051-4111x216,304-792-2245,buckleykatie@patel.net,2020-02-06,https://rubio.com/
10-Mar-2021,ATM,00.85,00.00,"4,945.77",DCAd2BD0CeBFc1d,2915,Louis,Klein,Mcintyre Inc,Kennethshire,Finland,(377)132-6353,+1-189-712-1697x991,lindseydale@mercer.com,2020-05-09,https://www.garrison.com/
10-Mar-2021,NEFT,"6,499.27",00.00,"11,445.04",31F579d9ACB8cEE,5283,Gavin,May,Erickson LLC,South Lonnie,Luxembourg,001-871-531-7752x721,341.126.7060,haasgrant@duncan.net,2021-06-24,https://key.info/
10-Mar-2021,NEFT,00.00,"1,144.50","10,300.54",34382663A4AEaB5,6752,Faith,Monroe,Lindsey LLC,Jonesport,Luxembourg,004-624-7123,663.234.6649x3084,ifrazier@andrews.com,2022-02-03,http://meza.com/
10-Mar-2021,RTGS,"59,311.00",00.00,"69,611.54",febb2c72a59Bd7a,9656,Judith,Prince,Aguirre and Sons,North Derrick,Slovakia (Slovak Republic),+1-913-916-8483x63840,122.361.1734x9617,nicolas59@gillespie.com,2020-05-30,http://swanson.biz/
10-Mar-2021,ATM,00.00,"9,944.51","59,667.03",3DbcDDda3F5baFA,2485,Alex,Stokes,Barajas PLC,Masonchester,Indonesia,166-793-2751x1508,001-905-717-9103x36624,christyreed@wood.com,2021-10-20,https://www.landry.com/
10-Mar-2021,RTGS,00.00,"7,458.38","52,208.65",beed56F4538Cfa3,6946,Jaime,Benton,Dodson Inc,Lindabury,United States Virgin Islands,+1-995-784-6309x404,+1-880-341-1068x346,mcdonaldralph@lara-conner.com,2020-02-12,https://daugherty.biz/
10-Mar-2021,Purchase,08.20,00.00,"52,216.85",EddbA8F7CFA0954,1866,Tammie,Duffy,"Randolph, Wilkins and Arellano",Alexanderstad,British Virgin Islands,027.537.9757,153.678.4330,rmaxwell@nichols.com,2021-01-28,https://melton.com/
10-Mar-2021,Transfer,"1,468,038.00",00.00,"1,520,254.85",fD8ebdFBC6484c0,9903,Donald,Key,Walsh PLC,Owensmouth,Tuvalu,3837627237,001-615-917-7244,mejiavictor@neal.info,2021-06-12,http://www.pineda.net/
11-Mar-2021,Commission,375.00,00.00,"1,520,629.85",9df1C51847107D8,5176,Briana,Romero,"Wiley, Lucero and Delgado",New Jack,Turkmenistan,(230)019-6120x01529,214-947-3393,hallann@wilkerson.com,2021-12-11,http://www.owen-chandler.com/
11-Mar-2021,Transfer,26.00,00.00,"1,520,655.85",8A96EECfBD1E182,199,Robyn,Abbott,"Dodson, Weaver and Barajas",Jodiberg,Somalia,001-158-488-8157,(812)515-3121x0742,breanna32@mayer.net,2020-12-31,https://www.jordan-phelps.org/
11-Mar-2021,Tax,50.49,00.00,"1,520,706.34",f1AA1fdEb6eF9c4,8797,Vicki,Lloyd,Lynn-Marquez,Jordanbury,Aruba,791-822-6156,(511)594-7691,cristinaglenn@nash.org,2020-10-04,https://www.robertson.com/
11-Mar-2021,Debit Card,00.00,"168,967.37","1,351,738.97",20Ed3D3d2AA7dc1,6206,Reginald,Arias,Barrera Group,Tomburgh,Chad,946.871.2756,4359002644,melissabrewer@wolf-rice.com,2021-07-18,http://www.long.com/
11-Mar-2021,Purchase,00.00,"150,193.22","1,201,545.75",610f3FAFBEd6F7a,5343,Devin,Gutierrez,Conner-Lynch,Lake Joshua,Senegal,001-143-493-4059x73808,(356)245-9283,haley46@gomez-house.info,2021-07-06,http://www.gallegos-contreras.com/
11-Mar-2021,IMPS,"23,356.30",00.00,"1,224,902.05",B1Cbd3b8810b78c,7987,Natasha,Kidd,Hill-Hendricks,East Haydenville,Tuvalu,852-220-0484,001-372-352-4399,patelshannon@wyatt.info,2022-01-22,https://daugherty.com/
11-Mar-2021,Interest,04.00,00.00,"1,224,906.05",adc155A42a8FEFa,1926,Janice,Garrison,Nunez Ltd,South Edwin,Mauritania,231-007-9710x4571,341-180-2305x81183,pedro48@page.com,2020-10-21,https://www.clayton.com/
11-Mar-2021,Cheque,00.00,"306,226.51","918,679.54",aceEA73F9A62411,9498,Theresa,Parrish,"Ray, Calhoun and Schultz",Lake Ana,Palestinian Territory,001-696-596-9936x1137,825-061-2003,pottergordon@wood-gomez.com,2022-02-23,http://www.wilson.net/
11-Mar-2021,Tax,00.00,"918,679.54",00.00,e30688Ea00183B8,4162,Danielle,Mcbride,"Hays, Ward and Huffman",Carlosburgh,Uganda,+1-161-068-1953x14267,+1-302-910-3707x93814,meaganpineda@carlson-calderon.biz,2020-09-08,https://miller-vance.net/
11-Mar-2021,Tax,"240,175.69",00.00,"240,175.69",41fbbaaEBdCe268,7520,Madison,Jefferson,Ellis Group,Port Cristina,Montenegro,967-823-3344x1692,(379)875-2265x025,vcowan@lindsey.com,2020-01-11,http://www.ortiz.com/
11-Mar-2021,Miscellaneous,439.00,00.00,"240,614.69",2b94E0a823C2FeF,206,Jose,Morse,Ford-Dixon,West Brendan,Chad,849-351-2710x10812,001-684-502-1388,woodsdevin@maldonado.org,2020-05-17,https://www.wheeler-wong.com/
11-Mar-2021,Interest,00.00,"80,204.90","160,409.79",458fcE2f51143df,6150,Glen,French,Wilkerson PLC,Chadside,Croatia,(224)752-8584,279.351.6005x5307,lanejill@roach.com,2020-07-25,https://allison.info/
11-Mar-2021,NEFT,461.69,00.00,"160,871.48",E2f3CBBB5D6Fb94,231,Carly,Bullock,"Schroeder, Krueger and Day",New Evelynside,Austria,747-121-9878x3705,3993787031,josephchaney@roach-rocha.info,2021-07-13,https://www.huff.com/
11-Mar-2021,Reversal,00.00,"20,108.94","140,762.55",cDAe2508Df4Da9f,6619,Wesley,Hayes,"Larsen, Moon and Burton",North Ernest,Indonesia,149-890-7192x26129,001-182-961-5704x796,kristy93@costa-vazquez.com,2021-06-24,https://www.meyers-ferguson.org/
11-Mar-2021,RTGS,"298,000.25",00.00,"438,762.80",29A8E562DC75ede,105,Bobby,Collier,"Horn, Stevenson and Yoder",New Cindy,Mauritius,001-778-840-9271x74639,+1-151-871-9736x708,samantha34@mccarthy.com,2020-04-11,https://hendrix-pittman.biz/
11-Mar-2021,Cheque,"1,061,618.00",00.00,"1,500,380.80",7AF39CE0d8fd304,8135,Jeanette,Bryant,Walsh PLC,South Donaldville,United States Virgin Islands,621-902-3902x370,001-473-517-7589x17594,isoto@allen-simmons.com,2021-07-21,https://www.davila-mcmahon.net/
11-Mar-2021,RTGS,00.00,"214,340.11","1,286,040.69",9d870e901b752E8,7147,Michaela,Ware,"Rivera, Glover and Escobar",Anneton,United States Virgin Islands,009.561.9920x382,+1-876-262-1470x4261,ihouston@warren-trujillo.com,2021-12-21,https://martin.com/
11-Mar-2021,Bill,240.00,00.00,"1,286,280.69",92021846B5ad659,1608,Hayden,Mack,Simon LLC,Boltonstad,Saint Helena,(443)692-4767x5498,+1-295-529-0533x869,wangalicia@wright-potter.com,2020-03-01,http://waller.com/
11-Mar-2021,Tax,00.00,"183,754.38","1,102,526.31",FdF7F6e6D49739a,7420,Jorge,Maddox,Hodge LLC,West Francistown,Faroe Islands,(820)794-9460,(472)778-2822x628,adrienneescobar@gardner.com,2020-05-02,http://www.davenport-gray.com/
11-Mar-2021,Reversal,"121,220.00",00.00,"1,223,746.31",Ed3DDEE0De1b769,875,Becky,Obrien,"Dunlap, Page and Duke",North Billfort,Andorra,256.124.9882,+1-503-703-0457x21281,wileygordon@salinas.com,2020-05-02,https://merritt.com/
11-Mar-2021,Reversal,00.00,"611,873.16","611,873.16",6a8d8a2c580681C,9817,Misty,Owens,"Gallagher, Glover and Watson",Alvaradomouth,Suriname,001-501-301-5394x263,+1-572-050-1951x7106,imathews@chaney.com,2020-08-25,https://jones.com/
11-Mar-2021,Cheque,00.00,"61,187.32","550,685.84",BEfA2CBE462e561,1998,Natalie,Rosales,Johnston LLC,West Melissa,Niger,+1-008-522-5954x9262,(683)532-7801x3943,uboyle@kemp.com,2022-05-28,https://rogers.com/
11-Mar-2021,Miscellaneous,"1,003.00",00.00,"551,688.84",C18a4Fbe5D008f6,390,Candice,Livingston,Marshall Inc,Lake Kathrynburgh,Mexico,001-205-673-8989x77190,237-030-0300x015,thall@soto.com,2021-03-21,https://www.rowe.com/
11-Mar-2021,Debit Card,"1,503,976.00",00.00,"2,055,664.84",87Eab13E8b9C18a,2518,Melody,Middleton,"Camacho, Bernard and Hale",Port Tyler,Ghana,236.726.1055x6468,713.329.1052x500,crystal58@peterson.biz,2020-06-25,https://tapia-weber.com/
11-Mar-2021,ATM,35.26,00.00,"2,055,700.10",40fFDD3C5BFe8bB,3156,Randy,Goodman,"Dougherty, Cooley and Fischer",North Kristine,Reunion,001-568-711-2096x142,887.284.9917x5655,mirandadebbie@travis.com,2021-02-02,https://www.roth-johnson.com/
11-Mar-2021,IMPS,00.00,"2,055,700.10",00.00,8f22c9cA5a0bac0,1367,Kim,Terry,"Vargas, Roman and Washington",Port Sean,Solomon Islands,438.732.2394x185,7579914194,espinozamelissa@gutierrez.org,2020-04-01,https://underwood.com/
11-Mar-2021,Interest,58.20,00.00,58.20,Bc7e3aC9f17c6E5,5001,Alvin,Sawyer,Arroyo-Vasquez,Sheilafurt,Seychelles,214-843-6155x25205,836-731-5502x23087,mullinsdiana@davies.com,2021-07-03,https://www.mcpherson.com/
11-Mar-2021,Purchase,00.00,06.47,51.73,34616EE42FC1aeA,1421,Norma,Alvarez,Wyatt Ltd,New Melvinborough,Japan,774.852.8761x78970,565-081-2471x5617,ruizrichard@york-cummings.org,2021-02-22,https://alexander.net/
11-Mar-2021,Reversal,00.00,51.73,00.00,BcEf3324988221b,9383,Andrea,French,Patrick-Gillespie,New Joanneberg,Luxembourg,001-025-095-1651,001-270-379-8256x8698,eschroeder@murphy.com,2020-10-13,https://www.valentine.com/
11-Mar-2021,Cheque,25.76,00.00,25.76,E7D74f12DeA75FF,2177,Craig,Hoffman,Bowers-Cox,North Sallymouth,Lebanon,4225725307,001-775-854-9431x6922,ybrady@gilbert.com,2020-03-25,http://sellers-perry.com/
11-Mar-2021,Bill,"5,801.00",00.00,"5,826.76",4A1DaFdd15ecF6C,1619,Alan,Harrell,"Werner, Sparks and Harrell",Goodwinhaven,Senegal,7531543408,001-030-384-3274,feliciablake@oconnell.com,2021-09-30,https://www.rojas.com/
11-Mar-2021,Reversal,08.00,00.00,"5,834.76",02fFdedf01c07bC,7791,Ruben,Strickland,"Montgomery, Duffy and Daniels",Lake Harold,Bulgaria,860-123-0052,775-321-8560,lorettalarson@wilkinson.com,2020-02-26,https://stein.com/
11-Mar-2021,ATM,07.74,00.00,"5,842.50",8024D7CFb9C451B,6875,Natalie,Barry,Montgomery-Woodward,New Hayleymouth,Guyana,5753169571,055-522-2979x400,frylaurie@thornton-roman.info,2021-11-09,https://www.russell.com/
11-Mar-2021,Tax,00.00,649.17,"5,193.33",cfC51Eb78eBbc9d,2349,Rita,Hensley,Barker Ltd,Loganside,Palestinian Territory,+1-761-592-4317,(155)060-2584x863,jeanette03@mitchell-blevins.org,2020-08-02,http://eaton-davies.org/
11-Mar-2021,Debit Card,00.00,741.90,"4,451.43",bc218da412De33d,7743,Barry,Guerrero,Bishop PLC,Dukebury,Cayman Islands,033-139-8722,327-353-8684x8262,samantha16@rosario.org,2021-07-17,http://www.barnett-benson.biz/
11-Mar-2021,Tax,60.88,00.00,"4,512.31",7C88B7c5d1a4dEB,4856,Patty,Levine,Sims PLC,Nicholasburgh,Iraq,(981)728-9756x549,021.624.2276x9137,kendrarodgers@waller-farrell.com,2021-04-09,https://mills-nelson.biz/
11-Mar-2021,NEFT,00.00,752.05,"3,760.26",e1bc8dfACAD5Abc,5754,Riley,Cain,Best-Thompson,Rachelborough,Slovakia (Slovak Republic),001-854-447-3498x2544,863.066.0668x22891,peter16@wu.com,2020-09-22,http://hogan.net/
11-Mar-2021,ATM,00.00,376.03,"3,384.23",136bEeF9fCF1E7C,5259,Cathy,Preston,"Fisher, Peters and Gordon",Port Kristiechester,Bhutan,(733)873-0304x551,(882)389-5687,faithpark@baird.org,2021-03-09,http://www.calhoun.com/
11-Mar-2021,Debit Card,00.00,564.04,"2,820.19",dCb7b9aFdfe2C7A,4056,Guy,Sellers,Kennedy PLC,New James,Georgia,(281)516-7945x6852,(020)569-0163x71834,normanchristina@kirby.biz,2021-12-13,http://www.riley.com/
11-Mar-2021,Reversal,00.00,705.05,"2,115.14",EF78b8Cb47a0D7f,9746,Francis,Phelps,Morse-Dorsey,Mccormickmouth,Latvia,067.174.1997x6490,(271)526-1827,hesterkim@sanders.com,2021-03-10,https://rangel-schmidt.com/
11-Mar-2021,Transfer,02.64,00.00,"2,117.78",483fE2AD3cFfA6A,7353,Jody,Buck,Haas-Ritter,Thorntonport,Syrian Arab Republic,741.874.6342x57821,643.940.2516x04648,olawson@holt.com,2021-06-24,https://www.boone-cook.com/
11-Mar-2021,Tax,00.00,423.56,"1,694.22",ffce5F9eaCCba01,6071,Louis,Sharp,Roberts Ltd,Meghanville,Kyrgyz Republic,(785)729-9645x25020,+1-595-910-7806,hoopertommy@joyce-powell.com,2020-05-03,http://www.hensley.org/
11-Mar-2021,NEFT,00.00,847.11,847.11,FC4EDBc20Cfb8e5,7567,Diane,Rivas,Duffy Ltd,West Christieshire,Ethiopia,001-388-744-7046x9352,(860)761-8474,travismaurice@calhoun.info,2021-09-21,http://kramer.com/
11-Mar-2021,Commission,00.00,141.19,705.92,40edeA3A08EdfaD,8429,Douglas,Potter,Mccann Ltd,New Chelseyberg,Chile,(503)194-2318,274.554.9254,ethan02@gould-kerr.com,2021-06-16,http://www.hendrix.com/
11-Mar-2021,Cheque,00.00,100.85,605.07,b942f7F5CB2cd8d,7387,Marcia,Shannon,Mcgrath-Graham,Port Jeanetteborough,British Indian Ocean Territory (Chagos Archipelago),(308)859-2900,(471)239-8959,jaclynespinoza@park-hopkins.org,2021-12-21,https://www.vance-cooley.net/
11-Mar-2021,NEFT,00.00,86.44,518.63,DABb9bD3CE75FF3,8388,Peggy,Holt,Fitzpatrick Ltd,Mortonside,France,434.173.9632x9161,(660)264-1581x0816,rfuller@torres.com,2020-04-09,https://www.marks.info/
11-Mar-2021,RTGS,"1,337.33",00.00,"1,855.96",d993cfBbF3b36cd,6974,Pam,Phelps,"Skinner, Fields and Chase",Wallsville,Sierra Leone,327.184.9150,968-787-1366,mfisher@krueger.com,2021-03-28,https://oliver-barron.info/
11-Mar-2021,Debit Card,00.00,463.99,"1,391.97",fB6CF51BBe93581,5490,Steve,Banks,Gibbs LLC,Bonnieburgh,Bolivia,754-800-2044x1732,(707)308-7814,kentpatton@potts.net,2020-12-06,https://www.lester.org/
11-Mar-2021,NEFT,"88,412.70",00.00,"89,804.67",6D30DE16c37f3eC,5149,Sandra,Galvan,Burch-Horne,West Kathleen,Kuwait,(690)368-1888x027,+1-557-378-2255x4038,orrdanielle@welch.net,2021-11-08,http://www.hinton-lambert.com/
11-Mar-2021,Purchase,00.00,"17,960.93","71,843.74",CcCecee5C3BbAae,6766,Stefanie,Simon,"Jennings, Torres and Fry",Charlestown,Indonesia,668.181.6011,(895)653-8222x224,mowens@castaneda.biz,2021-05-20,https://atkins.biz/
11-Mar-2021,Tax,"1,999,179.25",00.00,"2,071,022.99",1Ddd0d9d13eaABA,3866,Malik,Brady,Martinez and Sons,Olsonhaven,Zambia,495-666-0987x3154,(146)410-7719x69181,traciebryant@blake.info,2020-01-29,https://www.crawford.info/
11-Mar-2021,IMPS,00.00,"295,860.43","1,775,162.56",ce3Fa71411d9E29,1219,Yesenia,Hayden,Rosario PLC,Kristieshire,Germany,453.375.2921x7965,169.311.4936,ferrellmason@melton.com,2020-11-06,https://www.melton.net/
11-Mar-2021,Commission,409.20,00.00,"1,775,571.76",8Eb2A5Ca7deed8A,8953,Laura,Ingram,Duncan Ltd,Lake Sandyborough,Korea,+1-872-486-5978x77870,520-814-8250,sheryl29@hurley-kirby.com,2020-06-13,http://shannon.net/
11-Mar-2021,Debit Card,00.00,"177,557.18","1,598,014.58",Dc2B423fc6C8cE7,8089,Rick,Quinn,Fitzpatrick-Lin,Jaymouth,South Georgia and the South Sandwich Islands,9218247163,(429)946-6606x03484,levygary@johnston.com,2020-02-19,https://www.kent-sloan.net/
11-Mar-2021,Reversal,00.00,"266,335.76","1,331,678.82",21FEF4731a46A91,9092,Edgar,Dominguez,Castillo-Shepherd,South Bobhaven,Lithuania,+1-857-125-3577x5496,+1-336-379-4877x265,pennynunez@park.com,2020-01-10,http://norton-dean.com/
11-Mar-2021,Transfer,00.00,"190,239.83","1,141,438.99",67ECBda6a4CA8f4,322,Justin,Hendrix,Pham Ltd,Marvinville,Costa Rica,958.055.4898,001-002-454-2007,fphelps@cole-gay.com,2020-03-01,https://www.duarte.com/
11-Mar-2021,Cheque,00.00,"114,143.90","1,027,295.09",4a83aB1AEaDA20e,9000,Rachael,Vazquez,Cain-Ashley,Hansenmouth,Equatorial Guinea,249-788-7240x49952,301.370.6988,frostdestiny@hughes.info,2022-04-20,http://www.nguyen-rios.info/
11-Mar-2021,Reversal,"230,128.20",00.00,"1,257,423.29",5fcb4b2EAb8A38c,7874,Zoe,Cochran,Harrington Ltd,New Alexisburgh,Tuvalu,308.604.9871,669.993.2856x91657,leonardcalhoun@edwards.biz,2022-02-19,http://velasquez.com/
11-Mar-2021,Debit Card,00.00,"157,177.91","1,100,245.38",387b57da0dC94B0,5166,Alexandria,Mcintyre,Meyers LLC,New Sherriborough,Brunei Darussalam,904-453-6975,(734)439-9764,deanmendez@torres.com,2020-03-10,http://www.melendez-farley.biz/
11-Mar-2021,IMPS,34.63,00.00,"1,100,280.01",82bFf35ccaa1eca,9773,Brian,Dixon,Browning-Crosby,Isaacmouth,Saint Martin,734-926-7481x012,289-462-3915,dwalters@weiss.info,2022-04-23,http://www.henson.com/
11-Mar-2021,Transfer,03.55,00.00,"1,100,283.56",Beb0D2e4BA54a51,22,Roy,Brock,Becker-Woodard,Port Martha,Zimbabwe,001-102-869-0189x1414,303.040.0780x2768,ldelacruz@spence.com,2021-06-27,https://www.norman.org/
11-Mar-2021,Miscellaneous,"1,649.12",00.00,"1,101,932.68",D3BA2462fCc6D83,9068,Michelle,Nguyen,Long-Valentine,New Ricky,Jersey,(181)366-5073,604-228-3693x0544,santiagotheodore@dickerson-hardin.com,2021-04-08,http://nicholson-archer.com/
11-Mar-2021,Interest,44.00,00.00,"1,101,976.68",CD73bc8Fa7Be64E,88,Sierra,Bautista,Lynch Inc,Butlerberg,Heard Island and McDonald Islands,001-209-997-8162x72724,759.775.4540,chavezrandall@mckinney-stafford.net,2020-05-27,https://www.anthony.net/
11-Mar-2021,Commission,"18,054.75",00.00,"1,120,031.43",7cFaD5Bc7B4aB7b,7064,Hailey,Yu,Lawrence and Sons,Logantown,Monaco,+1-954-487-6577x1498,001-533-404-6864x68791,hickmangrant@joseph.org,2022-03-26,http://ritter.biz/
11-Mar-2021,Bill,02.70,00.00,"1,120,034.13",d3591C4fDbFe474,9533,Madison,Franco,Fowler LLC,Sherichester,Macao,+1-054-550-2788,075.028.3306,lpennington@henderson.net,2021-05-06,https://www.velasquez.biz/
11-Mar-2021,Purchase,00.00,"1,120,034.13",00.00,aa00EB5CF5EB5E3,4338,Caroline,Jensen,Dougherty LLC,North Timothy,Benin,(757)847-7395x7696,270-037-3151,faith58@arellano.net,2022-04-08,http://zuniga-caldwell.info/
11-Mar-2021,Commission,"1,250,839.20",00.00,"1,250,839.20",6F5Fff931dbC1b0,9722,Allison,Powell,"Wilcox, Strickland and Zimmerman",West Kristaville,French Guiana,718.736.7449,491.883.9187x333,claudia76@navarro.org,2021-07-17,http://www.hutchinson.org/
11-Mar-2021,Interest,00.00,"138,982.13","1,111,857.07",caBc788e17DeBAe,5671,Frank,Winters,Day Inc,Lake Alexaland,Fiji,001-485-916-9460x0223,931.443.6398x5895,ldunlap@washington-mckenzie.com,2021-03-03,http://parks.com/
11-Mar-2021,Bill,"944,996.80",00.00,"2,056,853.87",E96e3Db4d1c2cEE,3755,Jason,Hayes,"Skinner, Livingston and Reyes",West Eduardo,Reunion,2413584734,200-182-9540,robin91@byrd.com,2021-11-25,https://www.barber.net/
11-Mar-2021,Debit Card,"3,443.29",00.00,"2,060,297.16",11D5aeDE5C4Cb7C,9485,Nathaniel,Higgins,Haley-Castro,Waltonshire,Azerbaijan,0929500542,(542)788-5480,gmccoy@glover.com,2020-01-01,http://lowery-villanueva.com/
11-Mar-2021,Interest,03.00,00.00,"2,060,300.16",87Bb78c5ab6F3a0,4519,Noah,Hawkins,Ruiz-Clements,Terrytown,Argentina,780.531.3799,001-443-314-7166x4995,james43@goodman.net,2021-01-20,https://ramos-gross.org/
11-Mar-2021,Cash,00.00,"228,922.24","1,831,377.92",aE954839a03D5b5,2741,Tasha,Matthews,"Parks, Pineda and Mendoza",South Walter,Venezuela,(387)086-9534x26661,001-781-566-8485x325,noahdominguez@reyes-snow.com,2020-03-28,http://lowe.net/
11-Mar-2021,Purchase,"254,303.00",00.00,"2,085,680.92",14BEc500d6A777d,2491,Rebecca,Sampson,Cameron-Moyer,Beardchester,Isle of Man,+1-690-922-4618x82795,306-928-2344x098,meyersrobin@vazquez.com,2021-08-05,https://www.scott.com/
11-Mar-2021,RTGS,"1,148.09",00.00,"2,086,829.01",025f17DCE1Acb3C,9203,Cristina,Mcgrath,"Tate, Freeman and Rose",Prestonberg,Panama,231.710.8158x778,644-315-3229x97457,carlcobb@mullins.com,2020-02-24,https://www.rodgers-villanueva.com/
11-Mar-2021,Miscellaneous,00.00,"260,853.63","1,825,975.38",bcE3Fbe7cfAfaFa,6621,Ronald,Pennington,Potts LLC,North Olivia,Madagascar,(279)295-1295,001-887-559-7046,dillon37@cruz-rosales.info,2021-03-05,http://acevedo.com/
11-Mar-2021,Transfer,"1,051.50",00.00,"1,827,026.88",00C5FeadD87EeD5,2978,Matthew,Hurley,Stewart-Davidson,Oscarmouth,Myanmar,891-910-9221x7233,732.970.1087x415,esparzakyle@rogers.com,2020-12-29,http://macias-morris.com/
11-Mar-2021,Tax,07.00,00.00,"1,827,033.88",cf4DAA75cd7AC14,747,Betty,Soto,Roberson PLC,South Guy,Uzbekistan,3719042212,434-533-6969x900,lcooper@ball-pittman.org,2020-08-29,http://patterson-huerta.com/
11-Mar-2021,Cash,25.00,00.00,"1,827,058.88",DD5f5df7fF3B78A,8788,Betty,Bryan,Grimes-Lara,Lake Tammy,Morocco,505-019-2831x6432,369-855-7032,mdurham@mcmillan-kaufman.biz,2021-03-01,http://rowe.com/
11-Mar-2021,Miscellaneous,00.00,"456,764.72","1,370,294.16",a895a9dfea93dD7,6979,Michael,Beasley,Schroeder LLC,New Cheryl,Togo,001-629-907-7727x336,199.675.0432x0753,jeanettemarshall@gay-haney.info,2020-12-19,https://ward.com/
11-Mar-2021,Interest,00.00,"274,058.83","1,096,235.33",6A527c245a0d1BF,2699,Damon,Orozco,Arroyo Inc,Lake Whitneyburgh,Guatemala,001-276-887-0582x70305,(253)279-0125x8910,oortega@rivas.biz,2021-12-24,https://miles.com/
11-Mar-2021,RTGS,281.00,00.00,"1,096,516.33",a0eb3D0bDcfB8Bd,52,Judith,Fischer,"Oconnor, Glover and Park",Lake Joshua,Isle of Man,6570280667,001-929-759-1013x923,natasha83@delacruz-edwards.com,2020-01-26,https://spencer.com/
11-Mar-2021,Transfer,00.00,"219,303.27","877,213.06",2AdaCF424D7Ab1a,2820,Elijah,Blair,"Roach, Webster and Medina",Alvinbury,French Polynesia,(951)041-6976x05879,(395)398-2747,kennedymarc@sims.com,2020-07-10,http://www.daugherty-hooper.biz/
11-Mar-2021,Debit Card,00.00,"125,316.15","751,896.91",96b9f9af21eBC93,9211,Juan,Kelly,"Roberson, Hartman and Graham",Port Evelynshire,Mauritania,+1-899-632-7517x4940,001-793-819-0908,ghogan@browning-stephenson.biz,2021-06-20,https://www.cantrell.biz/
11-Mar-2021,Tax,"29,167.20",00.00,"781,064.11",7290EbcB2CD6BC5,4029,Toni,Shah,"Burns, Kaiser and Daniels",New Stefanie,United States Virgin Islands,560.336.1443,177-113-6583,tasha29@campos.com,2020-10-18,http://www.stewart-flores.com/
11-Mar-2021,Tax,00.00,"781,064.11",00.00,C9fdCfd4f9147b1,5888,Lucas,Gonzalez,"Garcia, Watson and Vargas",Lake Kentfort,Germany,+1-412-178-9139x94957,+1-219-271-4331x85034,laura58@schwartz.com,2020-11-14,https://heath.biz/
11-Mar-2021,Bill,"106,327.81",00.00,"106,327.81",21bAD5deAffd240,7281,Hayley,Mueller,"Herring, Thompson and Burton",Jillianville,Montserrat,+1-238-912-7961x552,9704910038,ohampton@roberts.com,2020-10-28,http://www.bradley.org/
11-Mar-2021,Cash,"29,821.00",00.00,"136,148.81",54Ea659A810eeae,8308,Mariah,Sherman,Roach-Stokes,East Michaelaport,Nigeria,749-439-7112x0007,656.337.5763,boltonrichard@donovan.com,2020-11-06,https://www.sanford.biz/
11-Mar-2021,Transfer,00.00,"27,229.76","108,919.05",7cE3A8cAe5D6196,4174,Robert,Espinoza,"Carr, Cobb and Melendez",Georgeland,Tonga,001-261-868-1207x454,+1-516-957-3663x3850,shirley59@sparks-waller.com,2021-05-02,https://barr-chen.com/
11-Mar-2021,RTGS,76.00,00.00,"108,995.05",Bfbade7aCC44ddb,7296,Glenda,Frederick,"Payne, Valenzuela and Bryant",Kayleemouth,Mauritania,445.265.9031,+1-204-208-8839x64146,freydon@newton.com,2021-11-24,http://dunlap.com/
11-Mar-2021,Tax,29.65,00.00,"109,024.70",fb07C73BF5DAe62,1973,Jasmine,Huynh,Hale Inc,North Joshua,Reunion,(213)448-3869x4153,+1-928-924-2695x3141,andrescarr@atkins.com,2020-08-03,https://www.young-calhoun.biz/
11-Mar-2021,NEFT,00.00,"36,341.57","72,683.13",e1B07addD3A0eea,9442,Elizabeth,Cooper,"Wilcox, Fuller and Sloan",North Lucas,Peru,(522)898-9494,(518)932-0605,alexandercisneros@wright.com,2021-07-18,https://www.lane.org/
11-Mar-2021,Tax,00.00,"72,683.13",00.00,7d899C243b2DEEE,3926,Caitlyn,Nichols,"Huynh, Decker and Herman",Lake Todd,Andorra,249.283.5913x750,+1-236-371-8929x7211,harold50@pollard.biz,2022-02-27,https://www.payne-humphrey.info/
11-Mar-2021,NEFT,05.00,00.00,05.00,cCffAC2beBC5adF,6450,Louis,Galvan,"Trujillo, Sanford and Reynolds",Raymondville,French Guiana,323-329-8940x08589,001-547-551-2019x19363,snowjake@hoffman.net,2022-03-19,http://www.duncan-anderson.com/
11-Mar-2021,Miscellaneous,"129,362.60",00.00,"129,367.60",52FDe6b6B8a0cDe,1308,Ralph,Orr,"Flynn, Richard and Buckley",Meyermouth,Oman,+1-741-939-1850x179,549-240-8979x05631,amontoya@cruz.com,2021-11-12,https://mclean.com/
11-Mar-2021,Tax,00.00,"32,341.90","97,025.70",502bfa3399cbAdB,2411,Mark,Ortiz,Frost and Sons,Richardview,Comoros,001-018-152-8747x67446,001-947-571-2844x902,frank25@bray-beltran.com,2020-03-22,https://www.schmidt.com/
11-Mar-2021,Tax,06.70,00.00,"97,032.40",6d1de21C407B2f4,9497,Jeffrey,Costa,"Howe, Berg and Brewer",Alexandertown,Bulgaria,389-590-6544,(345)309-5112,jaydominguez@molina-sharp.com,2020-01-05,https://walker.com/
11-Mar-2021,Interest,00.00,"16,172.07","80,860.33",611D6Ae1ddf2Bf5,9565,Caitlyn,Schultz,Kerr-Wade,Knoxton,Cyprus,852-648-5084x70198,7427530062,andrea85@huffman-powers.com,2021-06-27,https://boone.com/
11-Mar-2021,NEFT,"151,997.90",00.00,"232,858.23",C17dab74930a79C,3546,Kristy,Fitzpatrick,Mccormick-Salazar,Orrton,Antigua and Barbuda,780-061-0442x427,422.432.2106,terrysharon@watts-reyes.com,2021-08-11,http://www.foster.com/
11-Mar-2021,IMPS,167.86,00.00,"233,026.09",b7AFA72118d4ee3,4463,Larry,Gentry,"Everett, Shepherd and Brown",East Chris,Jordan,001-956-139-9094x7437,001-351-325-8476x557,kharper@moreno-holmes.com,2021-12-21,http://www.moore-holloway.info/
11-Mar-2021,Transfer,"362,681.00",00.00,"595,707.09",B9bbd1bBD5CbB61,8841,Sonya,Porter,"Mcpherson, Larson and Tapia",New Lee,Turks and Caicos Islands,(602)378-7928x119,(806)969-6302x490,norrisricardo@fitzgerald-james.com,2020-03-31,http://dennis-parker.biz/
11-Mar-2021,ATM,"85,807.59",00.00,"681,514.68",ffaBE254CFF9A37,1215,Clayton,Curtis,Rasmussen and Sons,Jimfurt,Suriname,388.951.1595x7598,460-285-8235,karlamartinez@zavala-terry.com,2020-07-29,https://www.berry-conley.com/
11-Mar-2021,Reversal,"16,676.00",00.00,"698,190.68",F3603661F39eAE0,1200,Jeremiah,Riley,Mullen Ltd,North Ellen,Rwanda,351.617.4405,312-654-1063x0858,gibbsjason@hodges.com,2021-01-27,http://www.gay-jones.biz/
11-Mar-2021,Cash,"1,837.20",00.00,"700,027.88",fa48c8Fb8fc0eAd,2786,Kyle,Nielsen,Mclean PLC,New Maurice,Algeria,156-036-2034x750,+1-620-909-9042x49872,markscheyenne@camacho.com,2020-07-27,https://dillon.com/
11-Mar-2021,Purchase,"23,904.00",00.00,"723,931.88",C8dEd7ba91Bc2df,9381,Jocelyn,Howe,"Travis, Boyd and Sutton",Averymouth,Botswana,(091)760-1036,692.943.3222,jesse21@prince.com,2020-04-21,https://gregory.org/
11-Mar-2021,Miscellaneous,346.88,00.00,"724,278.76",9a0BDf9cEf1f76d,379,Jim,Villegas,"Browning, Avery and Mercado",Emmaton,Ghana,525.864.9616,2353584783,fpope@buck-carney.info,2022-01-05,https://www.rocha.com/
11-Mar-2021,Reversal,00.00,"241,426.25","482,852.51",2cAA5152Ee6A6a5,5763,Gregg,Wise,Bright-Mcdaniel,Moralesland,Guatemala,001-308-477-7007,(783)920-6340,craig63@wells.net,2020-10-11,http://www.hartman-lloyd.com/
11-Mar-2021,Interest,00.00,"160,950.84","321,901.67",4cb9D11EFCD696D,5496,Leroy,Burgess,Atkins-Zamora,New Ricky,Macao,8249238804,001-287-712-2670x73729,antoniovargas@franco.com,2021-06-28,http://nolan.com/
11-Mar-2021,Debit Card,81.00,00.00,"321,982.67",59EED312CCA35F5,6580,Luis,Lang,"Mccoy, Wang and Moss",Lake Hannah,Cote d'Ivoire,001-088-260-1755x78482,2892503111,iturner@shields.com,2020-10-10,http://www.price.net/
11-Mar-2021,Commission,00.00,"107,327.56","214,655.11",2fB6bC11D650b9E,7035,Cristian,Collins,Clayton Group,Feliciaborough,Ghana,+1-869-820-0527x42505,+1-880-802-5248,marthamercer@summers-brennan.com,2020-02-10,http://sherman.com/
11-Mar-2021,Transfer,00.00,"35,775.85","178,879.26",f4fAED2cD18B6bf,3706,Tony,Trevino,Roach-Small,Lake Jefferybury,Djibouti,001-223-510-3903x219,(348)145-5248x35742,pford@campbell.biz,2020-09-15,https://durham.biz/
11-Mar-2021,Purchase,00.00,"17,887.93","160,991.33",Ca61535FddCFeBb,4841,Terry,Marks,"Johnston, Cantu and Chang",New Larryville,Palestinian Territory,(399)704-6133x9870,001-534-683-4922,phodges@garrison.com,2020-04-09,https://www.reese-ingram.com/
11-Mar-2021,Bill,"2,320.00",00.00,"163,311.33",f258EB0EEB6AA80,3797,Frank,George,Shepard LLC,West Isabellastad,Bermuda,(202)824-7339x8770,+1-583-157-7485x12540,karl18@hicks-boone.com,2020-05-10,https://www.lowery-preston.com/
11-Mar-2021,Interest,00.00,"163,311.33",00.00,c1A5A2ee14D72d0,3934,Marie,Houston,"Santos, Daniel and Mann",Kristinport,New Caledonia,743.125.8171x406,(020)943-1337x448,hollyflynn@hart.com,2020-02-02,http://www.nelson.info/
11-Mar-2021,Interest,"1,087.80",00.00,"1,087.80",FC7Fc11c2195998,6064,Alison,Mueller,Tucker-Russo,Hobbsberg,San Marino,138.919.5321x31662,+1-497-116-8185x5820,nathaniel38@burgess.info,2020-06-06,https://www.leach-pham.net/
11-Mar-2021,Miscellaneous,05.00,00.00,"1,092.80",21F4586e5aEBA7E,709,Jasmine,Lutz,Boyd Group,Huberville,Haiti,+1-124-988-9229x4595,(163)520-0326,kevin30@ferguson.com,2022-04-15,https://www.archer-fuller.com/
11-Mar-2021,Bill,00.00,"1,092.80",00.00,C3e83C94C47Ac4E,9441,Angie,Welch,Quinn-Watts,Randallmouth,Saint Martin,+1-316-070-4456x799,7554065930,ryan05@murray-fletcher.com,2021-07-02,https://www.roberts-rush.net/
11-Mar-2021,NEFT,"1,552,265.00",00.00,"1,552,265.00",073f7DF62c0256f,8825,Bill,Valentine,"Macdonald, Sherman and Lewis",Lake Jodishire,Greenland,001-831-788-0268x50503,+1-516-060-4164,timvazquez@wade-wolfe.com,2021-05-09,http://www.herman-bird.com/
11-Mar-2021,ATM,00.00,"155,226.50","1,397,038.50",ffAcBbd4cBBF187,6829,Stanley,Wilcox,"Davila, Koch and Decker",North Paulfort,Luxembourg,+1-812-977-3072x02292,(303)052-7848,hutchinsonjessica@prince.biz,2020-02-11,https://freeman-hendricks.info/
12-Mar-2021,IMPS,"49,086.25",00.00,"1,446,124.75",C3B6ab1b4Cb563d,1118,Jackson,Mccall,Holloway LLC,Rowlandview,Niue,940-629-0533x1254,016-443-9290x80844,diane27@donaldson.com,2020-03-10,http://www.riddle.com/
12-Mar-2021,Miscellaneous,00.10,00.00,"1,446,124.85",6a7f5CCaBc6D76f,4182,Ruth,Ward,Mendoza Inc,Hesterborough,Bosnia and Herzegovina,353.686.7557x32460,953.087.6111,jamie79@dalton-byrd.com,2020-09-24,https://www.baird.com/
12-Mar-2021,Debit Card,"1,134,235.75",00.00,"2,580,360.60",1b9CDDceC017308,4324,Emily,Yang,Richards Ltd,Port Karen,Holy See (Vatican City State),924.290.7172,(205)466-3521,pwhitney@sharp-powell.net,2022-01-09,https://gonzalez-lucero.org/
12-Mar-2021,Cash,00.00,"430,060.10","2,150,300.50",Ea7A6ebbdaDAc53,5336,Rick,Lewis,"Good, Cantu and Cunningham",Sergiohaven,Lebanon,(225)258-2241,+1-274-496-3398x7470,wardjade@howell.com,2020-07-22,https://www.scott.com/
12-Mar-2021,Reversal,00.00,"2,150,300.50",00.00,ab405Bb4fccAd89,5466,Roberto,Foley,"Hamilton, Wheeler and Navarro",Grantfort,Belarus,120-343-4348x788,(213)425-9954x6175,hvincent@butler-pena.info,2021-01-21,https://charles-rhodes.com/
13-Mar-2021,NEFT,130.40,00.00,130.40,2bDD58D1f444eCb,9683,Randy,Pope,Jones Group,Laneburgh,Myanmar,491.374.9325x63663,946.086.6309x36640,kaylalambert@roberson.com,2020-12-08,http://bray-mcmahon.biz/
13-Mar-2021,Cash,00.00,32.60,97.80,6C3b6B6D0AfCeCf,7867,Elijah,Fleming,"Spence, Mccormick and Jacobs",Lake Gabriellamouth,Somalia,682-867-3865,494-172-7750x711,tristansherman@wang.com,2020-07-11,https://clements-paul.info/
13-Mar-2021,Commission,00.00,19.56,78.24,ffB8FB3589eEd0b,2281,Alexis,Calderon,Meyer LLC,Frederickberg,Monaco,(758)520-8553x85407,+1-946-189-6675x81402,jennyjefferson@choi.info,2020-02-26,http://www.kent.com/
13-Mar-2021,Debit Card,"152,100.00",00.00,"152,178.24",42a21A18031AbdD,6466,Warren,Esparza,Holt Inc,Hatfieldbury,Mongolia,0552779368,834-945-0971,hayden09@cook.biz,2020-03-03,https://mccall.com/
13-Mar-2021,ATM,506.12,00.00,"152,684.36",65b46e79ccD48de,5765,Lucas,Pena,"Becker, Oconnell and Aguilar",Leachborough,Eritrea,001-909-990-0940,+1-390-148-0396,petersengwendolyn@walters.com,2021-04-18,http://mejia-howe.com/
13-Mar-2021,Cash,"950,945.75",00.00,"1,103,630.11",6D23D4aBD7a9d5C,4322,Leah,Flynn,Blankenship-Fox,Barbaraville,Monaco,908.086.0859,007.651.8932,nathanielhansen@massey.com,2020-01-05,https://huber.com/
13-Mar-2021,Interest,00.00,"275,907.53","827,722.58",BDc713e91375aeE,8014,Peggy,Brady,"Cruz, Lam and Day",Prattport,Poland,001-578-243-9473x47586,790.593.8042,farmerdominique@ball.net,2020-06-09,http://dickson-snow.biz/
13-Mar-2021,Purchase,05.00,00.00,"827,727.58",E520ccbAd7CB37F,6616,Susan,Tucker,Stanton-Gray,Vanceview,Lebanon,319.562.0897x11594,247-885-8400x187,velezalvin@hancock.com,2022-03-22,http://www.mays.com/
13-Mar-2021,ATM,48.38,00.00,"827,775.96",b816EECEB9AEFF6,2173,Mariah,Hardy,Santiago-Baker,South Jasmineshire,American Samoa,343-761-4011,035-238-0649x4750,kayleerodgers@leblanc.org,2021-11-15,https://glenn.com/
13-Mar-2021,Transfer,00.00,"82,777.60","744,998.36",22f54B5EbDe3f2F,2459,Ashlee,Mathis,"Griffin, Hayden and Bailey",Kiarachester,Cayman Islands,(839)520-3099x0770,713.516.7109x57193,bdaugherty@patton.biz,2020-11-02,http://www.wilcox-brandt.net/
13-Mar-2021,Cheque,"1,479,490.50",00.00,"2,224,488.86",EeFB6FF8ACdcB9d,5395,Cheyenne,Rhodes,Dean Ltd,North Jillianshire,Cook Islands,001-161-649-4107x75737,124.493.6241x9477,dmooney@joyce.com,2020-09-08,http://velasquez.com/
13-Mar-2021,Commission,00.00,"278,061.11","1,946,427.75",98f7dCef6EF92dD,2413,Albert,Singleton,"Lawrence, Gonzales and Terrell",East Autumnstad,Myanmar,+1-032-663-0508x06945,1987893348,cray@crosby-walls.com,2020-10-01,http://www.miller.com/
13-Mar-2021,Transfer,"1,383,644.00",00.00,"3,330,071.75",dfCE769cc1D18Ae,5084,Benjamin,Houston,"Holden, Trevino and Tate",South Diana,Lebanon,968-809-7996x98609,001-084-821-7290x686,rhonda21@herrera-glover.com,2021-06-09,https://grant-price.com/
13-Mar-2021,Cheque,"6,628.60",00.00,"3,336,700.35",206BC3d36E2D937,3583,Jill,Church,Jenkins-Houston,South Tashaberg,Bangladesh,210.205.3360x4079,2903797817,lucasrichard@chandler-cross.com,2021-01-26,https://www.bradley-hodge.info/
13-Mar-2021,Tax,"4,347.46",00.00,"3,341,047.81",Fb0FDba4e37AF5B,2525,Felicia,Andersen,Fischer-Wilcox,Lake Dustinhaven,Saint Kitts and Nevis,0367606756,(610)484-1001x931,qcowan@conley.com,2022-01-04,http://www.roy-stone.info/
13-Mar-2021,IMPS,00.00,"556,841.30","2,784,206.51",d002cD8C638f2AD,4734,Darrell,Benjamin,Santos Ltd,South Garrettville,Ethiopia,338-087-7522x4410,7333956127,holdengavin@sharp.com,2022-04-17,http://www.escobar.info/
13-Mar-2021,Reversal,"256,600.88",00.00,"3,040,807.39",bBac21fE82CEf2e,3575,Tiffany,Wong,Curtis-Peters,Calhounborough,British Virgin Islands,533-880-2876x68452,290-942-0744x9844,cmarshall@richardson.com,2020-05-03,http://www.mayer.com/
13-Mar-2021,Debit Card,00.00,"506,801.23","2,534,006.16",2AdaCF424D7Ab1a,2820,Elijah,Blair,"Roach, Webster and Medina",Alvinbury,French Polynesia,(951)041-6976x05879,(395)398-2747,kennedymarc@sims.com,2020-07-10,http://www.daugherty-hooper.biz/
13-Mar-2021,Interest,"30,824.38",00.00,"2,564,830.54",C90dfe2E88e36c1,1252,Norma,Valenzuela,Mcfarland PLC,Port Clintonmouth,Ukraine,966-161-8867,888.335.2002x5228,hornjavier@hanson.com,2021-10-25,http://www.hart-whitehead.info/
13-Mar-2021,Debit Card,00.00,"284,981.17","2,279,849.37",3BEb4Fc4BacF8e5,2576,Eric,Cruz,Pena Inc,West Bobby,Christmas Island,(720)264-8931,0652489344,katiemcmillan@gould-barrera.biz,2020-01-19,https://morse-fowler.info/
13-Mar-2021,Cash,00.00,"455,969.87","1,823,879.50",fBE68ee9EFcCd1B,3595,Nicolas,Hood,Russell-Velez,South Vincenthaven,Estonia,+1-896-444-7307,322-274-6630,blake37@craig.biz,2021-04-21,http://www.wolfe-wood.net/
13-Mar-2021,Reversal,"1,020,461.80",00.00,"2,844,341.30",46E4bCa4717cf12,5553,Clarence,Valenzuela,"Bowen, Whitney and Cunningham",Gloverhaven,Sudan,474.350.9740x91212,001-682-724-6284,christine17@cross.info,2020-09-15,https://www.shea.net/
13-Mar-2021,Purchase,"2,664.50",00.00,"2,847,005.80",ceeF7BC6bABaFBC,5412,Fred,Zamora,Marshall Inc,South Amy,Guatemala,+1-060-231-9197x7789,980.156.3803,christopherwise@wallace.com,2020-12-07,https://www.mullen.biz/
13-Mar-2021,Commission,"14,544.00",00.00,"2,861,549.80",5CE55DA29696E1F,1809,Ian,Galvan,"Bradford, Obrien and Morris",Middletonhaven,Saint Kitts and Nevis,675.492.1709x3219,+1-277-845-4265x029,robynlevy@spence.info,2021-08-28,https://reid-crosby.com/
13-Mar-2021,Commission,00.00,"357,693.73","2,503,856.07",b1BCbA94f5A288F,8095,Edward,Chaney,"Long, Collier and Kent",West Jennifershire,Luxembourg,206-189-7709x6895,418.609.3227x20016,tzamora@greer.com,2020-07-24,http://www.fisher.com/
13-Mar-2021,IMPS,248.00,00.00,"2,504,104.07",3edF1BfF7c19e6C,9876,Elizabeth,Huff,Adams Group,North Beth,Panama,+1-321-644-2116,+1-233-623-1599x4828,mcfarlandgarrett@flowers.com,2022-03-17,http://www.villanueva-bates.com/
13-Mar-2021,Interest,"127,470.00",00.00,"2,631,574.07",d07d21B018BE28E,8666,Gerald,Rivera,Tran-Cole,Lake Melanie,Uganda,+1-048-313-3833x8063,679-528-5041,qharding@taylor.org,2021-04-22,https://www.lin.com/
13-Mar-2021,IMPS,"21,537.35",00.00,"2,653,111.42",2D87D4c98F1dc84,2136,Darren,Atkins,Stanley-Mccarthy,Jodiland,Greece,001-944-715-5149x62983,(559)795-3150x901,galvarado@vance.com,2021-09-13,http://hickman.com/
13-Mar-2021,Bill,"3,273.00",00.00,"2,656,384.42",Cdcd04c2398FFfe,148,Rose,Hunter,"Acosta, Mendez and Rivas",Boydburgh,Costa Rica,264-488-7271,+1-039-325-0627x1822,hebertdarin@kidd.com,2020-03-22,http://www.small.com/
13-Mar-2021,Reversal,00.00,"885,461.47","1,770,922.95",a8Eff9e04AdfC29,2462,Jerome,Pearson,Patel-Costa,Watkinschester,Netherlands,732.495.6762x104,+1-506-597-2261x20206,wolfmiranda@burch.com,2021-09-18,https://strickland.biz/
13-Mar-2021,Miscellaneous,56.01,00.00,"1,770,978.96",C59D0C66209d40d,2082,Marilyn,Carrillo,Henry Inc,West Aaron,Jamaica,+1-752-470-5610x1241,(508)753-1617,wallsmargaret@day-woodard.com,2020-07-30,http://www.jordan.com/
13-Mar-2021,Tax,00.00,"177,097.90","1,593,881.06",290D433DDc9FA44,7051,Sabrina,Stein,Oconnor-Wheeler,West Brady,Cuba,110.483.9449x445,140.584.2566x48428,guy24@mullins.com,2022-03-24,https://www.suarez.net/
13-Mar-2021,Reversal,00.00,"398,470.27","1,195,410.80",C9bFa849Cd1DeEe,7292,Helen,Weiss,"Sweeney, Newman and Guerra",South Bryce,Antigua and Barbuda,+1-545-223-7038x98874,389.415.3502x7264,lancemayer@webster.info,2021-12-15,http://pope.com/
13-Mar-2021,ATM,23.50,00.00,"1,195,434.30",e512e3DaEA344fC,2695,Maurice,Dawson,Fowler Ltd,South Tammy,Morocco,408.260.0659x5380,745-605-0076,pamdickerson@mcclure.org,2021-02-01,https://hammond.com/
13-Mar-2021,ATM,00.00,"119,543.43","1,075,890.87",F08D0610937E87c,9732,Tracie,Donovan,Carson-Glass,Elizabethside,El Salvador,+1-514-562-6430,524-284-9296,curtisjones@bush.biz,2020-06-23,http://bowen.com/
13-Mar-2021,Transfer,"1,858.40",00.00,"1,077,749.27",Be6C74ac9E684ab,9311,Tommy,Tyler,Chapman and Sons,Dennistown,Oman,952.474.3698,7391421130,mharris@dennis.net,2022-01-24,http://skinner-andersen.net/
13-Mar-2021,Cheque,00.00,"359,249.76","718,499.51",c00E78BA78Ade7A,6223,Angela,Schneider,Madden PLC,Vasquezfort,Armenia,521-209-3743,652.119.4974x69809,harrellcaroline@cortez-espinoza.com,2020-10-31,https://www.jenkins.info/
13-Mar-2021,NEFT,00.00,"89,812.44","628,687.07",3b1F09D26B6b666,8555,Melissa,French,Hurley-Bradford,Fredbury,Mauritania,+1-187-896-6110x93624,001-293-525-9920x217,arianagood@wilkerson-gomez.com,2020-05-20,http://www.bean.com/
13-Mar-2021,Purchase,00.00,"628,687.07",00.00,4EADd9328ed6D83,3511,Lee,Keller,Chapman PLC,East Norma,Tonga,+1-312-308-3209,+1-586-319-5277x96596,leonardmartha@hull.com,2021-11-26,http://stout.com/
13-Mar-2021,ATM,"6,419.00",00.00,"6,419.00",Cc7fDD0640ebfa8,2897,Bill,Foley,"Benjamin, Boone and Kidd",Dodsonton,Greece,001-851-560-9830x6751,341.533.2270,nnolan@mcmillan.com,2021-07-30,https://cisneros.com/
13-Mar-2021,ATM,00.00,"1,604.75","4,814.25",9E0fDCA5069Ac32,9837,Darryl,Dixon,Murillo Ltd,East Kristen,Palau,001-291-829-6323x9058,263-786-3375x9325,karina46@bradley-bender.com,2022-03-10,https://www.hurley.com/
13-Mar-2021,Purchase,00.00,"4,814.25",00.00,5c8d356A16FfeEB,9112,Sonya,Andersen,"Rowe, Mosley and Stephens",Lake Kurt,Chad,417.387.6781x50654,001-162-465-5741x435,yeverett@ewing-anthony.com,2021-08-18,http://eaton.info/
13-Mar-2021,Purchase,11.54,00.00,11.54,61BE16F85cBF99e,6518,Vickie,Gillespie,Wells Group,Breannafurt,Niger,380-673-4235x616,475-729-6078x01099,clairemooney@rasmussen.com,2022-03-26,https://rhodes.com/
13-Mar-2021,Tax,07.00,00.00,18.54,f7BDdB36bA829dA,6306,Seth,Payne,"Moses, Guzman and Harvey",Kiddchester,Pitcairn Islands,666-688-9844,001-365-538-1550x222,dcardenas@tanner-rush.biz,2020-12-25,http://morrison.com/
13-Mar-2021,Purchase,"13,606.80",00.00,"13,625.34",57E4e85AF40bBb8,7245,Steve,Anthony,"Perez, Fleming and Greene",Kristinashire,Lesotho,565-278-2725x796,582.215.1259x07515,mindy49@kirk.com,2020-08-20,http://combs-contreras.com/
13-Mar-2021,Bill,00.00,"4,541.78","9,083.56",e296c0eCD7e0597,8575,Shirley,Schmidt,Friedman Ltd,North Paige,Kuwait,958.456.9495x2791,+1-822-953-1597x7953,owong@kerr.com,2022-04-18,http://winters.com/
13-Mar-2021,Purchase,00.00,"1,297.65","7,785.91",EBF3d9f378FC2f6,3153,Harry,Nunez,Valentine Inc,Bishopchester,Sudan,067.304.8581,070.102.2760,lfuentes@rivas.com,2020-04-23,https://www.calderon.info/
13-Mar-2021,Purchase,00.00,"1,946.48","5,839.43",F64d0B3a74d7eC7,681,Cathy,Ritter,Brock-Elliott,North Vickieland,Nauru,797.207.6965x261,254-781-9423,omullins@vasquez.com,2020-05-27,https://schmitt.info/
13-Mar-2021,Cheque,00.00,"1,167.89","4,671.54",d5D381A204e861e,9336,Clinton,Mccarthy,"Mcconnell, Pugh and Powell",West Ruben,Macao,(491)608-1759,(545)110-8682x7165,michealcooper@mendoza-conley.com,2022-01-08,http://www.potter.com/
13-Mar-2021,Purchase,00.00,934.31,"3,737.23",a28CF6b0FfAAe26,6289,Jennifer,Fleming,Macdonald-Bishop,Willisview,Tanzania,(000)627-6460,5441510404,ebonypineda@huynh.com,2020-03-15,http://www.duran-hickman.com/
13-Mar-2021,RTGS,00.00,"1,245.74","2,491.49",ffEC198AAb6b2C4,7799,Mia,Leblanc,Alvarado-Hooper,Port Emily,Russian Federation,001-615-515-6787x098,001-969-388-0238x09302,sheliajacobson@schmidt-vega.info,2020-01-01,https://www.duran.com/
13-Mar-2021,IMPS,00.00,276.83,"2,214.66",fB028faA71AcEA4,7048,Walter,Rangel,Ferrell-Mcclure,Cordovachester,Macedonia,+1-674-991-0010,(395)778-7693x0284,bondtoni@haley-wong.biz,2020-03-07,https://www.petersen.info/
13-Mar-2021,Transfer,00.00,246.07,"1,968.59",2C7eF6a798DdBCd,5519,Pedro,Montes,Ibarra Ltd,Washingtonview,Bhutan,670-415-5101x1057,001-384-880-7808,hhammond@stafford.biz,2021-02-06,http://johnson.com/
13-Mar-2021,Tax,365.00,00.00,"2,333.59",5167E3bEa50df7a,9596,Clarence,Nelson,Lawrence-Hood,North Katherineshire,Palau,8612421817,451.788.6324,nsheppard@matthews.com,2020-07-26,http://www.ashley.biz/
13-Mar-2021,Debit Card,00.00,583.40,"1,750.19",479Fbf73d78f24F,6487,Bruce,Howell,"Gomez, Higgins and Short",Alantown,Tokelau,(682)702-0132x079,294-780-9182,arose@noble.biz,2022-03-13,https://www.collins.net/
13-Mar-2021,Cash,00.00,175.02,"1,575.17",c304b6ac171831D,2723,Christian,Hubbard,Warren-Mccarthy,North Daisy,Solomon Islands,907-753-7582x5318,001-741-128-0785,colleen20@coffey.com,2021-12-15,http://www.mckee.org/
13-Mar-2021,Debit Card,"217,579.00",00.00,"219,154.17",ace763c03c1eED8,361,Melissa,Potts,Bauer-Zavala,Padillaton,Bosnia and Herzegovina,+1-761-964-7294x350,376-094-5704,nicholas11@lyons.org,2021-10-29,http://solis-castro.com/
13-Mar-2021,Bill,00.00,"219,154.17",00.00,1a5052EaEA363D8,2559,Brandi,Medina,"Vasquez, Glover and Buchanan",North Caitlinport,Honduras,(321)683-9665x0938,(131)422-0523,rsantana@baxter.com,2020-07-15,http://daugherty.info/
13-Mar-2021,Reversal,"20,695.10",00.00,"20,695.10",E1CE0D4070F76F3,2463,Douglas,Chang,Levy LLC,Normanview,Trinidad and Tobago,+1-793-021-4940x874,(218)991-1008,tammierobertson@johnston-marshall.biz,2021-03-09,https://www.arellano.info/
13-Mar-2021,NEFT,00.00,"3,449.18","17,245.92",040517eff707929,1566,Lindsey,Benjamin,Riggs-Greene,New Candice,Norfolk Island,001-844-110-1921x107,1164704437,adam20@wong-downs.com,2021-02-20,http://www.oconnell-gonzales.com/
13-Mar-2021,Tax,"55,524.00",00.00,"72,769.92",606fBedaD99B8bb,7291,Isabel,Moody,Wilson LLC,West Calvin,Czech Republic,519-332-2607x56948,749.687.7884x217,holdercasey@park-goodwin.com,2021-06-11,http://boone-bell.com/
13-Mar-2021,Cash,"3,738.40",00.00,"76,508.32",EB18eb1ccDbAe7C,7807,Marilyn,Bruce,Luna Ltd,Schultzborough,Tuvalu,576-902-8941x685,233.577.3812,jerry23@cantrell.info,2020-08-12,http://www.arroyo.com/
13-Mar-2021,Reversal,103.00,00.00,"76,611.32",c513D89c6edef91,7852,Malik,Mathis,Stevenson-Lawson,Port Vanessafurt,United Arab Emirates,943.061.0276,(033)345-5530x2128,katelynroberson@chung.com,2020-04-21,https://www.good.org/
13-Mar-2021,Purchase,50.20,00.00,"76,661.52",6856BFA1dB7C238,3681,Ruth,Yu,"Barajas, Thomas and Butler",Kellifurt,Bahamas,513.296.3148x867,+1-884-894-1347x4321,melindahaney@little-faulkner.biz,2021-10-19,https://swanson.com/
13-Mar-2021,NEFT,"183,057.00",00.00,"259,718.52",EDF84b2D3f452d7,1848,Lisa,Norton,"Beck, Sharp and Waller",Bentleyland,Maldives,681.119.3503x195,064.571.4165,jherring@gates.com,2021-04-13,https://www.butler.com/
13-Mar-2021,Cash,"865,919.00",00.00,"1,125,637.52",9fBd5F9EeAe3B78,8946,Dillon,Jefferson,Booker-Patrick,West Steven,Bhutan,001-430-432-6706x0224,+1-975-635-4491x593,chasegriffin@estes.net,2021-02-14,https://osborne.com/
13-Mar-2021,Reversal,"212,596.00",00.00,"1,338,233.52",E3Be47B2Bc0fb08,422,Lisa,Blackwell,Daugherty and Sons,New Mackenzieland,French Polynesia,+1-397-236-8851x31652,+1-146-452-8670x3244,nlawrence@miles.biz,2020-04-30,https://mcneil-pratt.com/
13-Mar-2021,Reversal,150.00,00.00,"1,338,383.52",1eb9a595dea4aEA,6793,Damon,Galvan,Huber Ltd,Archerborough,Netherlands Antilles,851-076-5096x37877,001-564-547-9113x7592,darrenlewis@santiago.com,2021-04-02,https://www.benitez.net/
13-Mar-2021,Transfer,"962,454.00",00.00,"2,300,837.52",Bc7DFb5B7Fa55Be,9914,Charlotte,Nash,Shepherd-Gentry,Sheppardfurt,Switzerland,775-736-8696,2000703973,khanjulia@dennis.info,2022-04-16,http://www.gordon.info/
13-Mar-2021,Debit Card,"195,793.80",00.00,"2,496,631.32",Ad94D89c739CF3A,485,Krystal,James,Novak Group,Kristiborough,Serbia,010-055-4525x3849,(125)508-4414x54979,daryl93@pruitt-bass.com,2020-04-03,https://singh.info/
13-Mar-2021,Bill,"109,503.00",00.00,"2,606,134.32",Ed3DDEE0De1b769,875,Becky,Obrien,"Dunlap, Page and Duke",North Billfort,Andorra,256.124.9882,+1-503-703-0457x21281,wileygordon@salinas.com,2020-05-02,https://merritt.com/
14-Mar-2021,Transfer,00.00,"289,570.48","2,316,563.84",E1aa570E0F2cc5a,7777,Sharon,Conway,"Webb, Norman and Hartman",Singletonbury,Nauru,001-696-779-6740x68656,2116634114,daughertykelly@tran.com,2022-05-09,http://reyes.biz/
14-Mar-2021,Bill,"20,193.00",00.00,"2,336,756.84",a2c9eeFD2B0EC97,8781,Candice,Crawford,Gray PLC,Rossfurt,Tonga,485.006.7348x1130,0842225941,robin39@grimes.com,2021-08-02,http://www.adams-beard.com/
14-Mar-2021,Tax,"78,456.60",00.00,"2,415,213.44",1ffA5730246Ed10,9807,Daryl,Greer,Roy-Mccormick,Monicamouth,Marshall Islands,+1-671-445-2728,063-949-5302x9400,mcdanielgrant@sandoval.com,2020-06-23,http://conrad.info/
14-Mar-2021,Transfer,00.00,"345,030.49","2,070,182.95",76C2b8Ba59DD762,6709,Daniel,Simmons,"Duffy, Villarreal and Berger",Jaredside,Comoros,367-116-7421x80810,+1-926-595-3474x8254,hmolina@leblanc-harrington.com,2020-01-19,http://sharp-casey.org/
14-Mar-2021,Commission,00.00,"258,772.87","1,811,410.08",7fbCa0Ccc5C3537,2104,Noah,Blanchard,Dixon-Jordan,Port Arianatown,Kazakhstan,+1-314-035-8487x0851,845-826-4739,courtneybrock@mccormick.info,2020-04-18,http://www.solis.com/
14-Mar-2021,Reversal,381.91,00.00,"1,811,791.99",fAB3E7f258D68ba,2686,Joan,Erickson,Lozano Ltd,South Karlaburgh,Gambia,372.246.8158,975-329-6696,debbie36@weaver.com,2021-11-30,https://www.pratt.com/
14-Mar-2021,IMPS,"2,884.00",00.00,"1,814,675.99",D5fd4FA7f7fC3Ed,3906,Alejandra,Mathis,"Sexton, Glass and Huber",Hallville,Burundi,328.867.8174,(176)527-9414x75943,vlittle@villa.com,2020-07-23,http://dorsey-petty.com/
14-Mar-2021,NEFT,242.00,00.00,"1,814,917.99",34616EE42FC1aeA,1421,Norma,Alvarez,Wyatt Ltd,New Melvinborough,Japan,774.852.8761x78970,565-081-2471x5617,ruizrichard@york-cummings.org,2021-02-22,https://alexander.net/
14-Mar-2021,Debit Card,00.00,"453,729.50","1,361,188.49",b9bb9B0f559A5F9,8361,Isaac,Boyd,"Novak, Park and Schmidt",Port Tristanshire,Mali,001-794-722-8276x543,429-557-1930,whitakerpatrick@esparza-nielsen.org,2022-04-23,https://www.mcintyre.org/
15-Mar-2021,Cash,00.00,"340,297.12","1,020,891.37",FaaCDAE3c4dbed1,9232,Marissa,Oneill,Schwartz-Charles,Lake Patty,Faroe Islands,0140132738,(838)801-1430,blake12@rodgers.com,2021-06-17,http://www.cruz.org/
15-Mar-2021,Interest,06.50,00.00,"1,020,897.87",2eb07bD20aE016e,7370,Mathew,Robbins,Fry and Sons,East Rebekah,Reunion,310-214-8785,+1-541-068-3278x7456,muellercarl@wagner.com,2020-12-20,http://www.mcintosh-ortiz.com/
15-Mar-2021,Reversal,00.00,"255,224.47","765,673.40",F4dfd4eEf14bbBA,4526,Christine,Stephens,"Malone, Cuevas and Tyler",North Billfort,Sri Lanka,+1-256-965-9231,+1-427-925-3940x297,ibrock@hutchinson.net,2021-12-31,http://jordan.org/
15-Mar-2021,Cheque,"1,559,456.00",00.00,"2,325,129.40",fbE5C218cf4050e,1036,Taylor,Cobb,"Rios, Camacho and Lewis",Stephenschester,Cape Verde,159.581.2468,+1-744-608-4839x0823,walterprince@rivera.org,2020-04-12,https://www.holmes.biz/
15-Mar-2021,Cheque,"128,640.00",00.00,"2,453,769.40",cbA43d7cFeD7A7e,9944,Belinda,Fischer,Sosa-Hogan,East Tracyhaven,Mauritius,(723)759-1588x080,257.937.9153x77861,devon24@robles.com,2021-11-23,https://yoder-short.net/
15-Mar-2021,Interest,00.00,"490,753.88","1,963,015.52",1A6D0cd74F67a5a,584,Stanley,Shannon,Tucker-Diaz,Laurabury,Saint Helena,9042616723,+1-049-516-0935x212,becky23@nunez.info,2021-09-23,http://frey-rowland.net/
15-Mar-2021,NEFT,01.00,00.00,"1,963,016.52",dA5BC0C9B62B40c,5640,Gail,Malone,Haynes PLC,Fernandotown,Nigeria,(325)080-3401x1834,7962088193,benjamincarol@olson.info,2020-06-28,https://www.pena.com/
15-Mar-2021,Purchase,00.00,"196,301.65","1,766,714.87",eD5fa9E034B8a83,8910,Rose,Kaufman,Conley-Crawford,Barrychester,Mexico,001-956-518-9012,+1-589-534-1195x260,khughes@camacho-ross.com,2020-11-24,http://diaz-weaver.info/
15-Mar-2021,IMPS,00.18,00.00,"1,766,715.05",dDCCcCEEb244DCB,7459,Joann,Mckee,Mooney-Schroeder,Port Tony,Monaco,(612)252-4788,(274)639-5331x574,tyronepeterson@parks.net,2021-10-05,https://www.lam.org/
15-Mar-2021,Reversal,02.10,00.00,"1,766,717.15",eAC826eEC70c452,3255,Marcus,Walters,Mercado-Tucker,Newmanmouth,Costa Rica,942-254-4375,(007)812-9087,terrymcintosh@christian.org,2020-08-27,https://shelton.net/
15-Mar-2021,Cash,00.00,"883,358.58","883,358.58",3AFe816AAc6beD0,5410,Deborah,Wiley,"Weiss, Gaines and Little",Marisaberg,Philippines,(692)333-4684x7351,+1-499-854-6950x47787,michaela78@frost-campos.com,2021-12-06,http://www.solis.biz/
15-Mar-2021,Commission,"127,537.00",00.00,"1,010,895.58",7741E98D0D5ED12,4941,Clifford,Sanchez,"Shaw, Little and Jordan",South Tyler,Mauritius,5208128451,001-328-765-1610x286,hvincent@hatfield.org,2021-12-16,https://www.benson-schneider.com/
15-Mar-2021,Miscellaneous,"94,719.00",00.00,"1,105,614.58",efDEeFAf05Cec10,5973,Morgan,Lee,Gonzalez LLC,North Ricardo,Bolivia,402.454.3460,451.421.6697x151,jennyoconnor@castro.com,2021-03-21,http://odonnell.com/
15-Mar-2021,RTGS,00.00,"368,538.19","737,076.39",aEdcfa6aB7Aa3b8,3976,Nicolas,Vincent,Kaiser-Bridges,Lake Damonfurt,Reunion,001-181-243-2461x8147,001-957-890-0834x291,lauren77@poole.net,2020-10-29,https://www.wolf.com/
15-Mar-2021,Cheque,00.00,"245,692.13","491,384.26",aaAc1CD3A0EDE5b,3924,Edgar,Bruce,Charles-Brock,New Victorshire,Nicaragua,6732194864,601-146-5955x494,bryanhopkins@webster.com,2020-03-14,http://chaney.com/
15-Mar-2021,Transfer,"52,813.00",00.00,"544,197.26",b208cC8f3534DEf,8402,Kristi,Landry,"Olsen, Bolton and Lee",Watersburgh,Zambia,184.492.7297,499-819-5770,santanajeff@chung.com,2022-03-21,https://www.mooney.org/
15-Mar-2021,ATM,00.00,"60,466.36","483,730.90",ca3daB6512e6b33,2821,Dakota,Santana,Bray-Ellis,Alexaton,United States of America,001-700-682-2705x17586,(174)734-0737x2905,herringbelinda@bauer.com,2020-10-23,http://ramos-yu.com/
15-Mar-2021,Interest,00.00,"161,243.63","322,487.27",B99C38a8cCb3D7e,6280,Darrell,Frazier,"Hess, French and Deleon",North Anthonyside,Bolivia,(507)763-3346x490,436.694.7314x54992,betty09@ramos.com,2022-05-22,https://nunez.net/
15-Mar-2021,Tax,392.00,00.00,"322,879.27",7ffdc6cfcB8bEf6,2259,Julian,Walsh,Gross Inc,Greerside,Guernsey,001-099-171-6423x5891,001-828-288-8801x73174,qrobles@robbins.info,2020-05-04,https://www.mullins-hodges.net/
15-Mar-2021,Purchase,03.00,00.00,"322,882.27",cfea97B3aB9E037,9615,Gwendolyn,Hartman,Leach Ltd,Christianfort,Mali,(294)869-6584,+1-961-090-7505x480,louisvega@lawson.com,2021-04-25,https://www.villanueva.info/
15-Mar-2021,Reversal,141.15,00.00,"323,023.42",C92E39b2eBE7215,2393,Chris,Gilbert,Knox-Riley,Lisashire,American Samoa,426.643.7568x22331,459.833.0421x081,joepreston@gross.com,2021-07-15,https://www.woodard.biz/
15-Mar-2021,Interest,00.00,"80,755.86","242,267.56",18EC22b40be4f24,8030,Isabel,Humphrey,Vance-Ford,West Kathryn,Russian Federation,089-851-2862x322,9737557872,curtisalexandra@vasquez.com,2020-09-22,http://www.bender.org/
15-Mar-2021,Purchase,953.70,00.00,"243,221.26",b33d8d8A8a0ba5B,8517,Roger,Wagner,Sawyer and Sons,North Gabriellestad,Philippines,624.249.9946,964.048.4362x691,haleylloyd@skinner.info,2020-01-03,https://www.parsons.com/
15-Mar-2021,Tax,00.00,"81,073.75","162,147.51",6D719Cd56854ff2,3235,Daryl,Sexton,"Scott, Camacho and Martin",New Steve,Lithuania,(112)957-3267x141,(487)766-1594,zpoole@blanchard.biz,2020-03-24,https://hendricks-rosario.com/
15-Mar-2021,ATM,25.00,00.00,"162,172.51",80ADdB032adD50C,777,Gabriella,Hutchinson,Trevino-Hawkins,Chambersshire,Seychelles,7219771564,679.517.4215,albertfoley@cameron-osborne.com,2022-03-13,http://www.moody.com/
15-Mar-2021,ATM,37.00,00.00,"162,209.51",acfa6d36133e5de,9954,Miguel,Costa,Roy-Dennis,North Kristen,Nauru,684-421-6710,097-294-3891x715,malikdougherty@blankenship.com,2020-12-05,https://www.ritter-blevins.info/
15-Mar-2021,NEFT,494.14,00.00,"162,703.65",25b867D7ADcdbc8,9391,Denise,Berry,Mcintyre-Lawrence,Lake Meghan,Cyprus,300.729.6290x9467,(218)580-8525,eileen81@prince.net,2021-05-14,http://pineda.com/
15-Mar-2021,Miscellaneous,00.00,"16,270.37","146,433.28",af7F8FFfC17014E,1511,Grace,Thompson,Barajas-Houston,New Adrian,Taiwan,626-451-6922,(590)461-8969x099,salinasolivia@kane-hubbard.com,2021-07-23,http://arnold.info/
15-Mar-2021,Interest,03.21,00.00,"146,436.49",1614531Fac153C7,1801,Isaiah,Schneider,"Reynolds, Payne and Bullock",Alexaview,Vietnam,483.795.3412x2520,001-514-197-5719x01692,kenneth56@adkins-flores.com,2022-02-11,https://sharp.com/
15-Mar-2021,Miscellaneous,00.00,"73,218.25","73,218.24",dD0AFa0092C39Ba,7285,Kurt,Schneider,Morton-Swanson,Harrisonbury,Mauritius,871-651-6029,(524)041-1404x458,bestmarcia@carrillo-mccarty.com,2021-01-18,https://www.harmon.com/
15-Mar-2021,Bill,"118,428.69",00.00,"191,646.93",E9B18eB8BDFcfe2,5067,Ana,Glover,Cruz-Lester,Lake Deborahfort,Egypt,053-914-0101x16800,(406)924-6437,mercerjeff@zavala-cooke.info,2021-01-01,http://www.graves-monroe.com/
15-Mar-2021,Commission,"786,485.25",00.00,"978,132.18",9fb821FAC0BC4a9,2628,Paige,James,Norton Inc,North Victor,Angola,139-540-9443,559-588-4466x91092,summer43@ball.com,2022-05-05,http://mccann.com/
15-Mar-2021,Bill,00.00,"195,626.44","782,505.74",Cb76C41eCcCf1a7,9127,Shari,Reid,Mccall-Carr,Veronicamouth,Haiti,001-205-245-0903,001-871-896-6026x804,stefaniecox@pruitt-chaney.info,2021-08-24,https://www.blake.com/
15-Mar-2021,Cash,"82,804.30",00.00,"865,310.04",fE0Cb4D3FB26dB3,4216,Kerri,Jefferson,Rojas-Huerta,Stanleymouth,Somalia,(281)304-6829,001-776-419-9370,parkermullins@riley-perkins.com,2020-06-03,https://www.hopkins.com/
15-Mar-2021,Interest,00.00,"96,145.56","769,164.48",278AD06feF1Ca17,5140,Darin,Sherman,"Dickerson, Mendoza and Carney",New Javiermouth,Kazakhstan,0895243523,001-936-794-6243x5534,greenshari@crawford.net,2021-04-01,http://www.mcmillan.com/
15-Mar-2021,Miscellaneous,00.00,"384,582.24","384,582.24",5bA23ea0B3Dff46,1120,Tricia,Duran,Bartlett-Hurley,Hendrixport,Kazakhstan,670-876-7637,(905)864-2760,melodyvalenzuela@mcclain-potts.biz,2021-07-03,http://suarez.biz/
15-Mar-2021,Cash,01.26,00.00,"384,583.50",4B58cDF6137BBfC,6548,Devin,Robbins,Walker LLC,Lake Kurt,Bhutan,+1-182-227-8518,+1-291-840-7811x973,shawnmccann@ayala.org,2021-07-14,https://www.briggs.biz/
15-Mar-2021,Transfer,00.00,"76,916.70","307,666.80",fE48ffc6070EFcB,8341,Brendan,Walsh,Powers Inc,Blackwellville,Kazakhstan,(851)895-5397,(512)174-3113x100,iobrien@fox-boyer.com,2020-05-18,https://singh.com/
15-Mar-2021,Tax,"1,389,819.50",00.00,"1,697,486.30",48b3ACBfD6A5cdC,18,Kim,Griffin,Tyler-Levine,New Gwendolyn,Saint Kitts and Nevis,597.367.9499x5429,506.141.4174x6326,harold11@mullen.org,2021-06-02,http://www.mclaughlin-hubbard.net/
15-Mar-2021,Transfer,00.00,"1,697,486.30",00.00,e32faAAb95D8DCF,8427,Parker,Marquez,Mercer Group,South Danielle,United Arab Emirates,(176)133-4155x380,+1-531-109-6250x275,jerrycrane@ochoa-holmes.com,2021-04-30,https://www.rojas.net/
15-Mar-2021,Cheque,36.94,00.00,36.94,d4B05F7082F10Ef,1029,Kathleen,Barrera,Jacobs LLC,Port Krista,Cayman Islands,317.302.7413x48380,001-280-584-4955,krystalfrye@wise.com,2020-05-24,http://www.acevedo-watkins.info/
16-Mar-2021,Commission,00.00,04.10,32.84,6Ec287E31b2e71a,4292,Kristen,Singh,Riddle-Bautista,Ariasberg,India,001-102-883-6491x43981,827.700.4983,daltonsheri@aguilar.com,2020-07-07,https://www.waters.net/
16-Mar-2021,Transfer,00.00,03.65,29.19,53cD8B96bCBB4F3,3710,Kerry,Cox,Keith-Mcclain,South Edwin,Qatar,640-837-2819,001-749-643-1264x173,kristirusso@gonzales.com,2020-03-21,http://www.nielsen.com/
16-Mar-2021,Commission,745.00,00.00,774.19,5FaF51c2067c51e,4144,Edgar,Owens,Levine-Byrd,South Faith,Georgia,(704)944-2693,228.831.1651x0252,jacquelinepollard@proctor-yoder.com,2020-05-18,http://www.escobar.com/
16-Mar-2021,Cheque,864.40,00.00,"1,638.59",F9745b186d16B0f,6461,Isaiah,Huff,"Walls, Santana and Mcintosh",West Wyatt,Bahamas,135-434-2966x481,0342930040,kelleyerika@riley.biz,2022-02-21,https://www.mccullough-hanna.com/
16-Mar-2021,Reversal,00.00,"1,638.59",00.00,3428A38dCAf9bdc,3964,Allen,Pierce,Delgado Inc,Washingtonmouth,Iceland,967-679-1794,277-995-8330x974,spencerwilliam@blevins.info,2020-12-14,http://haas.net/
16-Mar-2021,NEFT,"27,726.30",00.00,"27,726.30",E31a9699DF2A0eF,25,Philip,Flynn,Morton Ltd,West Guy,Oman,881-632-0721x11032,(881)992-9151x74921,austinhobbs@briggs.com,2020-09-05,http://huerta-cordova.info/
16-Mar-2021,Cheque,00.00,"2,772.63","24,953.67",A8fcB4B7e9a922F,3395,Gina,Villegas,Moss LLC,Ewingville,Nigeria,001-773-752-0453,399-500-4358,diazalvin@barrera-ferrell.org,2021-01-28,http://www.harrell-atkinson.com/
16-Mar-2021,RTGS,04.30,00.00,"24,957.97",DF8dE20Ee5Ab918,5315,Richard,Petersen,Henry-Wilson,New Jennifer,Germany,(082)796-4011,(662)409-2890x909,jermaine30@long-bryant.com,2021-09-11,http://www.leblanc-gaines.com/
16-Mar-2021,Miscellaneous,314.42,00.00,"25,272.39",D714f8EebcA6b80,4299,Patricia,Wise,Wall-Khan,Gainesfurt,Germany,973-818-8867,+1-109-429-8987x03818,sheri69@blanchard-burton.com,2022-03-29,http://www.woodward.com/
16-Mar-2021,IMPS,"146,825.60",00.00,"172,097.99",5d817Aba4f31b6E,5911,Cassie,Mullins,Shepard Ltd,Arthurbury,Burundi,588-399-3523x03858,107.301.7121,stanleypayne@bowen-guerrero.com,2022-01-16,http://www.preston-short.com/
16-Mar-2021,Reversal,00.00,"43,024.50","129,073.49",60ab0ee3E4F6714,5502,George,Macias,"Vaughan, Krause and Wilkerson",Singletonmouth,Mongolia,+1-621-912-2987,001-249-250-1870x026,lynnhopkins@ramsey-matthews.net,2020-10-02,http://khan-weber.com/
16-Mar-2021,IMPS,03.84,00.00,"129,077.33",DE662Ecaa7A0cbf,8336,Lindsey,Benson,Mccoy-Weeks,Hooperbury,Latvia,301.026.7927x189,(497)678-6161x3375,jaclynchase@rangel.com,2021-07-17,http://www.pruitt.com/
17-Mar-2021,Commission,00.00,"43,025.78","86,051.55",3C0B6CfFB73bdBC,8969,Tracie,Henderson,"Adams, Morrison and Benitez",Abbottborough,Brunei Darussalam,1332936881,4062764693,cristian06@greer.com,2022-03-15,http://www.joseph.info/
17-Mar-2021,Debit Card,00.00,"28,683.85","57,367.70",5daBFEe0FDD4aC1,209,Joel,Pearson,Castaneda Inc,New Chadport,Luxembourg,470-922-3685x36290,274.232.9857x729,jerrygates@garner.net,2022-01-13,https://burnett.com/
17-Mar-2021,Cheque,00.00,"19,122.57","38,245.13",EBf46DBa0d72C47,1603,Cristian,Stevenson,Gibbs Group,Port Xavier,Colombia,(644)040-6505,133-459-4871,jorgesampson@roach-hull.com,2020-05-19,https://barnett-reed.biz/
17-Mar-2021,Commission,00.00,"7,649.03","30,596.10",2e15e6Ea65AAcC3,367,Robert,Perry,"Hancock, Simpson and Faulkner",Danielsstad,Liberia,563-746-1695,964.893.5912x1370,romandeborah@carter.com,2022-04-09,http://villarreal.com/
17-Mar-2021,Interest,289.50,00.00,"30,885.60",84A596feF90a58a,4345,Steve,Lozano,Woods PLC,Ballstad,Ireland,440-629-1549,001-422-450-0505,yschneider@silva.com,2020-02-26,https://www.nichols.com/
17-Mar-2021,Transfer,"203,156.31",00.00,"234,041.91",abcBd0FbBcA2F4c,6958,Roger,Haney,"Wilkerson, Anthony and Hatfield",West Pamela,Lesotho,(337)094-5325x2413,814-355-2494x398,kathleen90@vaughn.com,2020-08-07,https://mullen.com/
17-Mar-2021,Reversal,00.00,"58,510.48","175,531.43",03069A40c583EfA,3341,Jordan,Ho,York Group,Hahntown,Hong Kong,(094)070-8496,001-961-124-0000,johnsonlouis@velez.net,2021-12-15,http://mills.com/
17-Mar-2021,Reversal,68.00,00.00,"175,599.43",bfc3B455Dd2f4bd,9089,Sophia,Schultz,Brooks and Sons,North Maureenchester,Afghanistan,355.104.4169x7569,370-557-8403x676,lucasweeks@carter.info,2021-10-04,http://www.hubbard.biz/
17-Mar-2021,NEFT,243.00,00.00,"175,842.43",Ed1eDdeecefEEa4,8279,Anne,Frank,"Nash, Bowen and Daniel",Port Virginiafort,Kuwait,(998)800-8203x486,(737)446-0048,starkjeremiah@michael.com,2020-12-01,https://tran-marquez.com/
17-Mar-2021,IMPS,"1,238.12",00.00,"177,080.55",1a1F80b3401c7aD,2007,Robyn,Acevedo,Cortez Inc,North Joannefurt,Kiribati,754.074.1462x29000,(005)062-3738,gallegospamela@travis-cannon.com,2020-05-24,https://www.sellers-salas.com/
17-Mar-2021,IMPS,00.00,"88,540.28","88,540.28",1b3eBF8F4dbBDa1,740,Jeffery,Snow,"Leach, Lam and Medina",Jillberg,Isle of Man,001-549-566-5006,+1-327-520-8770x14450,wcervantes@barron.info,2020-09-02,https://www.holt.com/
18-Mar-2021,Purchase,"14,760.61",00.00,"103,300.89",B0aab46eEFfCDC8,8873,Mckenzie,Salinas,Aguilar-Johnson,Berrychester,Japan,001-556-715-2581,001-120-667-0953x062,alexander17@casey.com,2022-03-11,https://mcguire.com/
18-Mar-2021,Cash,47.00,00.00,"103,347.89",E5e903Eb61ECcef,403,Elizabeth,Logan,Peck PLC,Geoffreymouth,Paraguay,633.088.3844,8980732697,kirkbradford@ibarra-bradford.info,2020-04-17,http://mueller-carpenter.com/
19-Mar-2021,Commission,"2,590.00",00.00,"105,937.89",5cfDaaDdD638E6f,7718,Courtney,Ingram,Phillips-Oliver,New Sheryl,Uganda,028.777.2909,(711)575-0955,powellcassandra@mckee-andrews.com,2022-03-03,https://swanson.com/
19-Mar-2021,Commission,00.00,"10,593.79","95,344.10",fDbB79FAB142707,36,Francis,Hubbard,Barron Group,West Makaylaton,Seychelles,+1-895-654-6918x3859,(182)766-9394x4641,savannah10@simpson.com,2021-03-17,https://www.velazquez-wright.com/
19-Mar-2021,Tax,"19,238.80",00.00,"114,582.90",8FD1fC4aDFaEA7c,9407,Alvin,Weber,Bartlett-Blankenship,Robintown,Mongolia,2878427621,001-692-667-9675x6845,albertbarron@brock-wilkinson.com,2022-05-17,http://berg.com/
19-Mar-2021,Debit Card,00.00,"22,916.58","91,666.32",b3828abFd5B904b,2913,Benjamin,Black,Church LLC,Lake Erikside,Latvia,(868)912-0340,001-253-652-3035x64428,ronnie25@arellano.com,2020-01-05,http://www.kaiser.org/
19-Mar-2021,Debit Card,"206,026.00",00.00,"297,692.32",4A1DaFdd15ecF6C,1619,Alan,Harrell,"Werner, Sparks and Harrell",Goodwinhaven,Senegal,7531543408,001-030-384-3274,feliciablake@oconnell.com,2021-09-30,https://www.rojas.com/
19-Mar-2021,RTGS,00.00,"297,692.32",00.00,d8FC702bB32a4ce,3960,Derrick,Koch,"Calderon, Vaughn and Clay",Joannashire,Ukraine,898-158-3507x75118,(829)266-1120,kristy66@kramer.net,2021-08-15,https://www.maddox-stein.info/
19-Mar-2021,ATM,"2,981.43",00.00,"2,981.43",efec3aAbf0dC3cA,7451,Martha,Larsen,Wall Group,Lake Amber,Lithuania,940-838-6567x568,+1-224-913-9496,dclark@krause.com,2021-08-02,http://figueroa-hall.biz/
19-Mar-2021,ATM,00.00,596.29,"2,385.14",B2cA2cdBf49E32C,2884,Monica,Wells,Greer-Davis,East Gabriellaborough,Monaco,076.613.8637,280-624-4638,harrellveronica@barker-romero.info,2021-08-15,https://www.graves.com/
19-Mar-2021,Bill,00.00,477.03,"1,908.11",9AA4c0bbAeEadf2,6786,Cassandra,Barnes,Cortez LLC,Edwardport,Palau,+1-482-413-7046x7213,6826624532,lmcintyre@alexander.org,2021-01-17,http://frost-aguirre.net/
19-Mar-2021,Commission,"104,278.80",00.00,"106,186.91",415cBaD5FCECaBf,6854,Glenda,Irwin,Hartman Group,South Kellitown,Fiji,533-155-7888,(865)032-1734,jenniferharmon@schultz.biz,2020-11-13,https://harrell.net/
19-Mar-2021,Transfer,00.00,"17,697.82","88,489.09",A9bCD0E9aFa006A,7693,Nathaniel,Morales,Poole Ltd,Elizabethchester,Niger,001-127-020-1953x2863,1550026650,dhodge@hunter-haley.biz,2021-09-23,http://www.daniels.biz/
19-Mar-2021,IMPS,157.04,00.00,"88,646.13",Fa9957b6BD6D87f,2739,Lawrence,Quinn,"Johnson, Dillon and Marsh",Gilberttown,Cayman Islands,(523)361-1325,(647)211-1913,xrandolph@wu-rivera.com,2020-08-19,https://nguyen-ingram.net/
19-Mar-2021,ATM,42.00,00.00,"88,688.13",cb8CdB9598A4BDb,5884,Whitney,Wyatt,"Owen, Dawson and Levy",West Taylortown,Micronesia,(572)978-5973x76260,(759)299-9953x865,rollinskarina@rich.com,2021-12-09,https://bender.com/
19-Mar-2021,NEFT,00.00,"9,854.24","78,833.89",Ff17C5290ADCc5C,4549,Sabrina,Barajas,Vaughn Inc,South Kyle,Yemen,(479)374-5020x24597,001-840-151-2675,hunterrhonda@curry.info,2021-05-23,https://www.cohen.com/
19-Mar-2021,Tax,33.80,00.00,"78,867.69",789edA5aD33dbF5,9652,Laurie,Atkinson,"Mcmillan, Ponce and Atkins",Bishopberg,Brazil,596.815.7422,(948)487-4761,dholloway@conrad.com,2020-01-30,http://kennedy-hardin.biz/
19-Mar-2021,Commission,"1,101.39",00.00,"79,969.08",bDD9F79E7D7E2d2,222,Carmen,Tyler,Hayes-Kelly,Daughertyfort,Liberia,(874)716-4853x19710,+1-493-529-1066x8598,obates@bennett-nicholson.net,2020-10-26,https://freeman-maddox.com/
19-Mar-2021,Purchase,00.00,"7,996.91","71,972.17",461F6f00930fC4c,583,Mason,Gaines,Mcknight-Townsend,West Deborah,Angola,+1-213-835-9799x0195,(704)387-6224,martinwade@macdonald.biz,2022-01-04,http://www.wilkinson.info/
19-Mar-2021,Cash,29.94,00.00,"72,002.11",F3Ab3D80D7212e9,8284,Meredith,Hoffman,Reid Inc,Pattersonmouth,Brunei Darussalam,321-824-5673x3627,+1-164-108-5404x574,taylorbeltran@nixon.org,2021-09-22,https://www.harrell.com/
19-Mar-2021,ATM,00.00,"8,000.23","64,001.88",7dddCD045de33Af,8287,Kristie,Pugh,Boyd-Weber,Meghanborough,Falkland Islands (Malvinas),+1-553-752-4134x02501,+1-097-687-5593,reginabennett@wolfe-huff.com,2022-04-13,https://moses.org/
19-Mar-2021,Debit Card,00.00,"10,666.98","53,334.90",7830fDDeB2394FD,7450,Gary,Pollard,Richards-Sosa,Candacefurt,Russian Federation,2312035566,467-115-8736x46087,billysantos@dawson.net,2021-04-11,https://www.english-moreno.info/
20-Mar-2021,Debit Card,00.00,"26,667.45","26,667.45",e1701dDc89cdDef,8736,Alexander,James,Goodman-Meyers,Lake Jane,Italy,352.377.9718x21501,145.815.9582x6612,tannermoore@cabrera.biz,2020-09-15,http://green.org/
20-Mar-2021,Commission,04.00,00.00,"26,671.45",59c712ACDf547d8,1880,Judith,Moyer,"Holt, Yang and Boyle",New Brianna,Central African Republic,691-349-8187x950,(531)732-7358x595,ale@massey.com,2021-02-12,http://daniel-bray.com/
20-Mar-2021,Debit Card,00.00,"6,667.86","20,003.59",fd2cEEB0A2DAca5,5372,Cody,Brock,Vaughan-Luna,South Terry,Jamaica,+1-244-071-9879x65702,017-512-9102,padillaalec@dean-rose.com,2021-01-17,https://www.vaughan-heath.com/
20-Mar-2021,Debit Card,00.00,"20,003.59",00.00,aB5C6b1Fd82bF1f,1822,Darren,Huynh,"Howard, Frye and Neal",Jimenezland,Andorra,+1-095-864-3551x4775,+1-119-925-6997x97182,kariarnold@valentine-underwood.net,2021-10-05,http://lester.info/
20-Mar-2021,Cheque,06.90,00.00,06.90,D8Fab80188CfBF2,2508,Lucas,Ball,Santiago and Sons,Savageport,Macedonia,213.311.7378,491-658-3861x045,judybeard@krueger.com,2021-05-02,http://kline.com/
20-Mar-2021,NEFT,00.00,01.15,05.75,DCFfe9Afb7c021E,2438,Andres,Mcclain,"Pruitt, Campos and Michael",North Charlotte,Tuvalu,(950)523-5640x859,215.140.3308,xmyers@forbes.info,2020-05-17,https://wu.biz/
20-Mar-2021,Debit Card,00.00,00.82,04.93,8d32c2fcD809843,2223,Earl,Mccormick,"Montoya, Hensley and Bush",Valerieville,Afghanistan,216-956-5845,001-799-776-5269x7242,cdunlap@woodward.com,2021-03-28,https://www.curtis.com/
20-Mar-2021,Transfer,"11,042.50",00.00,"11,047.43",E65bAC9F22075AC,290,Damon,Stanton,Joyce Inc,Rubenstad,New Zealand,(311)420-8154x573,+1-962-050-4131x01819,yesenia49@lester-martinez.com,2022-03-06,http://villegas.com/
20-Mar-2021,Debit Card,00.00,"1,380.93","9,666.50",C8026EDd92fA99A,2805,Jorge,Barron,Savage Group,Birdfurt,Korea,001-694-969-1879x0735,(819)756-4279,eholland@braun.com,2021-07-08,https://mccoy-ayers.com/
20-Mar-2021,RTGS,00.00,"2,416.63","7,249.88",980196D28cE27Ab,5651,Lorraine,Cochran,Wiggins-Shah,Alberttown,Thailand,+1-663-917-9102,5567946904,hector38@frey.org,2021-10-12,http://gay-weber.org/
20-Mar-2021,Commission,"242,687.00",00.00,"249,936.88",7e41faBf8d48e20,8514,Ray,Peck,Haynes-Barker,South Rodney,Sweden,436-199-0799x326,+1-103-258-3689x90463,ariel07@howell-velasquez.info,2020-09-30,http://fry.biz/
20-Mar-2021,IMPS,06.50,00.00,"249,943.38",fb6F888A84f87b0,6717,Lee,Burch,"Cortez, Martin and Christensen",New Spencer,Jamaica,170.328.3670,1156698760,jarvisalvin@bean-garcia.com,2020-02-20,https://www.atkinson.org/
20-Mar-2021,Commission,00.00,"62,485.85","187,457.54",40b6054b6AF1f65,5868,Joseph,Hughes,Wiggins Ltd,Kevinstad,Myanmar,+1-017-852-9854x7783,053-701-5277,lynnhodges@madden.info,2020-06-11,http://logan.info/
20-Mar-2021,IMPS,"25,885.63",00.00,"213,343.17",FccE8Bf3cecdBEb,175,Monique,Ewing,"Lester, Ayala and Harmon",East Maxborough,Antigua and Barbuda,972.635.8026,332.322.2094x970,evansstuart@griffin.org,2021-12-16,http://mata.com/
20-Mar-2021,Interest,00.00,"35,557.20","177,785.98",d7Aa0C4C34Ddcd3,1433,Alec,Norris,Stokes PLC,Harmonmouth,Malawi,6101512865,790-735-6172x815,summerwaters@mcneil.biz,2021-04-12,http://dougherty.biz/
20-Mar-2021,Reversal,"5,455.00",00.00,"183,240.98",bdd60975F95e13f,2224,Kari,Elliott,"Mckenzie, Chase and Ortega",Warrenbury,Turkmenistan,920-459-2372x04493,0131639868,scase@krueger-ali.com,2020-03-27,http://www.bray.com/
20-Mar-2021,Cash,01.70,00.00,"183,242.68",D85AE96aEfa3Aa2,7683,Alexander,Reese,"Ewing, Flynn and Hinton",North Michaela,Dominican Republic,+1-078-953-8185x0282,469.779.6977,salasclaire@moses-shaw.net,2020-12-20,https://www.hogan.net/
20-Mar-2021,Interest,"26,104.00",00.00,"209,346.68",FAa3224ddbdE48c,8314,Cameron,Olson,"Hobbs, Hartman and Graves",South Seth,Luxembourg,+1-931-097-3543,+1-477-067-7089x2613,karen91@huffman-montgomery.com,2022-02-12,https://jarvis.net/
20-Mar-2021,Cash,05.92,00.00,"209,352.60",f2d326a1FddBA4a,729,Crystal,Sullivan,"Andrade, Knox and Patterson",Calderonmouth,Jersey,(370)768-2554x17197,+1-602-780-4026x2313,mosshaley@benjamin.com,2020-06-27,https://meyer-harrell.com/
20-Mar-2021,Commission,07.00,00.00,"209,359.60",DaBB6acAeAa32CF,4473,Alisha,Goodwin,Griffin LLC,Adriantown,Lesotho,009-546-1023x23259,+1-448-494-0898x8507,whitakermolly@nelson-burton.biz,2021-01-12,https://bruce.com/
20-Mar-2021,Interest,"195,556.81",00.00,"404,916.41",759EEc69044a471,3833,Randall,Khan,Crawford LLC,West Erikaton,Montserrat,575-822-8821x241,(523)587-3579,kaitlincalderon@lawson.com,2020-02-09,https://www.joseph-hoffman.net/
20-Mar-2021,Commission,00.00,"44,990.71","359,925.70",4BDa2E785507F3A,1014,Tiffany,Gonzalez,"Jarvis, Garza and Zamora",North Jeanne,Paraguay,513-363-5589x576,001-484-199-3334,pbailey@whitaker.info,2022-01-12,https://www.lamb.org/
20-Mar-2021,NEFT,00.00,"359,925.70",00.00,8C755a6a73EBa00,4596,Vickie,Cabrera,Bailey and Sons,Port Marilyn,Djibouti,974-215-6764x5821,(107)001-0774,shahdominique@davila.org,2021-08-14,http://cummings-rangel.com/
20-Mar-2021,Purchase,"2,023,723.75",00.00,"2,023,723.75",d29Ed9CDdAa3CE2,8744,Rebekah,Velazquez,Goodwin PLC,Robertaside,Benin,181-767-3457x847,(210)341-7652x7668,steeleisaiah@buckley-bradford.com,2021-10-19,http://gallegos-winters.org/
20-Mar-2021,Purchase,00.00,"404,744.75","1,618,979.00",dBC2D8aB4c8687f,926,Glenda,Jefferson,"Wood, Powers and Lara",Melindaview,Uganda,623-710-8714x0128,+1-724-073-6403x8939,roachdiana@stewart.com,2020-11-13,https://www.hebert.com/
21-Mar-2021,RTGS,"20,972.80",00.00,"1,639,951.80",59f2ca9Fc663CDb,4003,Samuel,Turner,Odom-Conrad,Lake Jesse,Cameroon,(757)093-5050,426-546-1647x04275,jfischer@mays.org,2020-06-22,https://www.gay.com/
21-Mar-2021,Interest,00.00,"273,325.30","1,366,626.50",7B5E8BB7E53c7e8,8709,Brady,Haley,Atkinson-Newton,New Betty,Vanuatu,+1-315-628-5566x636,(499)620-9242,caroline04@blanchard-nichols.com,2021-06-10,https://gibson.com/
21-Mar-2021,Cheque,00.00,"136,662.65","1,229,963.85",8F2d72f11fed8e9,4316,Kendra,Nixon,Hanna-Simpson,Tylerchester,Bouvet Island (Bouvetoya),(805)153-6547x509,613.117.2177x01653,bryan51@espinoza.com,2020-05-31,http://rodgers.com/
21-Mar-2021,Cheque,"22,035.90",00.00,"1,251,999.75",73B9332DFa56A53,5802,Joyce,Gillespie,"House, Cherry and Villarreal",East Beverly,Central African Republic,057.025.8945x209,589-302-6922x0375,nicholsmarc@anthony-anderson.com,2021-11-13,https://www.tucker-case.com/
21-Mar-2021,Cheque,00.00,"417,333.25","834,666.50",21F0e2D2d85492F,8883,Monique,Underwood,Boyer-Cline,Hicksberg,Lebanon,(310)099-4843x68452,862.771.6694,bmeyer@norman-olsen.info,2021-04-18,http://kemp-berg.com/
21-Mar-2021,ATM,03.00,00.00,"834,669.50",Cc34F6F64D48BDF,1170,Ashlee,Escobar,"Garrison, Mathis and Glass",Cindyberg,Sri Lanka,001-126-163-4317x834,284.493.1105x586,terri64@mcclain.com,2021-01-02,https://www.oneill.com/
21-Mar-2021,Cash,00.00,"83,466.95","751,202.55",87D7420354C5dC0,2265,Ricardo,Jones,"Jefferson, Moon and Hogan",Lake Stacy,Korea,(560)462-2868x0863,(497)197-0764x697,vcox@medina-daugherty.com,2022-05-02,https://www.glass.com/
21-Mar-2021,IMPS,00.00,"93,900.32","657,302.23",Dbb6DB99b9bE2bB,9123,Earl,Byrd,Boyle PLC,Marshton,Mexico,324.731.1267x6051,+1-571-637-7662x216,russoglenn@burch.com,2021-04-28,http://dorsey-ramsey.com/
21-Mar-2021,Interest,459.18,00.00,"657,761.41",FC4aEcDd7b0Fd2e,8179,Jamie,Vaughan,"Clark, Horn and Buchanan",Vangburgh,Haiti,001-376-074-1501,403.939.7618,vvasquez@newman.com,2021-02-25,https://rowland.org/
21-Mar-2021,Reversal,467.80,00.00,"658,229.21",C97be4d67E65AAE,8321,Eddie,Manning,Mathews-Powell,North Kristiberg,Sri Lanka,(774)519-3561x5780,(540)652-0161x20220,gabriella88@wolf-carey.com,2021-08-29,https://www.walls-sosa.org/
21-Mar-2021,Debit Card,00.00,"82,278.65","575,950.56",8d8Ec265ba4BBDC,6543,Lorraine,Franco,Cook PLC,New Antoniochester,Pakistan,(830)506-2373x15662,(382)010-8280x7467,isharp@lee.com,2021-05-30,https://www.johnson.com/
21-Mar-2021,Cheque,00.00,"57,595.06","518,355.50",533e78d7a02026D,7126,Brady,Morris,Church Group,West Erikville,Mayotte,001-804-189-6214x32790,122.804.8582,newing@dawson.com,2020-08-30,http://orozco.org/
21-Mar-2021,Miscellaneous,03.70,00.00,"518,359.20",abF564950aaddbE,4770,Jocelyn,Buchanan,Munoz-Macias,Lake Perrymouth,Honduras,001-202-160-8632x8457,705-444-2110,byrdkim@guerrero.com,2020-04-22,https://www.lyons-baker.info/
21-Mar-2021,ATM,"1,720,812.00",00.00,"2,239,171.20",4d2D54679321f8c,243,Brenda,Hale,Mcguire PLC,Mitchelltown,Marshall Islands,828.109.2056,799.626.7815,romeroangie@cunningham.org,2021-01-26,https://www.jennings-mann.com/
21-Mar-2021,Miscellaneous,00.00,"373,195.20","1,865,976.00",abf0e9d1e30dBAD,9820,Isaac,Gonzalez,"Banks, Houston and Charles",Roychester,Ecuador,2570815450,5604370308,michealmatthews@rose.com,2022-01-28,http://galvan.biz/
21-Mar-2021,Commission,39.65,00.00,"1,866,015.65",80a6ab7D70a4eE4,6988,Jake,Luna,"Gordon, Thomas and Dyer",Stacieshire,Central African Republic,+1-064-940-3352x92364,(311)831-2679x951,yucole@mcintosh.biz,2020-05-16,https://mueller.com/
21-Mar-2021,Miscellaneous,07.00,00.00,"1,866,022.65",df5Ab2754F1eCf7,8753,Rhonda,Hartman,Fuller-Maynard,Alecville,United Arab Emirates,(264)095-7033x566,198-586-2788x38355,brett46@flowers-delacruz.biz,2020-01-21,https://frederick-zimmerman.biz/
21-Mar-2021,NEFT,12.80,00.00,"1,866,035.45",cDfED45AbC51c95,5691,Isabel,Tapia,"Marshall, Barry and French",Diamondberg,Holy See (Vatican City State),001-900-283-6448x0267,931.096.3032x21862,grossantonio@cross-li.biz,2022-03-10,https://www.castaneda-zamora.com/
21-Mar-2021,Debit Card,02.40,00.00,"1,866,037.85",071FB5bDeddED3e,1089,Cassie,Esparza,Hurley Ltd,South Isaac,Hungary,(836)106-7704x0781,(047)009-4396x7867,ekirk@velazquez.com,2022-05-05,https://skinner.net/
21-Mar-2021,Purchase,06.20,00.00,"1,866,044.05",8c1DffF9a631Cdf,866,Johnathan,Ramos,Raymond-Briggs,North Melaniestad,Congo,+1-538-403-4687x0089,(215)672-1531,jmorton@huff.com,2020-02-25,http://parsons.info/
21-Mar-2021,NEFT,"15,448.00",00.00,"1,881,492.05",Fbb4AA4EA3c51EB,2585,Sierra,Lindsey,Mccann-Wang,Gwendolyntown,Antigua and Barbuda,(634)268-2108x132,001-061-518-9703x711,donaldsonvictor@velez-watson.com,2020-04-26,http://www.bolton.biz/
21-Mar-2021,IMPS,00.00,"235,186.51","1,646,305.54",b9F6dc01e846C96,7536,Carla,Hays,Higgins Ltd,South Kristy,Sierra Leone,158.535.0644x208,+1-294-317-2899,allisoncobb@neal.com,2020-07-02,https://www.howard.com/
21-Mar-2021,Miscellaneous,00.00,"329,261.11","1,317,044.43",AAE28ef5F5a74dE,9689,Sherry,Clay,Nichols LLC,Bentleyland,Martinique,001-809-463-5508x4269,489-170-0639,ebryant@rivera-oconnor.com,2021-08-16,https://hughes.biz/
21-Mar-2021,NEFT,"186,400.44",00.00,"1,503,444.87",DA5BD64f6aaE4C6,9530,Leroy,Russo,"Boone, Daniel and Carter",Stuarthaven,Bosnia and Herzegovina,+1-198-501-9622x2102,047.259.5628,eduardoday@velez.biz,2020-07-30,https://www.fletcher.net/
21-Mar-2021,Purchase,60.60,00.00,"1,503,505.47",aB41dba4eFFe03A,2916,Aimee,Wall,Melendez-Tyler,Whitneytown,Angola,520-829-3466x8250,2652638031,cantukirsten@bond-goodman.biz,2020-11-01,https://www.zimmerman.biz/
21-Mar-2021,Cash,00.00,"167,056.16","1,336,449.31",8b09D387cfcA249,5403,Frederick,Beltran,Chen-Thomas,Gatesside,Antigua and Barbuda,(417)390-6854x3623,508.297.9994x106,bonnieguzman@booker.com,2020-12-06,https://www.woodward-archer.info/
21-Mar-2021,IMPS,00.00,"1,336,449.31",00.00,7FEFeffbdA756AB,5863,Chad,Moody,Velazquez-Hall,Chandlerport,Luxembourg,001-161-191-1616,(393)674-9296x79404,garciajoanne@snow.com,2021-02-20,http://www.christian-chung.com/
21-Mar-2021,IMPS,"106,928.00",00.00,"106,928.00",3Fa1C1c98cCC3bA,8391,Margaret,Coleman,Vaughn-Meza,East Marciashire,Lebanon,067-424-9888,510.050.8826,kellivasquez@buckley.org,2022-05-14,http://bass-hatfield.com/
21-Mar-2021,IMPS,00.00,"26,732.00","80,196.00",A7734c4626ab39e,9784,Kristen,Clark,"Pierce, Dillon and Rubio",East Clayton,Trinidad and Tobago,191.482.5890x9523,(000)577-1550,drakealexis@yang.com,2021-02-23,http://knight.com/
21-Mar-2021,Commission,"967,512.00",00.00,"1,047,708.00",1b48De1F0bBB4bf,9968,Rachel,Kramer,Park LLC,Lake Isabel,Central African Republic,952-653-5624x436,702.138.3889,montesjean@vincent.com,2020-07-10,https://neal.com/
21-Mar-2021,IMPS,00.00,"174,618.00","873,090.00",30Ffff3C9Cdea0d,8708,Jaime,Allison,Winters-Bruce,Port Karinaburgh,Palestinian Territory,874.570.1802x2775,001-772-960-1204x673,haley47@petty.com,2021-09-16,http://atkins.com/
21-Mar-2021,ATM,02.60,00.00,"873,092.60",6931B4824A554eF,5579,Haley,Decker,Leach-Griffith,West Toni,Fiji,781-410-0982x611,001-901-061-7982x8181,annettecervantes@jennings.biz,2020-09-01,http://www.leach-mays.info/
21-Mar-2021,Cash,00.00,"873,092.60",00.00,59D851a0E7Cb5a5,4235,Ariel,Williamson,Chan Ltd,Port Krista,Myanmar,+1-737-160-2476,+1-744-838-0316x3168,edgar76@garrison.com,2020-08-20,http://arnold-marshall.com/
21-Mar-2021,NEFT,03.07,00.00,03.07,b07424e5EeC73cD,1693,Cole,Rollins,"Wiley, Wiley and Townsend",West Daniel,Vietnam,322.131.5486x62409,+1-479-787-8360,barnettkristin@livingston.com,2022-03-21,http://www.pollard.net/
21-Mar-2021,Purchase,"14,315.86",00.00,"14,318.93",4fA018fb372a8EF,2355,Ryan,Bradford,Bennett-Mcfarland,Lake Yvette,Macao,001-998-883-6818x3196,+1-063-013-0220x82289,haneysonia@petersen.info,2021-03-27,https://www.benitez-chavez.com/
21-Mar-2021,Tax,"16,053.30",00.00,"30,372.23",D612caeb8FfE25A,8793,Darrell,Mclean,"Leblanc, Pope and Baxter",Riosfort,Luxembourg,001-194-295-7386x500,001-629-917-1811x203,riosbenjamin@richards.com,2021-10-04,https://www.cross-sanchez.com/
21-Mar-2021,Purchase,00.00,"4,338.89","26,033.34",E9fbc4E7D57E61E,5600,Jorge,Weaver,Rivas-Arias,Graytown,Uzbekistan,+1-944-231-8118x85897,423-066-7880x399,jenny70@lin.com,2021-10-17,https://macias.info/
21-Mar-2021,Transfer,07.40,00.00,"26,040.74",18EC22b40be4f24,8030,Isabel,Humphrey,Vance-Ford,West Kathryn,Russian Federation,089-851-2862x322,9737557872,curtisalexandra@vasquez.com,2020-09-22,http://www.bender.org/
21-Mar-2021,RTGS,00.00,"8,680.25","17,360.49",1eaF40D3aDb4551,2266,Rachael,Carrillo,Flynn Inc,Rickyberg,Falkland Islands (Malvinas),(058)336-2304,(507)354-5160x41864,warrencoleman@compton.com,2021-08-14,https://daniels.com/
21-Mar-2021,RTGS,00.00,"1,928.94","15,431.55",9Cfc61ebC5682F2,296,Kelsey,Rowland,"Russell, Oconnell and Merritt",Port Jakeside,Antarctica (the territory South of 60 deg S),+1-969-804-4669,4522340902,stacybradford@callahan-powers.com,2022-01-13,http://www.ortiz.com/
21-Mar-2021,Bill,00.00,"15,431.55",00.00,1BAebBabfCAC2Db,7885,Geoffrey,Landry,Pace LLC,Port Triciaberg,Saint Martin,937-421-0377,001-728-843-3142,martin55@bautista.com,2022-02-14,http://peterson.com/
21-Mar-2021,Reversal,20.30,00.00,20.30,08d66aDFB76fD38,5438,Rickey,Lozano,"Hickman, Mora and Blevins",Port Kellie,Dominica,549-338-7586,123.609.7943x661,glassjorge@knox-mendoza.info,2020-07-15,https://www.berger.com/
21-Mar-2021,RTGS,00.00,05.08,15.23,cb20Bc1E6D661a3,968,Mindy,Rivers,"Mercer, Ware and Bridges",Dylanville,Cape Verde,001-432-758-7386,126.403.7916x684,patricksteven@mcintyre.org,2021-12-04,http://www.steele.biz/
21-Mar-2021,Reversal,00.00,01.69,13.54,8F2d72f11fed8e9,4316,Kendra,Nixon,Hanna-Simpson,Tylerchester,Bouvet Island (Bouvetoya),(805)153-6547x509,613.117.2177x01653,bryan51@espinoza.com,2020-05-31,http://rodgers.com/
21-Mar-2021,Bill,"3,120.00",00.00,"3,133.54",caCCF49FD7bBaAA,8617,Shelby,Pacheco,"Meyers, Gonzalez and Hernandez",East Sharonstad,Uruguay,860-273-2972x94264,3291568396,jaclynthompson@frye.com,2021-07-01,http://rivera-green.info/
21-Mar-2021,Commission,"9,083.10",00.00,"12,216.64",BF36aD39120af56,4168,Willie,Cobb,Baker and Sons,Lake Marilynhaven,Moldova,001-679-544-5482x07009,001-825-610-3891x00042,thomascox@anthony-webster.com,2021-01-13,http://wilkins.org/
21-Mar-2021,Commission,00.00,"1,527.08","10,689.56",D699d92E5Fd7f3F,2452,Dominic,Serrano,Hickman-Galloway,Candaceburgh,Argentina,+1-059-471-6933x4684,+1-862-055-5815x53198,prandolph@alvarez.com,2020-12-13,http://www.mcclain-lang.com/
21-Mar-2021,Cheque,00.00,"1,781.59","8,907.97",3F6df9C42AAD5E1,4507,Samantha,Whitehead,"Shelton, Booker and Morales",Riggsburgh,Mexico,283.215.7200x7282,+1-448-131-8298x6715,ericksonmakayla@acosta.org,2022-05-03,https://harrington.com/
21-Mar-2021,RTGS,00.00,"2,969.32","5,938.65",cE26d5BBEc5aeeE,1834,Austin,Knight,Walter-Espinoza,Sheriville,Kazakhstan,+1-994-436-6664x6190,+1-716-520-9719x1785,herbert33@keller-morrow.org,2021-09-29,http://saunders.com/
21-Mar-2021,Bill,00.00,"1,187.73","4,750.92",A976D0fe6C4c4ec,6320,Hailey,Washington,Coleman PLC,Tommyborough,Belize,855.592.2004x9865,+1-698-198-6426x66973,faulknerkellie@chandler.com,2020-02-11,http://williamson.com/
21-Mar-2021,Cash,07.64,00.00,"4,758.56",6Aa2fe3Fd6Bc75c,9640,Terry,Schmitt,"Murillo, Steele and Robinson",West Corey,Morocco,655.185.4098x1006,480.825.0857,spencekerri@rose.com,2022-02-13,https://www.mccann.info/
21-Mar-2021,Interest,42.70,00.00,"4,801.26",7FAbeEEC1b8549B,8023,Stacie,Ball,Dunn-Ellison,Port Bethberg,Portugal,037.081.2034x300,278.327.8687x233,nwerner@moon.com,2020-02-16,http://www.golden-newton.info/
21-Mar-2021,RTGS,"3,014.00",00.00,"7,815.26",deCee1d8035D612,862,Gregg,Golden,"Stark, Pace and Fernandez",Coltonville,Liechtenstein,+1-898-361-3070x329,001-432-199-7893x4363,eugene22@lamb-thomas.com,2021-10-04,https://www.velazquez.info/
21-Mar-2021,Debit Card,08.00,00.00,"7,823.26",3Df3edCA4c98abD,9971,Shelley,Raymond,Holden and Sons,Port Jennybury,Ecuador,001-840-8597x3036,0045134154,caitlin15@rollins.com,2022-05-29,http://chapman.com/
21-Mar-2021,Debit Card,00.00,782.33,"7,040.93",BBfD2d0dE8a7fe9,9079,Sylvia,Maynard,"Garrett, Giles and Townsend",Ellenburgh,United Arab Emirates,093-728-5767x4339,456-425-3027x0379,jackson92@mora.info,2020-11-29,https://www.riley.org/
21-Mar-2021,IMPS,53.18,00.00,"7,094.11",e95f3f6AEC593b3,886,Joyce,Salas,"Sutton, Harrington and Hodge",Samuelside,Bermuda,535.459.2911x5791,(946)201-8782x937,jose29@alvarez.com,2020-04-04,https://richardson-abbott.com/
21-Mar-2021,Bill,00.00,"2,364.70","4,729.41",0D4b7E6Adc3c85A,5948,Phillip,Keller,"Wood, Carroll and Melton",North Kiara,Egypt,331.842.1411x54381,(321)546-8045x228,livicki@frey.org,2020-06-10,http://walter.net/
21-Mar-2021,Cheque,07.00,00.00,"4,736.41",eaaBfa86a5c3F3D,6926,Tracey,Levine,Ferguson Ltd,Schneiderchester,Holy See (Vatican City State),(535)842-7173,001-649-748-9555x8755,dwayne08@dennis.org,2022-04-24,http://johnson.net/
21-Mar-2021,Bill,"942,153.00",00.00,"946,889.41",9aD8552188B0FCc,2009,Sally,Brown,"Underwood, Zavala and Baker",Floydstad,Kazakhstan,(298)370-0672x84793,9472010514,andreschultz@howe-flowers.biz,2020-10-08,http://www.giles.com/
21-Mar-2021,Cheque,00.00,"315,629.80","631,259.61",cCdaaCEff7ab4a0,1818,Timothy,Shaffer,"Mullins, Cisneros and Boyd",West Jesus,Wallis and Futuna,001-686-209-7368x12737,+1-117-660-4653,laneandres@gilbert.com,2020-02-12,http://www.wilcox.com/
21-Mar-2021,IMPS,05.00,00.00,"631,264.61",51eDcd67bAcaF0B,5512,Hailey,Murphy,Reed-Mcclain,Bryanside,Lao People's Democratic Republic,0304982075,202-099-2517x45176,warddennis@alvarado.com,2021-09-25,http://cox.biz/
21-Mar-2021,ATM,39.16,00.00,"631,303.77",4ED2328ed5B6Df0,4715,Colleen,Webster,Holder Inc,Port Preston,El Salvador,+1-253-934-2791x47867,502.096.9230x125,ericksonjuan@sampson.org,2021-01-07,http://briggs-rodgers.net/
21-Mar-2021,RTGS,"169,195.00",00.00,"800,498.77",C95a2de9dFF4deD,3652,Kristy,Reyes,Figueroa-Tran,Lake Faith,Tokelau,+1-594-344-4775,001-093-497-0068x119,tiffanymendoza@austin.com,2021-01-07,https://www.huff.biz/
21-Mar-2021,Commission,00.00,"800,498.77",00.00,feCbBEcbFDfEFde,6015,Bianca,Lucero,Perez-Hardy,New Emily,Namibia,001-778-462-8511,865-490-7424x356,haleypayne@lambert.biz,2021-03-04,http://jarvis.net/
21-Mar-2021,Commission,"197,580.16",00.00,"197,580.16",7951fEB618E8eaE,4683,Alexander,Conley,Harrington-Terrell,Port Omar,American Samoa,726.252.6748x881,(503)291-7365x44598,valenzueladakota@ponce.info,2021-07-06,http://kent.com/
21-Mar-2021,Cheque,385.23,00.00,"197,965.39",acdFD08C5cBA6CA,352,Guy,Brennan,"Larson, Joseph and Richard",New Amandamouth,Trinidad and Tobago,030.070.7384,+1-415-226-5597,angieosborne@michael-simon.com,2020-05-06,http://hubbard.org/
21-Mar-2021,Commission,00.00,"39,593.08","158,372.31",F4EcE1A45d9F8a7,5925,Briana,Bond,Holloway-Calhoun,Deborahstad,Lao People's Democratic Republic,001-063-160-5412x537,(604)961-4328x489,payneneil@patton-bond.info,2022-03-03,https://www.carson-hooper.com/
21-Mar-2021,Cheque,76.00,00.00,"158,448.31",7C81C2daAAAaaC8,4594,Loretta,Ramsey,Leonard-Hall,Burgesston,Moldova,978-272-2550x19043,+1-945-603-3380,barrkeith@cantrell.org,2021-11-24,http://www.calderon.com/
21-Mar-2021,Bill,00.00,"15,844.83","142,603.48",E2ccCe0b3fbCBfd,8481,Joanne,Walter,"Khan, Henson and Hester",West Yvette,Yemen,415.548.2919,502-631-3887x6551,rebeccaatkinson@mcclure.com,2022-03-12,https://hoover.com/
21-Mar-2021,RTGS,01.40,00.00,"142,604.88",adEe026b1Cd00dF,1409,Donna,Anthony,Morton LLC,New Ashleyfort,Comoros,001-285-987-4114x00714,+1-621-243-5087x23670,yujasmin@armstrong.net,2022-02-08,https://reese-nguyen.com/
21-Mar-2021,Transfer,"34,156.22",00.00,"176,761.10",B25B0d4Fe18aBaF,5260,Valerie,Salinas,Montes Inc,North Rebecca,Ecuador,556.816.2235,001-399-480-1899x054,knightclaudia@mcgee-carr.net,2020-10-05,https://sanders.com/
21-Mar-2021,NEFT,05.00,00.00,"176,766.10",2A4AE5dE3fbfAE6,1664,Ashlee,Dixon,Reese Ltd,Mcmahonborough,American Samoa,001-674-243-7422x57501,001-078-052-4654,jorgenewman@bullock-welch.com,2020-09-07,https://www.boyle-berry.com/
21-Mar-2021,Debit Card,05.90,00.00,"176,772.00",8Cc44Fae8a4D395,460,Bryan,Odom,"Taylor, Solomon and Wolfe",South Luisside,Chile,094-007-9536x806,001-965-266-5591x622,gillespienorma@cline-boyd.org,2022-05-09,https://schwartz.com/
21-Mar-2021,Commission,00.00,"22,096.50","154,675.50",1F0A8a9DAc5bFB2,1028,Amanda,Kramer,Combs-Frost,South Kaitlyn,China,754.775.5016x24107,(024)751-6902x317,laneconnor@daugherty.com,2021-10-19,https://flynn.com/
21-Mar-2021,Reversal,"3,200.20",00.00,"157,875.70",f9e8aeAcd5c0fbC,2573,Jermaine,Bruce,Hardy-Stevenson,East Emily,Kiribati,001-983-651-2469x51535,893-343-2826,shieldsderrick@thomas.org,2022-04-12,http://www.bennett.org/
21-Mar-2021,ATM,02.40,00.00,"157,878.10",bbE1DDC7F7BbfDf,2529,Sandra,Burnett,Mills and Sons,Kurtburgh,Bhutan,+1-232-303-7107x78994,923.066.3441x280,carol05@blevins-spears.org,2021-03-30,http://rosales.com/
21-Mar-2021,Cheque,841.90,00.00,"158,720.00",C7cecB4891C117B,1349,Marilyn,Reynolds,Keller-Dawson,Townsendland,Hungary,(688)439-8804x1225,012.065.5147x3211,muelleradriana@clements-colon.com,2021-08-08,http://leblanc.com/
21-Mar-2021,Interest,00.00,"17,635.56","141,084.44",EB18eb1ccDbAe7C,7807,Marilyn,Bruce,Luna Ltd,Schultzborough,Tuvalu,576-902-8941x685,233.577.3812,jerry23@cantrell.info,2020-08-12,http://www.arroyo.com/
21-Mar-2021,IMPS,"27,079.60",00.00,"168,164.04",6490BbA8b281EE5,923,Jason,Solis,Gordon-Smith,East Hollystad,Finland,(706)024-5066,637.191.8104x9661,slucas@bates-davenport.com,2022-05-12,https://king-lin.com/
21-Mar-2021,Interest,00.00,"33,632.81","134,531.23",d575c37CAD9B3D1,2804,Harold,Carlson,Meza Group,Lake Tashaborough,Zimbabwe,+1-818-748-6059x7404,752.731.8428x0924,sandovalmary@woodward.com,2020-12-19,https://lowe-matthews.com/
21-Mar-2021,Reversal,00.00,"26,906.25","107,624.98",AE3e9B1BB54acEc,6746,Blake,Carter,Mcbride and Sons,Farrellton,Albania,094.095.1970,(823)990-7426x95617,juliarichardson@welch.com,2020-01-28,http://braun.com/
21-Mar-2021,Bill,00.00,"15,375.00","92,249.98",f97fBDfE34Dd016,5094,Zachary,Thompson,Dorsey LLC,Duartestad,Svalbard & Jan Mayen Islands,001-174-384-6004x2990,671-189-5673x94327,christie05@morton.com,2021-06-09,http://www.hancock.info/
21-Mar-2021,Miscellaneous,00.00,"15,375.00","76,874.98",FE7E7fDb64CFb85,6045,Gregg,Turner,"Oconnell, Ingram and Higgins",New William,Aruba,001-650-863-6115x22914,263-932-9436,rpeck@mccormick.com,2021-08-25,http://www.nixon-hodges.com/
21-Mar-2021,Cheque,00.00,"9,609.37","67,265.61",72f2A068476dab3,3085,Stanley,Franklin,Watkins Inc,Zhanghaven,Guyana,611.548.5912x752,9073529330,hcallahan@graham.com,2020-04-06,http://mcmillan.net/
21-Mar-2021,Purchase,00.00,"16,816.40","50,449.21",5ac476d798a9EE1,7242,Megan,Robinson,Mills Inc,North Bryce,Serbia,575.089.1288,(507)636-6186x4214,dcrawford@cisneros-daniels.org,2021-12-07,http://love-chung.com/
21-Mar-2021,Miscellaneous,00.00,"5,044.92","45,404.29",4a871A219b5c53a,4634,Linda,Roman,Bautista Group,Lake Lydia,Uruguay,001-147-660-9783x33511,001-760-039-2941,fmaxwell@small.org,2020-08-09,https://frazier.com/
21-Mar-2021,ATM,"14,187.71",00.00,"59,592.00",0D7EED0fe233832,6034,Cristian,Case,Grant Inc,North Dylan,Georgia,(207)566-6619,001-566-521-2020x11058,hollygonzales@leach-parrish.com,2021-09-24,https://www.russo.com/
21-Mar-2021,RTGS,00.00,"6,621.33","52,970.67",A1BFe00dDF12a4D,8021,Earl,Porter,"Leblanc, Proctor and Davenport",East Brittney,French Polynesia,+1-633-569-7880x3824,773.751.5881,monroestanley@callahan.com,2021-04-26,http://avila.biz/
21-Mar-2021,Interest,00.00,"8,828.45","44,142.22",fd57BCF8fe82eaf,7037,Kari,Lane,Mathis Ltd,West Mariah,French Southern Territories,001-293-351-1425,196.219.5653,tim02@gilmore-fleming.com,2020-03-19,http://decker-barton.com/
21-Mar-2021,Transfer,00.00,"8,828.44","35,313.78",81aec2a9e2DD5C7,7134,Raymond,Riley,"Richards, Bullock and Steele",Sarahfurt,Cook Islands,804.811.3305,662.747.3260,courtneyliu@vega.com,2021-03-17,http://moreno.com/
21-Mar-2021,IMPS,503.00,00.00,"35,816.78",14d0Ceb5ABA990C,4360,Timothy,Fletcher,Underwood-Schmitt,South Jeremiah,Montenegro,(689)382-1369x83146,001-292-440-3061x8173,wandadecker@montes.info,2021-06-23,http://www.robbins.biz/
21-Mar-2021,Tax,00.00,"3,581.68","32,235.10",A61Fe3B9a6Ddb77,1125,Richard,Soto,Diaz-Nunez,Darrellstad,Pitcairn Islands,001-723-512-6897x7874,+1-923-944-2258x5434,angela47@wang-klein.com,2020-06-19,https://fleming.com/
21-Mar-2021,Cash,00.00,"6,447.02","25,788.08",ab01e15Ca204bE8,1843,Kathy,Hester,Cruz-Leach,Lake Harryburgh,Jamaica,214.230.7711x0244,975.842.4979,nicholsshelley@smith.com,2022-01-29,https://elliott.net/
21-Mar-2021,IMPS,00.00,"8,596.03","17,192.05",EaF880AfB58bb2D,7250,Peggy,Blankenship,Greer and Sons,Lake Lindseyburgh,Eritrea,493-459-3330x7742,+1-210-782-2664,erinjoseph@tran.biz,2021-11-30,http://www.pope.com/
21-Mar-2021,Bill,00.00,"1,910.23","15,281.82",67A22a0b165A0e5,8277,Tom,Clements,Velasquez PLC,Normaside,Guatemala,5249985504,726.092.9208x028,craigpeck@davies.biz,2020-11-30,https://www.taylor.com/
21-Mar-2021,Debit Card,25.97,00.00,"15,307.79",ba71bf712Ba06B3,9158,Jody,Odom,Mooney-Ali,Lake Caseyburgh,Solomon Islands,329-025-9011x3344,107.375.8234x93258,joanne71@payne.com,2020-05-08,http://leblanc.net/
21-Mar-2021,Cash,"159,103.20",00.00,"174,410.99",248DFBD21eC1f73,450,Anne,Harper,Stevenson and Sons,Pruittfurt,Bhutan,246-514-2503x293,+1-720-685-6422x6584,josedudley@andersen.com,2021-04-03,https://walls.com/
21-Mar-2021,Miscellaneous,"870,771.00",00.00,"1,045,181.99",D0cc89bac5fA9bB,1146,Briana,Chaney,Mcconnell-Kidd,West Tanyafurt,Ethiopia,(281)138-8576x11080,909-746-1999x53242,sknapp@trujillo.biz,2022-04-11,http://avery.com/
21-Mar-2021,Commission,"1,571,623.00",00.00,"2,616,804.99",16e30af2efbd892,5559,Neil,Castro,Perry LLC,Kimborough,Hungary,+1-838-474-6768x6751,789.948.2000x10108,inorris@crane.com,2020-10-03,https://www.floyd.com/
21-Mar-2021,Cheque,"1,627.01",00.00,"2,618,432.00",Eaed4Bc2AfcE20a,3695,Lori,King,"Carson, Trevino and Fox",Lake Kelseyfort,Senegal,+1-702-656-6599,+1-314-880-5329x734,llindsey@decker-cervantes.org,2021-02-06,https://www.decker.com/
21-Mar-2021,Miscellaneous,00.00,"261,843.20","2,356,588.80",44E59772aa1c5D3,3653,Cristian,Barrera,"Gibbs, Dominguez and Wu",East Randy,Taiwan,5118080190,+1-096-696-1085x20227,jpatrick@skinner-willis.info,2022-01-18,http://hayes.biz/
21-Mar-2021,IMPS,00.00,"392,764.80","1,963,824.00",137Bd9E1Ad1c174,8382,Jeffrey,Dillon,Allen and Sons,Port Terrence,Vanuatu,(405)030-2982,+1-224-043-5731x434,robertenglish@bean.com,2021-03-29,https://fleming-hickman.org/
21-Mar-2021,Commission,"1,738.24",00.00,"1,965,562.24",9B13Eb7a280B7E9,1010,Kelsey,Colon,Andrade-Sawyer,Lesterfort,Indonesia,+1-990-015-4214x4165,001-270-221-6376x1125,oowens@valenzuela.biz,2020-10-14,http://hickman.com/
21-Mar-2021,RTGS,"65,387.94",00.00,"2,030,950.18",F196D46EbfbA82f,3711,Riley,Dickson,Logan-Chambers,Port Shelly,Uzbekistan,526-837-9911,001-643-608-3302x3445,tracey47@ayala.com,2020-11-26,http://www.glover.com/
21-Mar-2021,Transfer,"193,588.00",00.00,"2,224,538.18",0DD78d08BBa5D6F,6845,Edgar,Wade,Faulkner and Sons,Micheleville,Saint Helena,035.234.0494,390-544-3643x2426,tomjarvis@calderon.com,2021-11-22,http://bond.com/
21-Mar-2021,RTGS,00.00,"1,112,269.09","1,112,269.09",AE98f1BE147e71A,5791,Colleen,Stout,Cox-Carrillo,North Eduardotown,Northern Mariana Islands,+1-696-276-4146x32966,4552936437,devin36@lambert.com,2020-11-04,http://www.wilkerson.info/
21-Mar-2021,Debit Card,"168,910.00",00.00,"1,281,179.09",3B2e81d930d1AE3,608,Elizabeth,Casey,Ochoa Ltd,West Williamview,Namibia,+1-201-703-4225x834,+1-992-562-2917x01075,lutzkrista@boyd-braun.com,2022-03-14,https://neal.org/
21-Mar-2021,Interest,00.00,"128,117.91","1,153,061.18",6F0ef7D7Cf8D80D,788,Peggy,Cuevas,"Potts, Gay and Cooper",Lake Duane,Serbia,1281190354,(222)230-6793x2498,alexandraolson@serrano.com,2021-11-25,http://www.deleon.com/
21-Mar-2021,Miscellaneous,"142,860.00",00.00,"1,295,921.18",4D7FAdF824CaCa8,3811,Tami,Harrell,"Randall, Marquez and Mcgee",Bobbyside,Cote d'Ivoire,789.921.8792,(875)321-6055x27241,karileonard@hobbs-harmon.com,2022-03-12,http://estes.com/
21-Mar-2021,Interest,00.00,"647,960.59","647,960.59",4b67bfFCAe4853A,1283,Mathew,Proctor,Mcneil Ltd,Hoshire,Sri Lanka,(847)740-0284,(099)798-3345x631,pconrad@hendricks-frye.com,2020-03-11,http://www.carson.info/
21-Mar-2021,NEFT,00.00,"129,592.12","518,368.47",B9515B4Ed7cEa0f,6367,Rebecca,Douglas,"Holder, Compton and Flynn",New Raymond,Uruguay,995.240.7384x301,001-301-278-5189x849,brent04@ware-leonard.org,2022-02-19,http://hampton.info/
21-Mar-2021,RTGS,454.00,00.00,"518,822.47",5fF431B6F7D49fB,1414,Dwayne,Cabrera,Everett-Valdez,Pierceborough,Western Sahara,049-240-6446x240,772-471-3751x9926,xmorrow@macdonald-newman.com,2021-08-13,https://sloan.com/
21-Mar-2021,Miscellaneous,11.90,00.00,"518,834.37",Fe2b6Ef83499971,2555,Austin,Barton,"Richardson, Fox and Nash",Lake Rachael,French Southern Territories,2765042849,736-366-2370x76441,wyattburnett@wu-bean.org,2022-02-02,https://matthews-suarez.com/
21-Mar-2021,Transfer,00.00,"103,766.87","415,067.50",d1aCDbfCf97c12b,6706,Kerri,Meyers,Vang-Shaw,Tuckertown,Guinea,001-856-091-2956x52587,606.040.0420x012,myu@cox.com,2022-05-06,https://shah.com/
21-Mar-2021,RTGS,00.00,"51,883.44","363,184.06",ee6A9dd49c6B7B9,5382,George,Gonzalez,Stark-Spencer,Whitakerstad,Tunisia,+1-960-964-2072x602,(432)462-1189,judypollard@nielsen.com,2020-12-08,https://www.carrillo.org/
21-Mar-2021,Cash,"1,788,208.00",00.00,"2,151,392.06",6b6fe9A892930dE,3763,Anne,Morton,Foley Group,South Jonathanfort,Vanuatu,+1-778-203-6196x0422,5379833554,shanegallagher@armstrong.com,2020-05-11,http://fitzgerald.info/
21-Mar-2021,IMPS,56.90,00.00,"2,151,448.96",F41d606ccbd7F10,717,Nina,Logan,"Zuniga, Callahan and Harmon",Pattymouth,Malawi,+1-603-786-5143x21164,001-210-792-5761x69630,heidi78@parsons.com,2021-06-12,https://www.graves.org/
21-Mar-2021,RTGS,00.00,"430,289.79","1,721,159.17",207D45CCFEda8B9,691,Eugene,Petersen,"Mills, Velazquez and Hendricks",South Anneland,Germany,+1-803-155-3362x4002,625-053-6307x596,debrabeard@stein.com,2020-05-23,https://brennan.info/
21-Mar-2021,Reversal,00.00,"245,879.88","1,475,279.29",d06eDCF1489689C,5116,Nicolas,Jones,Ellis-Price,Port Felicia,Vietnam,118-073-3491,(076)417-0689,patriciaingram@avila-mahoney.com,2022-01-11,https://www.cordova.com/
21-Mar-2021,Cash,00.40,00.00,"1,475,279.69",c5f6b6A9C3b7DDe,1088,Devon,Holt,"Espinoza, Wade and Hood",East Chris,Western Sahara,560-913-6288,+1-073-524-4698,mirandamcfarland@woodard-kline.com,2020-06-05,http://www.murillo-cohen.biz/
21-Mar-2021,Bill,"15,089.70",00.00,"1,490,369.39",685d219b70A31aa,8262,Marilyn,Schroeder,Bradshaw Ltd,New Joseshire,Mayotte,391-019-8826,(936)892-4029,dchapman@werner-blackwell.com,2020-10-24,https://www.blevins-schneider.com/
21-Mar-2021,Cheque,180.90,00.00,"1,490,550.29",ED8eCEc7C236d2f,5616,Roberto,Robertson,Whitney LLC,North Caitlin,Angola,001-264-235-1187x81651,+1-100-045-8840x2196,pachecojenna@adkins.biz,2020-11-23,http://bennett.com/
21-Mar-2021,NEFT,00.00,"372,637.57","1,117,912.72",60D03A0a3F0da9a,2184,Alexis,Reese,Hayden Group,Mariochester,India,001-611-182-2027x81638,(083)975-9564x0664,jhuynh@kane.com,2022-04-15,https://www.shea.com/
21-Mar-2021,Reversal,00.00,"279,478.18","838,434.54",fF532C168cCEE1a,4160,Margaret,Mcdaniel,Page-Preston,Mckinneychester,Aruba,+1-703-832-9765x90636,309-071-5713x15355,kgreer@cordova-santos.biz,2021-08-22,http://www.ochoa-clements.org/
21-Mar-2021,IMPS,"140,213.78",00.00,"978,648.32",8beda4072817F58,4656,Jake,Higgins,"Adkins, Yu and Garner",Drewstad,Mauritania,142.889.2269x8524,752-011-6780x273,vickivalentine@briggs.biz,2022-01-05,http://castaneda.com/
21-Mar-2021,Reversal,00.90,00.00,"978,649.22",F1CF1B995811cAE,9157,Ruth,Berg,Blankenship-Avila,North Paulaport,South Africa,8676370400,025.818.9070,hollylindsey@mckenzie.com,2020-06-14,https://salas.biz/
21-Mar-2021,Purchase,00.00,"978,649.22",00.00,d5BbcEE7E4da8ae,7343,Cheryl,Meza,Thomas-Perry,East Feliciaview,Guadeloupe,(971)398-3742,(918)085-6470x6678,alexamiddleton@golden.org,2020-07-24,https://weiss.info/
21-Mar-2021,Miscellaneous,362.98,00.00,362.98,ACAd78e38e2EA6c,2771,Chelsea,Rowe,"Skinner, Diaz and Gay",East Stevebury,Turkey,5593990890,+1-218-193-5865x367,mikaylalyons@curtis.info,2022-02-24,http://rocha-lozano.com/
21-Mar-2021,Transfer,"10,630.30",00.00,"10,993.28",811c27Cadfc7114,6833,Joanne,Frost,"Fisher, Jennings and Travis",New Ricky,China,(116)814-8212x017,827.477.7138x36932,perry27@york-burch.com,2021-05-17,http://www.moreno.com/
21-Mar-2021,Bill,00.00,"5,496.64","5,496.64",De0F737156Ef1Ae,3630,Shawn,Hicks,"Weaver, Rivas and Henderson",Ashleytown,Congo,(175)142-9758x13452,001-386-627-4241x06757,kurt98@brady-reyes.com,2021-06-07,https://wheeler.net/
21-Mar-2021,Debit Card,00.00,"5,496.64",00.00,64d1a85d2A3efBC,6063,Lee,Blevins,Porter-Harrison,Port Caseyburgh,Solomon Islands,497-601-4038,162-766-7794,greertricia@hendricks.com,2021-12-30,http://howe.info/
21-Mar-2021,Cash,"2,070,108.50",00.00,"2,070,108.50",6DdAb10f0BFfa89,9701,Marissa,Steele,"Cooke, Davies and Cabrera",New Samanthaborough,Brazil,2285948601,001-967-109-8885x94930,lrobinson@nolan-odonnell.com,2021-01-01,https://www.evans.com/
21-Mar-2021,Cash,253.25,00.00,"2,070,361.75",DbE06ca1BF426bb,5272,Lonnie,West,Frazier LLC,Mercadoberg,Colombia,2065726016,668.232.0104x45281,phyllis50@padilla.com,2020-11-05,https://www.bowers-velazquez.com/
21-Mar-2021,NEFT,"222,410.80",00.00,"2,292,772.55",1BCFFFB972a1AEE,6251,Autumn,Stark,Simpson-Boyer,New Brendanmouth,Latvia,001-852-580-4013x5902,546.259.4716,rfuentes@koch.org,2020-01-22,https://www.ramirez.info/
21-Mar-2021,Purchase,"3,475.00",00.00,"2,296,247.55",FC67EF7bcB7E45e,1968,Darius,Mcbride,Peck LLC,Cookehaven,Moldova,001-760-063-4749x118,224.861.5309x4911,ebrowning@bautista-reilly.com,2020-08-04,https://www.chaney.com/
21-Mar-2021,Commission,00.00,"1,148,123.78","1,148,123.77",fF1AF17Ff3CDc4c,2962,Kirsten,Bush,"Le, Rasmussen and Sherman",Evansborough,Argentina,+1-812-564-1799x255,001-384-670-1330x9172,xbrennan@mcintyre.org,2021-06-06,http://www.bender.com/
21-Mar-2021,Debit Card,404.00,00.00,"1,148,527.77",3aE6facEb09F9DA,4905,Tim,Oconnell,Barrett Ltd,Marvinburgh,Mongolia,+1-529-792-1029x01541,7939182890,dariusmalone@orozco.com,2022-04-03,https://www.freeman.net/
21-Mar-2021,Bill,02.52,00.00,"1,148,530.29",BEF426b11CbC40f,3928,Kendra,Erickson,Huang LLC,Atkinsborough,Moldova,709-834-2839x499,(701)180-7118,upham@richardson-casey.net,2021-03-28,https://www.mahoney-west.com/
21-Mar-2021,Miscellaneous,46.79,00.00,"1,148,577.08",D9FaEfd9f2E71b2,1986,Sierra,Case,Reeves PLC,Davenportberg,Slovenia,+1-257-768-8102x55218,(636)141-3663,charleswalls@phillips.com,2020-08-22,https://mora.com/
21-Mar-2021,IMPS,"23,883.00",00.00,"1,172,460.08",a7ABcaDb68756C2,7953,Steven,Leach,Strickland-Downs,Carriestad,Greenland,001-599-008-6037x97007,389.971.3735,terrence23@carr.com,2020-04-15,https://www.morton.net/
21-Mar-2021,Debit Card,271.30,00.00,"1,172,731.38",03069A40c583EfA,3341,Jordan,Ho,York Group,Hahntown,Hong Kong,(094)070-8496,001-961-124-0000,johnsonlouis@velez.net,2021-12-15,http://mills.com/
21-Mar-2021,Purchase,00.00,"1,172,731.38",00.00,b7A68f0B24CbB2C,3523,Eric,Vazquez,"Webster, Wolfe and Beasley",Alyssachester,Samoa,(709)302-2623x871,308-888-0548,vasquezpatricia@hawkins-rose.com,2022-01-19,http://www.burnett.com/
21-Mar-2021,Cash,26.00,00.00,26.00,0bD9741FFebab13,5376,Don,Whitaker,Maddox-Mccann,New Tabitha,Faroe Islands,001-925-497-5965,+1-033-676-4379x620,madison57@rubio-holden.biz,2020-11-01,http://estrada.biz/
21-Mar-2021,Transfer,46.00,00.00,72.00,Cf8B3BDaC5A10cc,3520,Elaine,Hebert,Lawson Inc,Bryanshire,Albania,(316)026-4201x452,(287)835-6471x645,leahglenn@kramer.com,2020-06-08,https://www.clarke-shaffer.com/
22-Mar-2021,NEFT,"30,571.70",00.00,"30,643.70",FE5Ee2dEeE4cE28,409,Marilyn,Peck,"Solomon, Potter and Merritt",Oscarborough,Western Sahara,(319)744-3383x354,1974058669,stacy53@gardner.com,2022-04-30,http://www.frank.com/
22-Mar-2021,Purchase,"190,374.88",00.00,"221,018.58",a1bBBEBDfb3Fe3f,315,Phyllis,Fischer,"Henson, Khan and Padilla",Austintown,Trinidad and Tobago,(273)538-2624x2121,728.516.1523x240,catherine30@lewis.org,2020-05-18,https://frye.biz/
22-Mar-2021,Commission,00.00,"55,254.65","165,763.94",Fb3Bd33D4bae8F7,3128,Madison,Campbell,Lowery PLC,North Frederick,Malawi,509-415-7925,+1-466-656-0387x123,patrick96@kemp.com,2020-10-21,http://www.bridges-dunn.info/
22-Mar-2021,Cash,00.00,"23,680.56","142,083.38",63Dff8b8eAB0BC6,6021,Frank,Murillo,Decker Group,New Lonnieville,Iceland,401.222.0429x4189,073-705-2158x5471,bergmelanie@lawrence.com,2020-07-07,http://www.shepard.net/
22-Mar-2021,Bill,33.80,00.00,"142,117.18",0B86Add509Fe668,9151,Pamela,Carter,"Henson, Mooney and Sexton",North Sue,Iceland,187.966.6796,+1-586-700-8555x55026,fitzpatrickroger@mccarthy-hall.com,2020-11-24,http://www.thornton.net/
22-Mar-2021,Purchase,00.00,"71,058.59","71,058.59",dFAbAcEEEEcCA1D,3356,Paul,Arias,Huber-Hudson,New Reneechester,Botswana,(506)132-8932,497.843.8753x4853,rbaldwin@spencer-mckinney.info,2020-09-20,https://salas.com/
22-Mar-2021,Miscellaneous,"1,918.56",00.00,"72,977.15",f45e5b4d8afaf9B,7028,Darryl,Hale,Chaney and Sons,Changburgh,Iceland,016-205-9767x87669,541-999-9421,yrice@chan.com,2021-10-28,http://marshall.net/
22-Mar-2021,Miscellaneous,00.00,"24,325.72","48,651.43",2A319D00aa0AAfd,4878,Dean,Houston,Floyd-Norton,East Alejandraborough,Hungary,(861)123-9006x3852,+1-192-586-6661x142,fwise@herman-lutz.com,2021-01-16,https://johnson.biz/
22-Mar-2021,Cheque,00.00,"5,405.71","43,245.72",b1Fc8fcEa248e17,1892,Regina,Mcfarland,Larson Inc,Spencerborough,Sao Tome and Principe,354-972-1078,001-844-241-8734,craigmurillo@curtis.com,2020-03-23,http://herring-cisneros.com/
22-Mar-2021,Transfer,00.00,"10,811.43","32,434.29",b2DafC2bD849F4b,8130,Marissa,Roberts,"Rivera, Cabrera and Meyer",Shawnburgh,Senegal,+1-984-442-0921x7473,102-340-8844,ebonymathis@small.net,2020-11-18,http://www.fuentes.com/
22-Mar-2021,Debit Card,21.90,00.00,"32,456.19",8AF3BbC65eBbA1D,8986,Pam,Levine,Valencia and Sons,Bethanyton,Puerto Rico,4205273240,+1-397-718-3124x942,adriennewilkins@taylor.info,2021-03-18,http://www.mccall.com/
22-Mar-2021,RTGS,00.00,"32,456.19",00.00,beC6fF6CCAADd1a,1444,Greg,Mahoney,Lambert-Lara,Lake Manuel,Bolivia,000-076-5119,649.120.5116x8471,ghartman@beck.biz,2020-03-04,https://www.fields-erickson.biz/
22-Mar-2021,Miscellaneous,"20,441.10",00.00,"20,441.10",662221D2eb1A79b,1153,Emma,Fitzgerald,"Spence, Hendrix and Singh",Lake Jasminchester,Burkina Faso,748-888-8639x940,(418)560-4947x080,alexlynn@gilmore-chang.biz,2020-04-08,http://www.rivers.com/
22-Mar-2021,Bill,391.00,00.00,"20,832.10",f7c78D1a44a16f1,6511,Katherine,Carr,"Osborn, Mcgee and Austin",Port Bryce,Maldives,001-277-847-0116,(264)666-9745x598,zwelch@gutierrez.info,2021-02-25,http://duke.net/
22-Mar-2021,Cheque,503.79,00.00,"21,335.89",B50b5B8dD474B29,5057,Leslie,Hodge,Rios Ltd,East Sharonmouth,Malaysia,7517658154,(999)728-3930x890,phillip19@villegas.net,2021-08-28,https://lee-cain.com/
22-Mar-2021,Transfer,388.69,00.00,"21,724.58",bd7Da4B82F28279,405,Zachary,Shaffer,"Haynes, Lara and Lara",Mccormickmouth,Czech Republic,(713)867-5810x3140,540.738.7911x210,avilasummer@hensley-richmond.net,2022-01-30,https://www.burgess.org/
22-Mar-2021,IMPS,00.00,"3,103.51","18,621.07",eE718cdA1CCaA91,6195,Bradley,Clayton,Ramos Inc,Barberstad,Luxembourg,360.797.7453x7457,5987632252,mcclurejoel@hubbard-lawson.info,2021-01-14,https://www.ferguson.com/
22-Mar-2021,Interest,"20,404.55",00.00,"39,025.62",941bD9D9A8a0aeA,5875,Emma,Cervantes,Lester-Dalton,Lake Nina,Lao People's Democratic Republic,+1-727-448-2145x8798,001-012-769-8794x22629,angela24@sawyer.com,2020-05-11,https://www.carroll.net/
22-Mar-2021,Bill,00.00,"13,008.54","26,017.08",2Beb599f07c40c8,4186,Darin,Morris,"Raymond, Martin and Cordova",Andreaton,China,001-506-725-0139x6153,(914)168-1623x31681,alishasalazar@kent.info,2020-09-14,http://www.graham-pena.net/
22-Mar-2021,Commission,341.92,00.00,"26,359.00",7aCdbE1F5d99Be6,6531,Dillon,Mcclain,Cruz-Martin,Bettystad,Uzbekistan,(038)620-2282,001-576-379-0271x67975,calvin21@gomez-avery.com,2020-03-12,http://wyatt.org/
22-Mar-2021,Bill,00.00,"8,786.33","17,572.67",dd3Ee8eF3cB6532,2891,Lee,Lane,"Dalton, Trevino and Schmidt",Nicoleville,Niue,001-713-670-2583,610.923.5819,jacobvelazquez@pearson.biz,2022-01-28,https://www.coleman-tyler.info/
22-Mar-2021,Debit Card,"1,607,982.00",00.00,"1,625,554.67",cbBd69c9E0dAAB6,4445,Mark,Daniels,Hughes-Potts,Lake Hollyburgh,Uganda,135.780.0334,(071)549-3603,soniaflores@owen-logan.com,2022-03-12,http://www.stewart.com/
22-Mar-2021,Cheque,00.00,"812,777.34","812,777.34",1Cc705Efc19c52f,6324,Ana,Carpenter,"Andrade, Kidd and Rasmussen",New Cynthia,Iran,(853)107-6370x53034,(508)243-3126,foxbeth@castaneda.net,2020-11-19,https://rush.com/
22-Mar-2021,Cheque,00.00,"203,194.34","609,583.00",cCEEE9BEEE3Fe61,9573,Gregg,Dunlap,"Watkins, Wagner and Olson",South Tanner,Ethiopia,3469115890,223.519.9741x224,roymichael@medina-mccann.biz,2021-05-09,http://www.robles-sloan.net/
23-Mar-2021,Debit Card,05.10,00.00,"609,588.10",6ba0BC5c67eCDD0,196,Amanda,Harper,"Trevino, Lam and Brewer",Lake Kylie,Chad,331-372-4188,287.106.6090x069,fieldskelly@blackburn.biz,2020-03-22,http://macias-duffy.com/
23-Mar-2021,Transfer,08.00,00.00,"609,596.10",B6a7d1dC7c7Fc4A,1501,Oscar,Dorsey,Jennings Inc,Port Kellie,Kuwait,(119)524-0104x8633,024-317-7794,landrymakayla@moran.com,2020-08-17,https://www.cortez.biz/
23-Mar-2021,Cheque,00.00,"76,199.51","533,396.59",A7784bF3F61Abbc,1819,Carl,Byrd,Hartman-Zhang,Simonmouth,Hong Kong,+1-821-085-8923x576,+1-093-110-9428x1078,arthurnguyen@mendez-kennedy.net,2020-06-26,http://www.wheeler.com/
23-Mar-2021,Tax,01.90,00.00,"533,398.49",8da8cCd2Ba6aEd8,8641,Rickey,Middleton,"Ellis, Chapman and Bryan",Hammondview,Albania,(631)574-6810x315,001-082-726-0128x9828,thomas51@stone.info,2021-10-30,https://www.mendoza.com/
23-Mar-2021,IMPS,"238,642.28",00.00,"772,040.77",aF2Fb959e8da5D3,3766,Duane,Jimenez,Castro Ltd,Mackside,Nicaragua,537-667-7234,001-798-363-1777,hcastaneda@walton-houston.com,2020-04-13,http://www.jennings.com/
23-Mar-2021,Reversal,"1,457.10",00.00,"773,497.87",ADFf4FdCceDFD3D,1942,Latasha,Weaver,Chen-Contreras,Dwaynehaven,Ghana,252.330.6673x443,(731)669-3488x71780,henrymurray@kane.biz,2022-04-04,https://www.oneill.com/
23-Mar-2021,RTGS,03.38,00.00,"773,501.25",95Cae6FE89D9fB8,3524,Xavier,Horne,Mata Inc,East Tammyburgh,San Marino,(999)260-2620x825,950.918.2964x433,jane42@bartlett-irwin.com,2021-06-30,https://www.byrd.info/
23-Mar-2021,ATM,00.00,"110,500.18","663,001.07",6F25db33c48CcE8,6125,Max,Cortez,"Smith, Dudley and Berger",Haydenville,Suriname,291.672.9240,106-089-0525,pacebrenda@farmer-cardenas.net,2021-08-11,https://cummings.com/
23-Mar-2021,Interest,00.00,"663,001.07",00.00,CdE711D9D2a15Cb,5976,Jean,Murphy,"Baird, Butler and Avila",Raymondport,Dominican Republic,636-733-3119,+1-503-521-5649x6719,gcastillo@valentine.com,2020-11-08,https://www.roth.com/
23-Mar-2021,Transfer,635.53,00.00,635.53,f8CCf2BFf6AbEbb,2974,Dominic,Salas,Cobb Ltd,North Jerry,Palestinian Territory,441.295.7488x00063,603-385-8247x731,rodneylin@romero.com,2021-05-29,http://www.bolton.com/
23-Mar-2021,Tax,"5,618.00",00.00,"6,253.53",Bc02eA6FaCF7a1A,5341,Kelsey,Weber,Harrison-Short,Emmaton,Iceland,961.337.1211,(909)638-7551x6806,osbornewillie@becker.com,2020-06-23,http://www.zavala.com/
23-Mar-2021,Reversal,00.00,625.35,"5,628.18",503BbBF9c5E0276,7162,Clarence,Osborne,Guerrero-Phillips,West Albertside,Lao People's Democratic Republic,+1-552-515-9075x923,432.858.8918,sallymelendez@estrada.net,2021-01-25,https://meyers.com/
23-Mar-2021,Cheque,00.00,804.03,"4,824.15",1d0D5dbCfB33Fb6,3491,Jacqueline,Yang,Durham-Frederick,Braunfort,Bhutan,(763)091-7981,(529)044-0294,pittsarthur@booth.com,2021-08-30,http://mcintosh.com/
23-Mar-2021,Reversal,00.00,482.42,"4,341.73",AD11aee28Ecc768,413,Jasmine,Brennan,"Conway, Jones and Morton",Charleneview,Tunisia,561.311.5283x5492,398-406-9441x95528,uarroyo@david-greer.net,2021-07-15,http://www.zuniga.com/
23-Mar-2021,Cheque,00.00,868.35,"3,473.38",8ffcDBdF1D2F655,723,Brandi,Logan,Fitzpatrick Inc,East Brittney,Falkland Islands (Malvinas),338.902.4765,001-294-242-1071x26638,manningmallory@bartlett-dean.com,2021-03-27,http://mcneil-harding.com/
23-Mar-2021,Tax,00.00,868.35,"2,605.04",9e34DC005D2f770,699,Lucas,Bradshaw,Krueger and Sons,Zacharyborough,Qatar,001-719-480-7522x88708,001-359-077-4917,tammypennington@skinner-whitehead.biz,2020-01-04,http://www.cabrera-buck.com/
23-Mar-2021,Commission,00.00,651.26,"1,953.78",Ea7A6ebbdaDAc53,5336,Rick,Lewis,"Good, Cantu and Cunningham",Sergiohaven,Lebanon,(225)258-2241,+1-274-496-3398x7470,wardjade@howell.com,2020-07-22,https://www.scott.com/
23-Mar-2021,RTGS,00.00,651.26,"1,302.52",747baE7e65A527d,4236,Traci,Higgins,Nielsen-Cain,West Nancytown,Argentina,001-766-796-9916x752,+1-591-063-4601x42911,pittsstacy@gillespie-holt.org,2020-05-12,https://www.webb.net/
23-Mar-2021,Interest,00.00,186.07,"1,116.45",e1b5eCa0a12CBAE,2590,Claire,Crosby,Morrow-Baird,Lake Karen,Tajikistan,001-098-251-6810x2990,(519)779-6999x99029,nmoyer@wiggins.com,2020-01-18,https://huff-donaldson.info/
23-Mar-2021,NEFT,"4,518.80",00.00,"5,635.25",E1CE0D4070F76F3,2463,Douglas,Chang,Levy LLC,Normanview,Trinidad and Tobago,+1-793-021-4940x874,(218)991-1008,tammierobertson@johnston-marshall.biz,2021-03-09,https://www.arellano.info/
23-Mar-2021,Miscellaneous,00.00,"1,127.05","4,508.20",BF6AaBE141d74B4,5714,Juan,Jordan,Parks-Mcpherson,Darinfurt,Libyan Arab Jamahiriya,003-721-0376,026-150-3103,kempalexander@finley-allison.org,2020-10-17,http://www.reese.info/
23-Mar-2021,NEFT,13.80,00.00,"4,522.00",BbBAEa65fA91DE2,8695,Derek,Lutz,Schwartz and Sons,West Brianton,Bolivia,+1-020-075-1118,(301)176-0096x0520,dannyjoyce@clarke.com,2020-01-05,http://booth-lynn.info/
23-Mar-2021,Reversal,00.00,"1,130.50","3,391.50",287b7B7e2aBb1e2,8259,Joshua,Zhang,"Humphrey, Holloway and Torres",Downsburgh,Italy,513.177.6356x974,328-647-9285x602,pmorton@bird.com,2020-11-21,http://www.garrison.biz/
23-Mar-2021,Cheque,00.00,847.88,"2,543.62",151AB7444E1C0fA,4346,Chloe,Sanford,"Ortiz, Cummings and Mason",Fordview,Georgia,0075980914,628-422-9674,jle@soto.com,2022-05-05,http://rasmussen.com/
23-Mar-2021,Debit Card,180.00,00.00,"2,723.62",b0a0dfACe39e368,8777,Kaylee,Roberts,"Forbes, Meyers and Owens",North Wandafurt,Congo,990.616.5166,001-699-868-9084x5477,robertocaldwell@mccann.com,2021-08-28,http://www.hobbs-velez.com/
23-Mar-2021,ATM,00.00,389.09,"2,334.53",adbCFFfBF1eABF0,1988,Wesley,Keith,"Vang, Shaffer and Gilmore",Suemouth,Ghana,+1-687-922-6577,(676)161-8782,kdominguez@moore.info,2021-02-14,https://case.info/
23-Mar-2021,Transfer,"226,542.00",00.00,"228,876.53",79E1D633C6B2FA5,8441,Marc,Lucas,Henry-Singh,Lake Zachary,Guadeloupe,333.439.7645,906.819.8866x31112,kristopherbass@greer.com,2022-01-16,http://www.durham.info/
23-Mar-2021,Transfer,00.00,"114,438.27","114,438.26",5a173aA3E4d7B6d,3548,Mitchell,Lam,Green PLC,New Kathy,Comoros,(830)780-4690x357,027-025-6101x088,coffeydan@daniels.com,2021-04-16,https://www.clarke-hendricks.info/
23-Mar-2021,RTGS,00.00,"12,715.36","101,722.90",Dae2b4DA370bBAb,9291,Sally,Patel,Villegas and Sons,Mcbrideton,Liechtenstein,176.853.1794x700,2045317017,priscillahull@aguilar.net,2020-06-09,https://dickson.com/
23-Mar-2021,Bill,37.25,00.00,"101,760.15",b9c7C4ab1c1E053,4264,Hailey,Frost,Daniels-Combs,Dicksonland,Gabon,001-016-296-5366,001-199-930-4021,arichard@espinoza-spears.com,2020-08-13,http://daniels-costa.org/
23-Mar-2021,Cheque,00.00,"101,760.15",00.00,fC64BabBeDeD05b,4232,Ariel,Strong,Greene Inc,West Bethanyside,Nauru,001-035-155-2745x62648,(604)165-8488,tara21@payne-kerr.com,2021-11-06,https://www.stevens.com/
23-Mar-2021,Cheque,56.00,00.00,56.00,6BACDCEEbbfDAa4,930,Alfred,Woods,Hull-Ortega,North Zachary,French Southern Territories,219.942.9216,(131)460-2664x38611,suzanne36@burton-navarro.com,2022-04-12,https://www.santana.net/
23-Mar-2021,Interest,00.37,00.00,56.37,3D03b126b10f401,146,Paula,Huff,"Vaughn, Castillo and Anderson",Roseburgh,Peru,589-460-7915x9435,150.147.8773x7965,vmyers@novak-delacruz.biz,2021-08-01,https://garner.net/
23-Mar-2021,NEFT,"1,687,217.00",00.00,"1,687,273.37",2D87D4c98F1dc84,2136,Darren,Atkins,Stanley-Mccarthy,Jodiland,Greece,001-944-715-5149x62983,(559)795-3150x901,galvarado@vance.com,2021-09-13,http://hickman.com/
24-Mar-2021,IMPS,00.00,"281,212.23","1,406,061.14",Eaed4Bc2AfcE20a,3695,Lori,King,"Carson, Trevino and Fox",Lake Kelseyfort,Senegal,+1-702-656-6599,+1-314-880-5329x734,llindsey@decker-cervantes.org,2021-02-06,https://www.decker.com/
24-Mar-2021,Purchase,"71,660.30",00.00,"1,477,721.44",7f1f4aF82AbCdE8,785,Lonnie,Cisneros,Parrish LLC,Francischester,France,(648)763-8915,872-626-7295x19426,qpham@cabrera-foley.com,2020-03-22,https://www.kennedy.com/
24-Mar-2021,NEFT,00.00,"295,544.29","1,182,177.15",Aaa65bcDf93aeDd,9335,Jackie,Decker,Holt Group,South Shellybury,Congo,001-010-385-8318x20864,724-293-1020x117,gritter@whitaker-benton.com,2021-12-21,https://www.kennedy.com/
24-Mar-2021,Purchase,00.00,"168,882.45","1,013,294.70",Da2efbC6fCc5b74,9950,Sandra,Silva,Gonzalez PLC,Tabithaberg,Bangladesh,(434)277-0630x7629,634-816-4808,ablackwell@watkins-mcmahon.com,2020-09-03,https://www.campos.com/
24-Mar-2021,ATM,"8,377.00",00.00,"1,021,671.70",D840b3fd766ff8b,4725,Gwendolyn,Dunlap,"Ingram, Bridges and Conrad",Hicksside,Comoros,717-563-1573,573.400.1059x8581,sarah99@norris-parks.com,2020-11-18,http://www.keith-galvan.org/
24-Mar-2021,Commission,256.44,00.00,"1,021,928.14",B8FcDFcEedB34aA,5035,Danny,Shaw,"Mcneil, Martin and Deleon",Lake Debrahaven,Iran,462-104-8487,(555)631-3822,nathaniel57@haynes.org,2021-08-13,https://harding-dixon.com/
24-Mar-2021,Cheque,"182,482.00",00.00,"1,204,410.14",02898865ef261D8,2581,Gary,Watson,"Cameron, Peck and Hale",North Grantbury,Greece,334-059-0518x2057,749.882.3352,mariecochran@maddox-mcdowell.com,2021-08-21,https://www.crosby-hicks.com/
24-Mar-2021,Debit Card,"16,483.60",00.00,"1,220,893.74",EBeFbAC64966dBD,4510,Nichole,Shaw,"Dickson, Leblanc and Curry",South Andreside,Sudan,001-528-246-9147,045-769-8443,glen76@hoover-coffey.biz,2020-08-19,http://www.mcconnell.com/
24-Mar-2021,Commission,"28,786.00",00.00,"1,249,679.74",0ac5c95CeaEFdCe,789,Veronica,Griffin,Moreno and Sons,Port Bradhaven,Uruguay,2441427940,(637)700-3679,esantos@case.com,2020-06-05,http://whitehead.org/
24-Mar-2021,Purchase,"98,247.06",00.00,"1,347,926.80",99fBA93ffF751Ba,9237,Aimee,Lucero,Andrade-Strong,Whitneyborough,Luxembourg,+1-223-760-6945x38566,180.548.2643,moonsara@benitez-nielsen.biz,2020-11-16,https://www.kirk.biz/
24-Mar-2021,Cash,00.00,"1,347,926.80",00.00,7da1EA1eCaf71A7,3258,Glenn,Cunningham,Curry LLC,South Kara,Fiji,(362)458-3483,+1-861-907-8332x8865,solismiranda@ashley.com,2020-09-01,http://bowen.com/
24-Mar-2021,Debit Card,246.00,00.00,246.00,2D1a36dac6a635F,2570,Elizabeth,Hale,Costa PLC,Goldenmouth,Colombia,232-485-4706x8778,664-614-9154x0245,krystal87@evans.com,2021-11-09,https://banks.info/
24-Mar-2021,Cheque,04.19,00.00,250.19,a3Ea76FCEDBCBf3,4775,Lucas,Reynolds,Mcclure-Collier,East Alecton,Iraq,001-527-116-0696,466-800-3096x671,adrian44@morales.org,2021-03-08,http://www.yates-castaneda.com/
24-Mar-2021,Purchase,469.10,00.00,719.29,2Ea833b26e7Cb4e,7613,Gina,Pitts,"Parks, Bonilla and Baird",Spearsfort,Liechtenstein,+1-829-445-3636x1423,001-396-112-6366x954,casey10@delacruz.com,2020-07-14,http://casey.com/
24-Mar-2021,Bill,"26,684.80",00.00,"27,404.09",868D763f04bc0cb,3336,Abigail,Thomas,Carpenter Group,Port Daisy,Zimbabwe,(003)266-6168,+1-118-596-5063,howardjody@hartman.com,2021-07-13,https://barrera.com/
24-Mar-2021,IMPS,00.00,"3,044.90","24,359.19",ef14b1E5Fab16aE,7979,Isabella,Diaz,Mcfarland-Quinn,Chadmouth,Uruguay,355.123.3766x4125,850.865.2582x89593,roberto82@chang-rose.biz,2021-10-17,http://www.livingston.biz/
24-Mar-2021,Commission,401.40,00.00,"24,760.59",3bfEE48D2A38B98,111,Chad,Henry,"Gaines, Galvan and Goodwin",Hansonburgh,Cyprus,001-014-140-8925x13758,(560)696-8482,mathisgloria@house-hamilton.org,2020-07-05,https://silva.com/
24-Mar-2021,Miscellaneous,"222,577.81",00.00,"247,338.40",47B103d5B5f10F1,3884,Sherri,Escobar,Russo-Blackwell,Kimside,Peru,801.598.8166,254.433.4701,bnovak@mathews.org,2021-03-25,https://dean.net/
24-Mar-2021,Transfer,"28,285.80",00.00,"275,624.20",FAa3224ddbdE48c,8314,Cameron,Olson,"Hobbs, Hartman and Graves",South Seth,Luxembourg,+1-931-097-3543,+1-477-067-7089x2613,karen91@huffman-montgomery.com,2022-02-12,https://jarvis.net/
24-Mar-2021,Bill,"3,842.00",00.00,"279,466.20",eCEE08Fb05B4BBE,8455,Bryce,James,Bean Group,West Kristen,Syrian Arab Republic,001-448-418-6568x822,001-866-900-5528x295,davidmcdowell@wheeler-burgess.org,2020-06-25,https://stuart-hunt.biz/
24-Mar-2021,Tax,"3,433.41",00.00,"282,899.61",30fcCAFDea1fd6A,8498,Vickie,Gallagher,"Chandler, Hudson and Cervantes",Annemouth,Ghana,(328)589-7380x170,106.705.2157x7144,jcannon@moss.com,2020-12-22,https://www.chan.com/
24-Mar-2021,Commission,00.00,"141,449.81","141,449.80",1B4D97F5FB38069,4370,Jackson,Cobb,"Curtis, Peterson and Ho",South Don,Palestinian Territory,(832)103-2287x664,(095)304-9152,jeffreyvalenzuela@ross.org,2021-08-12,http://www.callahan-bryant.info/
24-Mar-2021,Debit Card,00.00,"70,724.90","70,724.90",cEabE1E527AFf60,5841,Micheal,Oliver,Patel-Downs,New Charleneview,Japan,(011)225-4096,620-958-9558x457,summer39@villa.com,2021-08-22,https://shepherd.biz/
24-Mar-2021,Tax,00.00,"70,724.90",00.00,c481C6D7Bc67E1E,794,Charles,Bradshaw,Mcdowell PLC,Thomastown,Benin,(383)738-7485,644.874.5744,avasquez@kidd.net,2020-02-18,http://gibson.com/
24-Mar-2021,Cheque,"3,309.80",00.00,"3,309.80",4969EC863e45Dc0,3997,Rita,Banks,Rush Ltd,East Allisonstad,Monaco,7274892386,4364191306,wcook@wyatt.net,2020-09-20,http://james.com/
24-Mar-2021,Commission,02.40,00.00,"3,312.20",b07c2Dc76d5b32C,389,Clarence,Church,"Rasmussen, Wu and Hawkins",Abigailstad,Hong Kong,1946419219,(559)009-3592x74098,daniellebooth@underwood.info,2021-08-13,http://www.tucker-kelley.info/
24-Mar-2021,Purchase,"8,271.40",00.00,"11,583.60",055A0EDa34c8Dec,5924,Erica,Donovan,Hatfield-Collins,South Dominic,Norway,857.650.1466,622.571.8737,breanna24@house-mcconnell.com,2020-02-20,http://www.oconnor.com/
24-Mar-2021,Cash,"16,923.47",00.00,"28,507.07",c4844Ad35808FcC,9859,Jane,Petty,"Davies, Nolan and Clarke",Caseyland,Cambodia,163-281-0529x49904,082-367-3176x8224,kim16@flynn-dougherty.net,2022-02-23,http://hatfield.net/
25-Mar-2021,NEFT,"1,636.00",00.00,"30,143.07",13f0A5E609fa6D0,5273,Timothy,Rollins,"Petty, Montes and Ramos",Ericksonstad,Bangladesh,398-120-7618,+1-688-972-1653x673,mollyholmes@wall.info,2021-05-24,http://miles.com/
25-Mar-2021,RTGS,02.28,00.00,"30,145.35",Df0ae9CebcDf828,6026,Carmen,Cardenas,Gates-Avila,Laurenfurt,Philippines,(751)822-2153,(271)575-7443,christensenalisha@long.com,2021-05-11,http://www.horton-boone.com/
25-Mar-2021,Commission,00.00,"3,768.17","26,377.18",Af1431b64FE4DBF,2527,Riley,Dawson,Melton-Pratt,Jesseland,Puerto Rico,0825578960,294-485-3943x0744,savannah09@trevino.com,2021-04-23,http://www.stokes.com/
25-Mar-2021,IMPS,00.00,"3,768.17","22,609.01",eDD1718ABdab600,4654,Candace,Glass,"Kirby, Kent and Crane",Bridgetview,Saint Kitts and Nevis,(817)450-3652x3049,877.617.9420x58450,alexisflores@moore.biz,2020-11-06,https://garrett.com/
25-Mar-2021,Cash,"27,291.20",00.00,"49,900.21",B6C8723eBc92D35,3417,Daryl,Guerra,Gallegos Inc,Paulaview,Rwanda,516.356.0800,224.197.5640x6148,sharon91@walker.biz,2021-11-25,http://costa.org/
25-Mar-2021,Tax,301.11,00.00,"50,201.32",32C993f1F0D1C9B,1885,Meredith,Roy,Mendez and Sons,Darinshire,United States of America,068.901.9170,(935)035-8188x0041,levinekelly@mays.net,2022-03-26,https://www.evans.org/
25-Mar-2021,Interest,06.90,00.00,"50,208.22",B9DCaC19254369b,4975,Dominique,Tapia,Meadows-Cooley,Lake Garyborough,French Polynesia,857-570-8724x2249,2200454553,sherryellison@garza.com,2020-09-19,http://mcintyre.info/
25-Mar-2021,NEFT,"221,818.50",00.00,"272,026.72",40541FBBd3BE5cD,7879,Leonard,Solis,Huang-Todd,South Herbert,British Indian Ocean Territory (Chagos Archipelago),001-008-456-7921,001-036-531-1866,bridgesnina@michael.org,2021-11-25,http://www.marquez.net/
25-Mar-2021,Cash,"21,509.00",00.00,"293,535.72",c1d0D052f1DB157,4254,Jane,Dougherty,"Gross, Maxwell and Maldonado",Ethanberg,Macao,(236)699-9758x64133,576.345.7437x171,spencergavin@bell.net,2021-05-26,http://www.butler.com/
25-Mar-2021,RTGS,00.00,"29,353.57","264,182.15",C92BeD3171FDf62,5883,Mckenzie,Alvarado,Hoffman LLC,Casefurt,Saint Martin,5872657076,716.183.6630,gnolan@price-lucas.com,2020-05-04,http://petersen.com/
25-Mar-2021,Miscellaneous,00.00,"29,353.57","234,828.58",f9Da46dDaF2FccC,6230,Alfred,Pena,Franklin LLC,Colliertown,Thailand,001-251-341-7476x1026,415.058.0950,gabrielleroach@li.org,2020-01-19,https://www.duffy.com/
25-Mar-2021,Tax,00.00,"39,138.10","195,690.48",1FEC8C58A1E88d3,5026,Jared,Ward,Flynn Group,East Deanberg,Libyan Arab Jamahiriya,(703)985-9509x6481,001-727-784-2161x1360,brockjasmin@hardy.biz,2021-06-02,http://www.stark-colon.com/
25-Mar-2021,Miscellaneous,00.00,"65,230.16","130,460.32",2DEFEfcAAf640aB,6891,Lynn,Arroyo,"Herring, Arroyo and Ashley",West Isabellatown,Gabon,992-775-4658x4598,(665)303-4574x947,kevinmullins@levine.biz,2021-08-28,https://www.holden.com/
26-Mar-2021,Debit Card,"213,330.00",00.00,"343,790.32",9E4b0DD1C2B3C75,3210,Alexander,Navarro,Chase-Wilkins,Paynemouth,Uganda,707-146-2865,001-821-174-1865x56850,rollinseugene@wilcox.org,2020-08-22,https://www.espinoza.com/
26-Mar-2021,RTGS,289.80,00.00,"344,080.12",f575ca97eaB6e8C,835,Latoya,Floyd,Buchanan-Cervantes,South Brittney,Libyan Arab Jamahiriya,(892)350-5679,472.477.3220x1735,apotts@dalton-reese.com,2020-09-09,https://pollard.com/
26-Mar-2021,ATM,268.46,00.00,"344,348.58",dDafEe6ABcCCEFB,7905,Mariah,Hughes,"Booth, Hunter and Rubio",Lake Melody,Turks and Caicos Islands,291-023-3739x1083,(630)482-0425,sherriyang@marshall-yates.net,2020-01-01,http://davies.com/
26-Mar-2021,Interest,00.00,"86,087.15","258,261.44",DEdB10454953F9B,5786,Erin,Barrera,"Weiss, Lowe and Myers",New Robertshire,Uzbekistan,(418)814-1588,001-560-636-9101x973,jane26@riddle.biz,2020-02-28,http://www.little.com/
26-Mar-2021,Debit Card,00.00,"28,695.72","229,565.72",2Db0AaFa22F73Ff,5790,Connor,Hill,Vance-Schaefer,Lake Andrew,Monaco,001-558-197-3607,008.347.3877x20921,aimee09@davies-edwards.net,2020-05-21,https://pierce.org/
26-Mar-2021,Debit Card,00.00,"22,956.57","206,609.15",3b0B5103EB8e5dF,5353,Tonya,Hess,Washington-Ibarra,New Shawnmouth,Reunion,001-305-222-2750,277-128-6594x461,ogalvan@perkins.com,2021-01-12,http://www.martin.com/
26-Mar-2021,ATM,00.00,"29,515.59","177,093.56",Aa6c730c2c53EcD,8412,Stanley,Richard,Wiley LLC,Santosberg,Korea,235-644-9245,054.490.3842x311,nle@salazar-cabrera.info,2020-07-07,http://vega.biz/
26-Mar-2021,Cheque,"1,530.00",00.00,"178,623.56",bd2FCeDCa54DA5a,5819,Geoffrey,Logan,Poole-Bowen,East Betty,Fiji,+1-362-389-3511,001-836-852-1579x270,kathleenjames@wilson.org,2021-07-10,https://www.rivera-maynard.com/
26-Mar-2021,ATM,"1,369.00",00.00,"179,992.56",6d87FB8851ff2Fb,802,Claire,David,Herring-Mitchell,Donaldhaven,Marshall Islands,(690)732-2285,880-984-8398,allisonbush@mccormick.net,2021-09-28,https://www.ponce.info/
26-Mar-2021,Transfer,04.11,00.00,"179,996.67",CdFECf4FE6aFfD4,7290,Brent,Ponce,"Cannon, Riggs and Parsons",South Kathy,Iceland,001-036-890-8672x2325,887.653.7589,scastro@collins.com,2020-03-24,http://www.rivera.com/
26-Mar-2021,Cash,112.10,00.00,"180,108.77",BF6AaBE141d74B4,5714,Juan,Jordan,Parks-Mcpherson,Darinfurt,Libyan Arab Jamahiriya,003-721-0376,026-150-3103,kempalexander@finley-allison.org,2020-10-17,http://www.reese.info/
26-Mar-2021,IMPS,00.00,"45,027.19","135,081.58",DdDcEabdE9f9587,5421,Jaclyn,Mcintyre,Conrad PLC,Christineton,Falkland Islands (Malvinas),+1-780-845-0989x996,001-988-124-0214x265,washingtonclaudia@mcgee.net,2020-10-28,https://www.esparza.biz/
26-Mar-2021,Cheque,"1,871,105.50",00.00,"2,006,187.08",387b57da0dC94B0,5166,Alexandria,Mcintyre,Meyers LLC,New Sherriborough,Brunei Darussalam,904-453-6975,(734)439-9764,deanmendez@torres.com,2020-03-10,http://www.melendez-farley.biz/
26-Mar-2021,Debit Card,00.00,"222,909.68","1,783,277.40",390de3b1476207E,7001,Valerie,Blair,"Reeves, Hernandez and Goodwin",East Debra,Isle of Man,2387750009,395-955-1702,hinesanita@gonzalez-gill.com,2021-10-09,http://dudley-cunningham.com/
26-Mar-2021,Miscellaneous,00.00,"445,819.35","1,337,458.05",E66A1B4B2C89E3C,3175,Alexa,Villanueva,Guerrero-Wilson,North Brittanychester,Thailand,001-224-515-9399x08368,(203)989-0097,bridget60@nunez.com,2022-04-12,https://www.burgess.com/
26-Mar-2021,RTGS,00.00,"167,182.26","1,170,275.79",C41Cc6C9AD0fA46,3551,Cindy,Sampson,Hendricks-Mcpherson,Glendamouth,Burkina Faso,079-216-9306,001-810-380-0755,evansalexandra@tanner.biz,2020-12-15,http://li.info/
26-Mar-2021,Miscellaneous,00.00,"146,284.47","1,023,991.32",bfCcdaFA3086F2C,8233,Rick,Morgan,Robertson Group,New Kelliburgh,Saint Vincent and the Grenadines,+1-198-971-9606,(708)016-3510x3838,robindean@yates.com,2020-12-07,http://whitney-cochran.com/
26-Mar-2021,Interest,00.70,00.00,"1,023,992.02",fA7fEB61B6B6cFA,8592,Rachael,Fisher,Holloway and Sons,Lake Betty,Grenada,889-232-5309x8929,521-843-1335,progers@hicks.net,2022-02-17,https://www.meyers.com/
26-Mar-2021,IMPS,00.00,"113,776.89","910,215.13",B6bdB2dEB14314e,6261,Cynthia,Ayers,"Riggs, Blevins and Ingram",South Joannaburgh,Cote d'Ivoire,553-496-1686,001-998-346-9650,chelseydurham@archer.info,2021-07-01,http://harding.com/
26-Mar-2021,Purchase,00.00,"101,135.01","809,080.12",fEB05baEc5ba41d,27,Emily,Calderon,Todd-Acosta,Lake Sallyport,Cameroon,038.443.6100,618.908.5890,shelley82@jarvis.com,2021-06-17,http://www.larsen.org/
26-Mar-2021,Transfer,194.88,00.00,"809,275.00",c0b8e6254F657B2,6847,Molly,Beck,Ray Inc,Shawland,Norfolk Island,231-385-7521x6416,+1-363-564-9606x1648,kelliereese@love.info,2021-03-07,https://stanton.com/
26-Mar-2021,Cheque,"2,087.80",00.00,"811,362.80",E9C8790fD0dD6DC,6193,Tristan,Mccoy,Silva-Barnes,Franklinville,Portugal,001-021-023-7986,381-553-4337,wgreer@mckenzie.info,2021-05-17,https://www.murphy.com/
26-Mar-2021,Commission,899.00,00.00,"812,261.80",f4aD7548C1c3C9C,5320,Michael,Daugherty,Paul-Reilly,Bobview,Saint Martin,(557)411-6536,058-979-3609x690,bryantmelinda@leblanc.biz,2021-04-04,https://ortiz.net/
26-Mar-2021,Transfer,"10,291.60",00.00,"822,553.40",846eFdCc7dC3da4,5860,Malik,Henderson,"Salinas, Kline and Austin",West Carly,Saint Pierre and Miquelon,001-333-398-0191x263,(967)236-5311x13603,spencerangie@fuentes-finley.com,2021-04-08,http://www.hicks.com/
26-Mar-2021,Commission,00.00,"82,255.34","740,298.06",9A6D2cedCcbc530,8584,Cassie,Ellison,Acosta-Sims,Keithshire,Finland,+1-702-339-9728x09691,+1-697-870-1662,kristameza@eaton.com,2020-01-22,https://www.hull-benitez.com/
26-Mar-2021,RTGS,00.00,"74,029.81","666,268.25",Fecc9aeD6354b30,9055,Jimmy,Estrada,Benitez and Sons,Kellyland,Samoa,(083)128-6767x78772,(677)923-9858x552,foxxavier@fernandez.com,2020-02-28,http://oconnell.org/
26-Mar-2021,Commission,"18,978.69",00.00,"685,246.94",bBa3FB624C7d5A0,7030,Parker,Buck,Mullen-Hodges,Lake Joditown,Burkina Faso,919-562-7423x1895,+1-012-506-4252x6240,chase32@rivers-shah.com,2021-10-11,http://carson.com/
26-Mar-2021,Interest,00.00,"171,311.74","513,935.20",8F9aC59a14BdE6C,4485,Brandon,Porter,Dalton Ltd,Mcclainville,Australia,001-817-218-2513x42503,7194278382,dennis26@mathews.com,2021-09-13,http://lucero.com/
26-Mar-2021,Miscellaneous,06.20,00.00,"513,941.40",2d0350E8496fA6a,9319,Jordan,Collier,"Delacruz, Sweeney and Mckenzie",Lake Glenborough,Togo,(588)467-4616,001-144-555-7902,eddiewhite@short.biz,2020-07-01,https://www.benjamin-petersen.org/
26-Mar-2021,ATM,"487,869.00",00.00,"1,001,810.40",4b67bfFCAe4853A,1283,Mathew,Proctor,Mcneil Ltd,Hoshire,Sri Lanka,(847)740-0284,(099)798-3345x631,pconrad@hendricks-frye.com,2020-03-11,http://www.carson.info/
26-Mar-2021,IMPS,00.00,"100,181.04","901,629.36",faBBE357AeDfaEC,7185,Jenna,Gill,"Morgan, Hubbard and Frank",North Christinafurt,French Polynesia,351-716-7821x522,2071347420,jasmin32@wallace-hawkins.com,2021-05-13,http://www.sanchez-holder.net/
26-Mar-2021,Reversal,00.00,"901,629.36",00.00,aaEAbf6C5EC23C2,1811,Gloria,Anthony,Pierce Inc,Soniafort,Barbados,001-209-995-5970x830,601-551-6979x23749,samanthamccall@conley.com,2021-11-09,http://www.reyes.net/
26-Mar-2021,RTGS,"253,917.06",00.00,"253,917.06",843afba349DEaFC,7887,Meghan,Proctor,Wyatt-Fields,Lake Shirleyport,Tonga,+1-608-142-2795x14429,001-959-621-1718x74913,shahkathryn@garza-acosta.com,2021-10-04,http://chandler-terrell.com/
26-Mar-2021,Transfer,00.00,"25,391.71","228,525.35",61ce30f9aA1a9C6,7861,Susan,Mcclure,Forbes Inc,Port Randallchester,Greenland,785.552.5785,001-445-850-0325x036,mandyyoung@finley.org,2021-10-27,https://www.berger-padilla.com/
26-Mar-2021,Interest,00.00,"25,391.71","203,133.64",Fd3e45dA3E9f46B,3967,Glen,Pittman,Brown-Hensley,West Tashaborough,Norway,+1-528-305-4978x5200,824-328-7168x29966,losborn@rhodes.com,2022-04-19,http://valencia-hunter.net/
26-Mar-2021,Interest,38.26,00.00,"203,171.90",0eFeA9aBcc73eBF,2982,Philip,Salas,Calhoun-Farley,Woodwardstad,French Polynesia,(472)273-5884x4355,794-270-1006x9880,patricia07@joseph-deleon.biz,2020-05-18,https://www.lyons-holmes.biz/
26-Mar-2021,IMPS,406.70,00.00,"203,578.60",81c60de7e3732Bc,6407,Lindsay,Oconnell,"Mercer, Moon and Kaiser",Cassandraland,Bahamas,448-821-5930x9623,+1-923-096-2857x3830,matthewacevedo@mcfarland.info,2021-06-25,http://www.lowe-richardson.com/
26-Mar-2021,ATM,00.00,"33,929.77","169,648.83",bFedD64adf4C5Bc,2351,Nathan,Massey,Hanson-Calhoun,East Tim,Brunei Darussalam,001-489-853-1900x21332,(745)389-5620x072,rhorton@harrison.net,2021-04-15,https://haynes-bates.com/
26-Mar-2021,Transfer,00.00,"24,235.55","145,413.28",0D8ddA3FEC39Dad,242,Karl,Stephens,Christensen-Gibbs,Horneton,American Samoa,516.383.5282,521-217-9034x306,miguelmathis@crawford.info,2022-05-03,https://burnett.com/
26-Mar-2021,IMPS,"1,015.50",00.00,"146,428.78",E520ccbAd7CB37F,6616,Susan,Tucker,Stanton-Gray,Vanceview,Lebanon,319.562.0897x11594,247-885-8400x187,velezalvin@hancock.com,2022-03-22,http://www.mays.com/
26-Mar-2021,Reversal,00.00,"48,809.59","97,619.19",ba7aCbA2f4CfEf4,2800,Alexa,Burton,Morse-Mclean,Port Ralphfurt,Cook Islands,537-812-9009,658-668-5354x1770,nmeadows@schroeder.com,2020-11-28,http://pena.org/
26-Mar-2021,Bill,00.00,"48,809.60","48,809.60",fAcabaBab61992d,2094,Maria,Khan,Chavez LLC,South Shawnton,Saint Martin,884.791.1649,(440)597-9229x8001,rkane@stark.com,2020-11-03,https://www.le.com/
26-Mar-2021,IMPS,02.20,00.00,"48,811.80",ADBDc0979A2cB5b,3593,Maria,Nolan,"Rivera, Floyd and Lucas",Marquezhaven,India,001-298-118-3215x5845,519.079.1582x2757,hayleychapman@petty-austin.com,2020-05-06,https://www.cannon-callahan.org/
26-Mar-2021,Purchase,"968,964.00",00.00,"1,017,775.80",AEC966c6EbEEd02,245,Sonya,Savage,Lynch and Sons,New Paulmouth,Paraguay,001-524-066-4043x946,427-771-8849x39563,cheyenne64@solomon.net,2021-04-29,http://terrell.biz/
26-Mar-2021,Purchase,220.50,00.00,"1,017,996.30",Ff6adCd1bdFbac5,4861,Madeline,Moyer,"Bowers, Daugherty and Key",Lake Blake,French Guiana,(710)702-7943,428.564.3700,ilowery@melton.com,2021-02-11,https://prince.org/
26-Mar-2021,Reversal,515.00,00.00,"1,018,511.30",5b64B8FaD5Fc702,8940,Keith,Mcfarland,"Stanton, Griffith and Marshall",North Sheenamouth,Equatorial Guinea,001-617-436-1720x2596,(224)436-7066x390,acostamorgan@freeman-perry.net,2021-05-14,https://durham-obrien.info/
26-Mar-2021,Tax,04.52,00.00,"1,018,515.82",fCDEbc9aEF7a098,7111,Krista,Wagner,"Mckee, Mayer and Norton",South Sonia,Belgium,434-855-6498x9122,211.717.6695x483,nroberson@yang.com,2020-11-22,https://www.fitzpatrick.com/
26-Mar-2021,Cheque,00.00,"169,752.64","848,763.18",75eff8a1c363EAe,2460,Xavier,Gordon,Woods PLC,Navarrobury,Andorra,460-020-7429x110,(400)001-5850x0976,rebeccaestrada@mooney-blackburn.net,2021-07-24,https://www.ford-pruitt.com/
26-Mar-2021,Debit Card,"9,792.32",00.00,"858,555.50",FdD7aa9c3c9a447,5027,Kylie,Bender,Colon-Schmidt,New Franciscoport,United States Virgin Islands,603-069-7960,689.225.4123x0611,warearthur@tanner-eaton.com,2020-03-29,https://valencia.biz/
26-Mar-2021,Commission,536.50,00.00,"859,092.00",0A9f8DD789EA1B0,8870,Marissa,Molina,"Underwood, Mckee and Blackburn",East Jake,Tanzania,673-415-1649,+1-813-193-1610x7548,cassandra13@byrd.com,2020-01-15,http://faulkner-owen.net/
26-Mar-2021,Debit Card,00.00,"95,454.67","763,637.33",DC450d0a2bDAcda,9891,Perry,Moon,Horn-Kim,Port Jay,Netherlands Antilles,001-564-166-7158x0428,(207)678-0218x226,hooperedgar@strickland-wilcox.info,2022-05-11,https://trevino-raymond.info/
26-Mar-2021,RTGS,00.00,"381,818.67","381,818.66",07076DBd0216DC7,7377,Edwin,Roberson,"Chandler, Ewing and Holt",West Pamelamouth,Niue,8984931458,596.514.7174x56091,alivingston@salas.com,2020-10-01,http://www.sanford.org/
26-Mar-2021,RTGS,"238,701.94",00.00,"620,520.60",bEcb134FeCc4fD5,1548,Kenneth,Harris,Marks-Farmer,Port Brandy,Macedonia,774-937-5625x89638,408-223-4142x1543,blake59@jefferson.com,2022-01-10,https://www.marquez.net/
26-Mar-2021,ATM,00.00,"620,520.60",00.00,D69C3ef77AbD0eC,6894,Lee,Glenn,Levy PLC,Virginiahaven,Mozambique,825.540.6318x10917,001-186-903-6412x18707,jaclyn71@wright.org,2020-02-20,https://www.morrison.info/
26-Mar-2021,Purchase,"8,984.90",00.00,"8,984.90",805Ccb6ec08EFcA,6730,Miguel,Duffy,"Vaughan, Glover and Shepherd",Mejiafort,Kiribati,4568228143,(898)593-5264,hwise@lowery.info,2021-01-09,https://www.hatfield.com/
26-Mar-2021,Transfer,00.00,"1,123.11","7,861.79",B29FCfBfD746fF7,2475,Susan,Mendoza,Golden LLC,Hurleybury,Albania,272.960.6989,001-644-278-2645,jared30@mays-clarke.com,2021-07-16,https://pittman.com/
26-Mar-2021,Interest,00.00,"7,861.79",00.00,8dB6BffFd9eB25A,9198,Jenny,Conrad,Carrillo Ltd,Wandaville,Taiwan,001-929-058-6696x983,(078)184-5447x81924,eyork@key.com,2022-02-15,http://www.dunn-mclean.biz/
26-Mar-2021,Debit Card,"812,018.00",00.00,"812,018.00",BAA4B9B03b4fBec,5955,Robert,Glenn,Molina-Munoz,Helenland,United States Virgin Islands,(716)435-1599,599.192.4682x99017,breannachan@hays-chaney.org,2020-03-09,http://bradshaw.org/
26-Mar-2021,Reversal,00.00,"116,002.57","696,015.43",d0813Ac7Ece4c58,431,Herbert,Tran,Mcintyre-Gaines,West Gerald,Bolivia,415-536-8137x415,307.873.0334x73452,meadowsmandy@baker.info,2020-11-22,https://www.bell.com/
26-Mar-2021,Transfer,10.00,00.00,"696,025.43",1a7cED1E5b8Cc1b,6968,Misty,Moody,Michael-Mcguire,East Austin,Dominica,828-525-2286x453,681-274-1259,ediaz@pruitt.com,2021-11-01,https://reed-peters.net/
26-Mar-2021,Cheque,00.00,"87,003.18","609,022.25",B25B0d4Fe18aBaF,5260,Valerie,Salinas,Montes Inc,North Rebecca,Ecuador,556.816.2235,001-399-480-1899x054,knightclaudia@mcgee-carr.net,2020-10-05,https://sanders.com/
26-Mar-2021,Bill,"159,850.70",00.00,"768,872.95",fb1AFBcFcBEaFa2,6275,Janet,Hickman,"Bailey, Leblanc and Fox",South Robertburgh,Guinea,+1-034-322-0845x403,+1-756-238-0882,rollinsyvette@roman.com,2021-05-26,http://www.hansen-mckenzie.net/
26-Mar-2021,Reversal,"146,894.00",00.00,"915,766.95",aFeDEcB7a57cC5E,5267,Rhonda,Mcdowell,Howell Group,North Casey,Portugal,815-607-1889,620-786-6452x3278,fbenitez@reynolds.com,2022-05-22,https://horne-erickson.com/
26-Mar-2021,NEFT,00.00,"91,576.70","824,190.26",BdBBE23cbE34aAE,6075,Matthew,Conway,Eaton LLC,North Corey,Dominican Republic,371-229-8009,409-456-1500,bernardmelissa@bruce.info,2022-01-20,https://morales.biz/
26-Mar-2021,NEFT,00.00,"137,365.04","686,825.22",F97f1ffBF7eD33E,453,Destiny,Snow,Duffy LLC,Brentshire,United States of America,873-940-1704x5312,(066)607-0041,alejandro05@bradshaw-chen.com,2020-10-18,https://weiss.com/
26-Mar-2021,Tax,06.72,00.00,"686,831.94",F741c07E6Fc5Bc9,9081,Renee,Kim,"Coffey, Sanford and Cochran",Herringport,Sudan,+1-054-331-4186x805,+1-509-796-8999x8068,wherring@rangel.com,2020-11-06,https://www.page.org/
26-Mar-2021,Purchase,"39,327.20",00.00,"726,159.14",578ebD0cfbefcd7,3828,Bianca,Hutchinson,Shah PLC,South Seth,Germany,8190244592,965.815.1973x439,msingh@olsen.com,2021-07-24,https://floyd.com/
26-Mar-2021,Reversal,00.00,"363,079.57","363,079.57",40edeA3A08EdfaD,8429,Douglas,Potter,Mccann Ltd,New Chelseyberg,Chile,(503)194-2318,274.554.9254,ethan02@gould-kerr.com,2021-06-16,http://www.hendrix.com/
26-Mar-2021,Interest,"2,346.60",00.00,"365,426.17",AE5491deEabb28b,8091,Sara,Stone,Newton-Donaldson,North Kristamouth,Czech Republic,340.011.9630x02127,+1-608-123-7519,gavinschneider@heath.com,2021-02-18,http://www.cortez.com/
26-Mar-2021,Bill,"67,903.41",00.00,"433,329.58",2249B1c2EdCABFc,7486,Tracey,Cordova,"Solis, Barton and Hanna",Hardingborough,Isle of Man,001-944-099-8613x071,944-278-3348,alvinrobbins@ray.net,2020-06-13,http://www.newton.com/
26-Mar-2021,IMPS,"978,213.00",00.00,"1,411,542.58",f7E6886FD2e1f5a,1193,Cathy,Castillo,"Browning, Fitzpatrick and Benton",West Ellen,Burundi,(927)325-4936x23547,(224)783-0325,fmckee@vaughan-spencer.net,2021-05-19,https://www.mooney.com/
26-Mar-2021,NEFT,00.00,"282,308.52","1,129,234.06",6e42CaAF7ba5C39,2027,Teresa,Weiss,"Gould, Reyes and Rosario",East Caseytown,Burkina Faso,831-586-0499x751,9988598791,cummingsstanley@snyder-stark.net,2020-01-26,http://wade.com/
26-Mar-2021,Tax,16.90,00.00,"1,129,250.96",3076E7ffaBC5D2A,8830,Jason,Clarke,Brewer-Walls,Port Lance,Heard Island and McDonald Islands,172.440.6818,+1-520-500-4917x922,bateseileen@mcgee-buck.biz,2022-02-12,http://jacobson.com/
26-Mar-2021,Bill,00.00,"161,321.57","967,929.39",86d47d9E2dCA0EB,5812,Charlotte,Potts,Reyes-Hensley,Luisbury,Isle of Man,+1-608-354-4406x638,281.167.3549,ebonydorsey@dominguez.com,2022-02-01,http://www.zuniga.com/
26-Mar-2021,NEFT,00.00,"967,929.39",00.00,738acfe13dCc4df,3748,Alejandro,Maddox,Wood-Hurley,West Miguel,Isle of Man,646-239-3723x42912,011.550.2152x515,ashley19@cardenas.info,2020-09-19,http://lozano.com/
26-Mar-2021,Cheque,00.50,00.00,00.50,ea0dcDf4824aCfC,4999,Cameron,Barajas,Valenzuela Inc,Dickersontown,Ethiopia,3782980318,623-102-1087x53065,richardsonwanda@bowers.com,2020-12-12,http://www.maldonado.com/
26-Mar-2021,Transfer,00.00,00.10,00.40,aA53aA6475331EA,7606,Caitlyn,Andrade,"Kirby, Stein and Molina",Melodyberg,Mongolia,120-015-0284x368,558-816-3985,pconner@shaffer.com,2021-01-11,https://www.melton.com/
26-Mar-2021,Transfer,398.70,00.00,399.10,27BA6ccF0BD9233,5355,Geoffrey,Vang,Bonilla and Sons,Patelborough,Swaziland,001-922-835-4371x63464,(117)307-4642,sergio33@hicks-cantrell.com,2020-07-23,https://peters.com/
27-Mar-2021,Interest,00.00,133.03,266.07,1CA8C4717a69edD,761,Jean,Melton,Ortiz-Hansen,Brandonmouth,Philippines,001-248-294-1601x96152,(710)472-9518,chambersaimee@carpenter-villegas.net,2021-04-16,https://ellis.com/
27-Mar-2021,Purchase,00.00,29.56,236.51,2a3c52D94a8FDCF,1798,Rebecca,Scott,"Schneider, Fischer and Soto",Brendanside,Seychelles,001-697-288-6176x3335,(925)404-5066x6239,woodwardalicia@davenport.com,2022-03-12,https://www.whitehead.info/
27-Mar-2021,Debit Card,05.47,00.00,241.98,bb8dcCDDF4fedF4,8734,Parker,Farley,"Cannon, Leblanc and Travis",South Tamara,Saint Pierre and Miquelon,450-682-8429x99230,674.457.4756,padilladiana@clements.com,2021-03-04,http://www.ashley.org/
27-Mar-2021,IMPS,541.82,00.00,783.80,Eb1DCE0f0a92F4E,8385,Grant,Howard,Castaneda-Mcconnell,Gilbertland,Qatar,6273662148,(454)810-8270x334,dmoses@cowan-french.com,2020-08-28,http://www.acosta.com/
27-Mar-2021,Bill,00.00,391.90,391.90,8b3D1009Aac9d2a,4093,Peggy,Harrison,Cochran-Silva,North Desireemouth,Albania,459.908.5695,(147)705-8895,iblair@duran.org,2022-05-04,https://www.cameron.com/
27-Mar-2021,Miscellaneous,00.00,195.95,195.95,F8775a0B1d3504E,2564,Carrie,Mcgrath,Garner-Dunlap,Lake Ana,Brazil,386-657-5617x38751,001-059-021-2523x607,marshearl@santiago-sosa.com,2020-04-13,https://www.reyes.com/
27-Mar-2021,Bill,00.00,27.99,167.96,68fbb98f6EbD971,421,Jack,Robbins,"Choi, Galloway and Fox",Kevinbury,Norway,001-084-704-0454x28664,330.200.8023,haasderrick@ortega-kirk.org,2020-12-02,http://farrell.com/
27-Mar-2021,Transfer,739.39,00.00,907.35,E2fEF1bA17A5A4B,2454,Drew,Rubio,Daugherty-Cruz,New Melaniefurt,Somalia,0394431738,001-865-775-3311,barrybrittney@ramsey-villegas.com,2020-02-14,http://sandoval.com/
27-Mar-2021,ATM,"146,882.12",00.00,"147,789.47",b9486F1c7A71cC5,4751,Micheal,Lara,Dickson Group,New Rhondaborough,Guernsey,001-538-686-1526x327,7414425722,brittneyberg@marsh.com,2020-06-22,http://www.blair.com/
27-Mar-2021,Cheque,00.00,"14,778.95","133,010.52",824819341ec367f,5193,Kelsey,Roach,Vazquez and Sons,Kathrynfurt,United Kingdom,816-551-9052x61034,0068791886,janesilva@york-fleming.biz,2020-06-16,https://mann-fritz.com/
27-Mar-2021,Debit Card,00.00,"16,626.32","116,384.20",0dBACeBCCAED7De,4414,Traci,Lloyd,"Walters, Foster and Roberson",West Isaiah,Armenia,+1-632-371-3631,714-649-0694x09431,webbfrancis@park.com,2021-09-29,https://www.porter.org/
27-Mar-2021,Bill,"260,881.00",00.00,"377,265.20",b6A81E7b5e1c90c,3504,Christie,Logan,Marsh Ltd,Lake Catherinehaven,Congo,935.974.6105x772,638.692.4489,nathan96@ortiz-hendricks.com,2020-11-25,https://www.brewer.com/
28-Mar-2021,NEFT,06.17,00.00,"377,271.37",dEdbfF94CeE71f9,8693,John,Quinn,Sanchez-Daniel,Kirkberg,New Zealand,820-599-7125x2023,(817)886-0194,fcastaneda@conner.com,2020-08-27,http://chavez.com/
28-Mar-2021,Miscellaneous,00.00,"47,158.92","330,112.45",93fBece6A07Cbce,8913,Caitlin,Stanley,Espinoza and Sons,West Dylanton,Congo,362-226-7785,728-890-1221,herringariana@evans-stein.com,2021-05-08,http://www.kirby.net/
28-Mar-2021,Bill,271.27,00.00,"330,383.72",3C5ca1Dce7Aaa8f,1813,Kylie,Paul,"Hatfield, Hudson and Glass",Alisonbury,Croatia,200.335.5435,(148)492-5891x31274,tommy62@love.com,2021-04-06,http://delgado.com/
28-Mar-2021,Commission,00.00,"41,297.97","289,085.76",4c0c9c8Bde1eAE8,3985,Alison,Owen,Landry Ltd,Gregorychester,Saint Kitts and Nevis,133-278-8473x10568,+1-413-612-3215,harold01@camacho-whitaker.com,2020-03-30,https://www.callahan.com/
28-Mar-2021,Debit Card,"22,024.88",00.00,"311,110.64",8Ce1Fb6D34F288b,307,Wayne,Gomez,Owens-Hale,West Sonya,Vanuatu,+1-633-747-5786x82865,687-760-2164x42491,hollowaykatherine@jones.com,2020-06-05,http://www.le.com/
28-Mar-2021,Transfer,00.00,"34,567.85","276,542.79",7e7011B1Bf93ADd,2706,Lindsay,Orr,"Bullock, Whitehead and Brown",East Alexandramouth,Reunion,237-885-3808,(639)197-4418x6398,brenda20@higgins.com,2021-04-05,https://www.spears.com/
28-Mar-2021,ATM,27.25,00.00,"276,570.04",dc51B5d3ad086Bd,7997,Bridget,Bonilla,Oconnell-Lucero,North Spencer,Denmark,001-647-322-6470x47723,001-240-199-7601x519,nwhitaker@carney.com,2021-09-20,https://www.nielsen-waters.com/
28-Mar-2021,IMPS,"212,976.20",00.00,"489,546.24",DccfB536C1edb1a,8377,Cheryl,Fitzgerald,Hughes-Ingram,Lindaville,Belarus,+1-848-865-7480x4017,+1-565-443-9766x526,pritter@campos-dean.com,2022-01-24,http://www.riggs.com/
28-Mar-2021,NEFT,00.00,"163,182.08","326,364.16",788B10C4e9aaDEC,5733,Tanner,Scott,"Pace, Brock and Chapman",Lake Morgan,Lithuania,(542)772-6467x83972,4678750013,sheryljensen@huff.info,2021-11-30,https://carr.com/
28-Mar-2021,Commission,05.53,00.00,"326,369.69",F4cb549dA8a60f5,7545,Stephen,Conrad,Harrison-Jennings,Port Dwayne,Mauritania,592-863-1015,883-258-3342,chelsey99@conway.com,2020-05-11,https://www.fox-mason.net/
28-Mar-2021,NEFT,00.00,"32,636.97","293,732.72",70e9dE1206A6289,655,Cory,Hill,Shields-Goodman,Carlburgh,French Guiana,776.162.9236x1407,001-084-040-9669,sethstuart@wheeler.com,2021-12-30,https://singleton-huber.com/
28-Mar-2021,Transfer,00.00,"29,373.27","264,359.45",8F9e8A45A206a69,9292,Jackie,Wong,"Duran, Cortez and Mccullough",Lindseyland,Afghanistan,772-065-3283,892.689.9330x291,kathleenfranklin@cunningham.biz,2020-04-10,https://lyons.biz/
28-Mar-2021,Cheque,00.00,"29,373.27","234,986.18",51f787dBbddd8fD,6489,Adam,Morgan,Howard LLC,West Pam,Japan,(482)230-8599x83276,475-836-2860,pam66@fowler.com,2021-07-20,http://www.kent.com/
28-Mar-2021,Bill,00.00,"29,373.27","205,612.91",10778bb483F1c0C,1098,Stacy,Long,Blankenship Ltd,South Katelynton,Congo,(126)344-6570x544,600.473.7761,baileyhardy@burton-brewer.com,2020-03-10,https://www.durham.net/
29-Mar-2021,Cash,00.00,"68,537.64","137,075.27",3afF6b5bcdE5ECF,5953,Karina,Rogers,Webb Ltd,North Noahfort,Taiwan,041.102.0888x430,(059)090-1792,brianna78@parrish-mccann.biz,2021-08-25,https://brock-burgess.net/
29-Mar-2021,Interest,301.00,00.00,"137,376.27",B34Ec6B249b67E8,439,Summer,Hancock,Kline-Wang,Larsenchester,Gibraltar,+1-870-872-8194x77839,(045)317-6109,rmcknight@bryan-king.com,2021-02-26,https://stevenson-arnold.com/
29-Mar-2021,Reversal,921.89,00.00,"138,298.16",d1C9Ac510126AE5,5814,Melvin,Duran,"Barnes, Roman and Benjamin",Hickmanfort,Taiwan,332.072.8323x8464,(290)081-3408,patrickalec@clements.com,2021-01-27,http://osborn.info/
29-Mar-2021,Tax,00.00,"15,366.46","122,931.70",eFa1Fcac802AB58,6776,Kiara,Gates,Lam Group,Kramerchester,Israel,234-823-5024x4575,(257)727-7725x7886,tmaxwell@mosley.net,2020-06-09,https://mays.com/
29-Mar-2021,ATM,383.00,00.00,"123,314.70",4f6D7bFFE3147a5,2782,Roy,Cummings,"Copeland, Ellison and Rodgers",Gilbertside,Antarctica (the territory South of 60 deg S),840-204-7560x3176,001-265-750-0029x88575,virginia98@cervantes.com,2021-05-16,https://price-cooley.com/
29-Mar-2021,RTGS,00.00,"20,552.45","102,762.25",8b7fA1F50B94E8a,3615,Mia,Woods,Robinson-Turner,North Yvetteview,British Indian Ocean Territory (Chagos Archipelago),(312)361-6998,001-401-693-4463x5674,diana58@cherry.com,2022-04-01,http://www.ibarra.com/
29-Mar-2021,Reversal,"9,825.00",00.00,"112,587.25",15B07b57eca7dcf,8425,Micheal,Flynn,Wheeler-Sampson,Walterburgh,United States Minor Outlying Islands,(327)939-7358x324,328-273-5007,gravesariel@white.com,2021-11-19,https://donovan-odonnell.com/
29-Mar-2021,Tax,00.00,"22,517.45","90,069.80",28222e5eF08907A,5416,Carol,Hull,Watkins-Mathews,South Haydenville,Uruguay,001-184-488-0831x41687,347.336.1982x72951,agould@joyce.info,2021-12-04,https://whitney.biz/
29-Mar-2021,Interest,05.27,00.00,"90,075.07",Bd6a6b630bDFaEd,7841,Eddie,Owens,"Shaffer, Sullivan and Heath",South Kayla,Sri Lanka,(725)882-1168x9141,8351542718,singletonjeffrey@klein.info,2021-04-15,https://www.brady.com/
30-Mar-2021,NEFT,00.00,"10,008.34","80,066.73",059e4fccDe20e8d,5713,Megan,Armstrong,Ochoa PLC,Natashaville,Korea,401.702.0903x15570,030-737-6213x33648,andre97@robbins.org,2021-11-10,https://alexander.com/
30-Mar-2021,Cash,00.00,"11,438.10","68,628.63",2aAf378Ec3bEa70,7509,Cory,Acevedo,"Meyers, Walters and Santiago",Elaineland,British Indian Ocean Territory (Chagos Archipelago),(099)740-5194x1244,051.282.9585x122,jermaine72@hoffman.net,2022-03-14,http://hoffman-stanley.com/
30-Mar-2021,Bill,00.00,"13,725.73","54,902.90",FFd28208C49B7e4,7914,Belinda,Trevino,"Reynolds, Brady and Hopkins",Kelliside,Azerbaijan,(831)512-8451x421,+1-133-322-5559x033,archermargaret@horn.com,2020-05-24,http://osborne-jenkins.com/
30-Mar-2021,Debit Card,00.00,"18,300.97","36,601.93",961cFe3BBa7eFbE,5468,Elaine,Howell,Bird Inc,Lake Jacobmouth,Malta,961-336-9313x0559,(454)802-1525,bryansharp@ferguson.com,2021-04-22,http://www.peterson-grant.com/
31-Mar-2021,ATM,00.00,"6,100.32","30,501.61",500aec857FFc945,5980,Stephen,Riley,Shepard Ltd,Port Katrina,Niue,+1-511-202-6207,925.348.2300,qbarr@landry.biz,2020-09-07,https://www.humphrey.com/
31-Mar-2021,Bill,00.00,"3,389.07","27,112.54",2BdA1E11E3c0cc0,5069,Cathy,Hernandez,"Peterson, Jackson and Holt",Yangville,Iraq,001-351-562-4488,+1-260-522-7161x9943,danacain@ruiz.info,2021-11-25,https://www.michael-coffey.net/
01-Apr-2021,Transfer,00.00,"4,518.76","22,593.78",Aec9C20C3086714,9854,Cory,Mccarthy,"Davies, Obrien and Olson",Guybury,Dominica,892.705.4715x903,001-274-687-2852,sonia11@berry.org,2020-04-01,https://brown-sanders.net/
01-Apr-2021,Commission,00.00,"3,227.68","19,366.10",0Df13a2dCeCF9CF,8411,Kristopher,Mcgee,"Green, Cardenas and Mayo",Moraburgh,Sao Tome and Principe,(551)640-3344,7312767380,stefaniegray@cowan.biz,2020-12-20,http://valentine.com/
02-Apr-2021,Bill,00.00,"3,873.22","15,492.88",0D3Cb620B4Ba8c7,1959,Leonard,Alvarez,Juarez LLC,West Natashachester,Gabon,001-519-669-3466x33083,+1-147-321-3306,prestonkirsten@carson.biz,2021-11-15,http://www.marks.info/
03-Apr-2021,Interest,"1,529,652.00",00.00,"1,545,144.88",FfDfEcc5FFFdA95,6781,Kenneth,Craig,"Wall, Walter and Page",Port Joel,Morocco,001-089-129-6082x036,+1-547-924-6453x2022,melanie55@kelley.biz,2020-07-05,https://www.escobar.com/
03-Apr-2021,NEFT,"30,583.00",00.00,"1,575,727.88",Be68a1f75F6cBCB,7681,Ross,Zimmerman,Dickson-Thompson,East Albertshire,Uruguay,304-826-2097x5386,001-750-249-2695x959,chelsea02@sharp-flynn.net,2020-12-22,http://www.holmes.com/
03-Apr-2021,Debit Card,00.00,"157,572.79","1,418,155.09",BBdA542d52Fab92,5877,Perry,Tyler,"Dennis, Morse and Elliott",Helenstad,Iraq,8169911264,007.696.3104,staffordlogan@walker-strickland.org,2021-05-21,https://hatfield.biz/
03-Apr-2021,Bill,00.00,"354,538.77","1,063,616.32",eE5a4e00d9Be04a,4740,Patrick,Hughes,"Blackburn, Fritz and Soto",North Taylormouth,Holy See (Vatican City State),002.356.5147x00309,5810688916,greg00@strong-chang.net,2020-11-30,http://www.summers.com/
03-Apr-2021,Interest,02.00,00.00,"1,063,618.32",d535Ccee51f5Cc6,236,Leslie,Ramos,"Stephens, Green and Dudley",Vaughnside,Montenegro,+1-004-914-0818,463-667-7297x27905,oscar33@holden-morrow.com,2022-03-23,https://maynard-madden.net/
03-Apr-2021,Interest,21.00,00.00,"1,063,639.32",a665c3eafa64f0c,1458,Rebekah,Vega,Brooks-Robertson,New Brianastad,Cuba,929.287.3088,3988011641,whiteheadcharlotte@khan-olson.net,2021-08-22,https://www.mahoney.com/
03-Apr-2021,Debit Card,01.82,00.00,"1,063,641.14",2bD048ACaDca22c,5917,Tamara,Dean,Mccarty Ltd,Ramseybury,Russian Federation,023-642-4171x14971,122-875-7981x8960,alexandra32@austin.biz,2020-03-13,https://weber-kennedy.info/
03-Apr-2021,Tax,00.00,"212,728.23","850,912.91",853538c4466BbB3,6420,Kristy,Mccarty,"Ruiz, Mccarty and Schneider",Kentview,Ecuador,001-604-508-4709,001-596-149-3411x0287,annette61@moreno-khan.com,2020-02-07,http://www.mccarty-sanford.org/
03-Apr-2021,Commission,00.00,"94,545.88","756,367.03",1fc98dC22ABc6DC,3718,Charlene,Hardin,Shah-Knapp,Tinaport,Mayotte,(726)082-5867,001-110-681-8415,danielleon@lutz.net,2022-02-07,https://www.stuart-santana.net/
03-Apr-2021,Cash,63.80,00.00,"756,430.83",1dc7fCAba09C885,3009,Eileen,Benjamin,Manning-Solomon,East Sara,Armenia,(695)414-1650,(004)505-9304,wesley80@sanchez.com,2022-04-01,http://www.jefferson-ramos.com/
03-Apr-2021,Purchase,35.70,00.00,"756,466.53",cfBfDCbDb52efAa,3820,Betty,Moody,Prince-Powell,Caseychester,Fiji,(940)834-5428x44477,(155)569-5841x169,doughertyroberto@davidson.com,2021-04-14,https://malone.com/
03-Apr-2021,ATM,"8,932.68",00.00,"765,399.21",31bE437Cb756CF5,5818,Mikayla,Tucker,"Vance, Rice and Kim",Kurtberg,Andorra,697-549-8712x532,216.940.9409,lucaspratt@pennington.com,2020-01-18,http://gonzales.com/
03-Apr-2021,Commission,00.00,"109,342.74","656,056.47",1fE2c9DfEa1bF3a,1319,Randy,Morton,"Colon, Compton and Booth",Port Carolborough,Bahrain,562.780.1287,001-568-013-2710x69644,mortonjermaine@hogan.com,2022-03-06,http://peterson-glenn.org/
04-Apr-2021,ATM,"252,327.00",00.00,"908,383.47",BDEBA17fbF7EbeF,4668,Kerry,Payne,Mercado-Joseph,Everettfort,Sierra Leone,001-061-692-0974x3943,(870)954-1338,icervantes@rocha-camacho.com,2022-04-01,http://www.sutton-livingston.com/
04-Apr-2021,Interest,00.00,"100,931.50","807,451.97",E0Dcf11fEBf29f8,4494,Bernard,Walls,Knox LLC,North Jeffreyport,Kiribati,+1-136-234-5210,001-054-480-5863x67674,darryl31@mendez.com,2020-03-17,https://cortez-chandler.com/
04-Apr-2021,Interest,00.00,"89,716.89","717,735.08",4d41c0F3D0f7Ea0,4997,Paige,Greene,Padilla PLC,Port Frederickbury,Israel,(146)941-9706,058.822.7544,abarajas@bright-yates.com,2020-01-01,http://www.roach.net/
04-Apr-2021,Reversal,"164,500.00",00.00,"882,235.08",C9F2caEBbD5d353,4181,Leon,Vega,Parsons Inc,East Isaac,United Kingdom,001-202-559-2980x597,(327)941-9788x239,mckenziewinters@marshall.org,2021-06-20,http://faulkner.net/
04-Apr-2021,Transfer,00.00,"147,039.18","735,195.90",BFfcFDCa5C283B0,9249,Ariana,Pittman,Crosby PLC,Alejandroborough,Kiribati,(943)308-4551x858,001-675-054-2581,odonnellwarren@chapman.com,2021-08-28,https://short-berg.com/
04-Apr-2021,Reversal,00.00,"735,195.90",00.00,F5304868DcBEa92,3604,Willie,Gibbs,Bautista-Boyer,Tonihaven,Turkmenistan,(408)981-0356,885-981-2022x3865,salasomar@hutchinson-shaffer.com,2021-08-04,http://www.mack.net/
04-Apr-2021,Commission,"5,817.00",00.00,"5,817.00",2fDf827eE3858eE,9575,Dawn,Faulkner,"Macdonald, Campbell and Hayden",Novakberg,Sri Lanka,001-582-106-9338x39405,(568)864-6439,relliott@carlson-forbes.info,2021-03-14,https://www.potter.net/
04-Apr-2021,Interest,02.90,00.00,"5,819.90",6bD1f9dF02aadA7,3008,Wayne,Harrington,Fischer-Chaney,Khanstad,Kazakhstan,7903661553,103-956-4670,cooleyaaron@valdez.org,2020-07-17,http://www.blackburn.com/
04-Apr-2021,ATM,00.00,"5,819.90",00.00,0Dc6fe9BAd4FE36,5653,Mark,Watts,Woods PLC,Johnnymouth,Christmas Island,987.134.8688x2077,+1-535-510-7290,upadilla@freeman.com,2020-10-04,https://boone.com/
04-Apr-2021,Tax,62.00,00.00,62.00,6C3b6B6D0AfCeCf,7867,Elijah,Fleming,"Spence, Mccormick and Jacobs",Lake Gabriellamouth,Somalia,682-867-3865,494-172-7750x711,tristansherman@wang.com,2020-07-11,https://clements-paul.info/
04-Apr-2021,ATM,"2,330.53",00.00,"2,392.53",7eeFb805E1b293a,7429,Jeremy,Frey,Ellis and Sons,Edwinfort,Grenada,467-591-3498,(891)144-3434x33655,bautistajeremiah@oneill.com,2021-07-29,http://hartman-valentine.com/
04-Apr-2021,IMPS,"13,218.75",00.00,"15,611.28",F5d03148eb09e8C,6632,Nancy,Livingston,Stark Group,New Nicholas,Albania,444.275.2143,001-341-584-8992,downsjorge@osborne.com,2022-04-19,http://www.pacheco.com/
04-Apr-2021,IMPS,00.00,"1,561.13","14,050.15",bEDe289068acADC,3714,Bob,Porter,Beck and Sons,Jasminestad,Germany,363.219.7100,413-584-6218x32972,jenniferstein@carter.info,2020-07-28,https://waters.com/
04-Apr-2021,Reversal,"1,274,743.50",00.00,"1,288,793.65",E6B6Dbd1cCCB900,1849,Meghan,Trevino,Pearson-Brooks,Port Edwardhaven,Honduras,+1-578-346-4552x90051,2012428909,geoffreyguzman@pace.com,2021-06-01,https://larsen.com/
04-Apr-2021,Purchase,03.73,00.00,"1,288,797.38",1FABa2F48E7F6b9,2888,Jody,Costa,Mcneil-Barajas,New Becky,Saint Barthelemy,001-992-047-4413,(485)368-4859x00400,hodgekurt@bass-mann.com,2021-05-26,https://hood.com/
04-Apr-2021,RTGS,"27,095.00",00.00,"1,315,892.38",765165e477658Fe,4412,Summer,Kemp,Hensley Ltd,East Jillian,Romania,+1-674-987-7314x70770,908.734.4537x55259,rhondaholder@mccormick-carter.com,2021-08-02,https://bush.biz/
04-Apr-2021,RTGS,00.00,"263,178.48","1,052,713.90",9CdA4fcbADED63e,4795,Daryl,Contreras,Mccarthy-Hopkins,Port Phillip,Northern Mariana Islands,716.629.6931x003,001-327-640-0015x317,gallowaychristian@norris.com,2021-03-22,https://buck.com/
04-Apr-2021,RTGS,37.50,00.00,"1,052,751.40",8F37E9Cb539Ab37,4624,Sandra,Herman,"Hughes, Bullock and Mayo",Lake Cole,Denmark,001-228-563-0044x89663,153.691.9404x0311,graypam@pruitt-benjamin.com,2021-06-18,http://www.torres.biz/
04-Apr-2021,Commission,00.00,"150,393.06","902,358.34",043B0085561b767,7283,Ian,Butler,Chambers-Quinn,Hayneschester,Pitcairn Islands,6769347145,805-676-0535,idavies@ayala.com,2021-10-03,https://www.mendoza.com/
04-Apr-2021,Transfer,"551,948.00",00.00,"1,454,306.34",C8eAE8D58C71CAE,248,Jay,Rosales,"Morales, Carpenter and Yoder",Hodgeburgh,American Samoa,6427544692,(806)799-8306,joanna47@davidson.org,2020-05-07,https://www.cochran-cook.com/
04-Apr-2021,Reversal,00.00,"290,861.27","1,163,445.07",4fA018fb372a8EF,2355,Ryan,Bradford,Bennett-Mcfarland,Lake Yvette,Macao,001-998-883-6818x3196,+1-063-013-0220x82289,haneysonia@petersen.info,2021-03-27,https://www.benitez-chavez.com/
04-Apr-2021,Bill,06.00,00.00,"1,163,451.07",E9fbc4E7D57E61E,5600,Jorge,Weaver,Rivas-Arias,Graytown,Uzbekistan,+1-944-231-8118x85897,423-066-7880x399,jenny70@lin.com,2021-10-17,https://macias.info/
04-Apr-2021,Interest,724.00,00.00,"1,164,175.07",1cda49fA77Ba7Ec,3654,Benjamin,Gregory,Lynch PLC,Robbinsside,Bulgaria,649.952.2410,001-735-773-8599x1508,collinsdon@huynh-duarte.com,2020-01-26,http://powers.org/
04-Apr-2021,Purchase,07.11,00.00,"1,164,182.18",20284c34EcbE37D,1897,Gregg,Shaffer,"Roberson, Mcclain and Bradshaw",West Kelly,Poland,229.729.0761x958,6189627017,travisstacy@orozco.com,2022-03-19,https://olson-gray.org/
04-Apr-2021,ATM,00.00,"388,060.73","776,121.45",e7B8101c86c8d5c,3373,Betty,Jarvis,"Gilbert, Montes and Hunter",West George,Panama,923.836.5919,051-879-1683x8682,autumnwarner@huang.org,2021-04-16,https://www.joseph.org/
04-Apr-2021,Interest,00.00,"97,015.18","679,106.27",7DcEd0B283DEcF6,7989,Collin,English,Moody Inc,South Troy,Zambia,6687464191,287-986-4620x6583,sdickson@dunn.info,2021-02-10,https://stanley.biz/
04-Apr-2021,RTGS,39.92,00.00,"679,146.19",cbE53dCBAD7DCd4,6319,Elijah,Knox,Horn-Riggs,Bradystad,United States of America,(822)937-3685x31944,+1-950-467-7849x6514,hsingleton@sanders.org,2020-11-01,https://www.johnson.com/
04-Apr-2021,Reversal,00.00,"97,020.88","582,125.31",91Bd624Ea6Dd56D,8489,Lynn,Franco,Mahoney Group,Port Benjamin,Iceland,001-623-107-8577,9822264272,brandonweaver@hendricks.com,2020-07-23,https://www.blackwell.com/
04-Apr-2021,Cash,"26,391.00",00.00,"608,516.31",0a9fe7D01D7628a,9838,Cheryl,Melendez,Ritter-Pratt,Moodyberg,Bangladesh,+1-221-543-2886,001-879-494-0698x40554,holderruth@nash.com,2020-01-24,https://www.vaughn.com/
04-Apr-2021,Cash,00.00,"202,838.77","405,677.54",A52a2d0FC786Aca,4187,Brendan,Davies,"Vazquez, Reilly and Costa",Tanyastad,Svalbard & Jan Mayen Islands,784-388-3248,(860)303-0662,keithhaley@hays.com,2020-05-07,https://cole.com/
04-Apr-2021,Miscellaneous,00.00,"405,677.54",00.00,Cef3AEf6c0e66FF,795,Tracey,Costa,Harmon-Graves,East Brendanbury,New Caledonia,611-021-3027x21053,440-140-6605,qrandolph@poole.com,2020-03-09,http://www.lawrence.com/
04-Apr-2021,RTGS,"1,226,925.00",00.00,"1,226,925.00",77Cf33c6Afe1bFc,5661,Samantha,Schmitt,Arias-Dixon,Solomonfort,New Caledonia,001-135-763-7078,899.978.3591,sarahpark@schultz.com,2020-01-27,https://www.campbell.net/
04-Apr-2021,Commission,00.00,"153,365.63","1,073,559.38",ec942239Da3DDA1,5030,Jenna,Hudson,Meyer LLC,North Summer,Tuvalu,8849418566,8087002897,angelica71@ortega.biz,2021-11-04,https://www.spencer-burton.org/
04-Apr-2021,Cash,"1,698,206.50",00.00,"2,771,765.88",9cdF03a6B65b1BE,678,Stacie,Turner,Carrillo-Lynch,East Heatherport,Nicaragua,001-024-760-6772x416,(353)642-4648x1291,daltonevans@keller.info,2021-06-18,http://reyes.net/
04-Apr-2021,Cash,00.00,"2,771,765.88",00.00,4B3aDB58ea4Ed5b,197,Rita,Serrano,Zhang PLC,Juanland,Montserrat,579.373.9493x60914,001-864-597-9599,vwhite@peterson-gould.com,2022-03-17,https://www.lambert-smith.biz/
04-Apr-2021,Cheque,"2,055,544.00",00.00,"2,055,544.00",A631028fcDEa4fb,7057,Jon,Mcclure,"Mullins, Haas and Carrillo",Sydneyberg,Singapore,979.195.0641,+1-273-369-5450x576,vincentwinters@benton.com,2020-03-04,https://bray-spencer.com/
04-Apr-2021,Miscellaneous,00.00,"2,055,544.00",00.00,d22A95B78B4AeaE,9076,Jason,Huber,Rocha-Lloyd,South Shannonside,Lesotho,(789)861-5337x836,001-861-324-1787x211,zunigatom@beasley-kirby.com,2021-04-14,http://yoder.net/
04-Apr-2021,Interest,226.90,00.00,226.90,9b70DDbA0fa6Def,5656,Dustin,Walsh,Murray and Sons,Chaneybury,Martinique,3168912917,(172)215-1305x32180,vickifranklin@kennedy-stephenson.info,2022-04-16,https://wilkinson.com/
04-Apr-2021,Miscellaneous,00.00,45.38,181.52,a6aA3FcD54F791B,3447,Ann,Waller,York-Kirby,Staffordhaven,Namibia,544-708-8621x054,(956)163-1587x3222,idorsey@beltran-knox.com,2020-11-19,http://washington-hall.net/
04-Apr-2021,Cheque,13.47,00.00,194.99,9de337CBe408A2C,8409,Ricardo,Macias,Terry-Molina,Gentryville,Nauru,+1-380-036-2068x5048,+1-102-878-3671x4509,jose35@odom.biz,2020-12-26,http://harmon-carlson.net/
04-Apr-2021,Reversal,04.00,00.00,198.99,EcdF6A25cAdbD64,7388,Mandy,Soto,Carey-Morgan,West Lori,Belgium,001-622-694-2181x120,354.830.4221,dwayne39@bell-stein.biz,2022-02-12,http://www.choi.net/
04-Apr-2021,Tax,00.00,49.75,149.24,C6c70E5d21DE2e2,4892,Nicholas,Rogers,Mcguire Inc,Caitlinburgh,Mozambique,(162)515-6422x9125,343.746.1372,tracyhoward@ward-barber.com,2022-04-02,http://www.thornton.biz/
04-Apr-2021,Transfer,196.71,00.00,345.95,8C0AEc5Ad5BfAEa,3514,Curtis,Sutton,Watkins-Knapp,Morganton,Madagascar,001-887-654-8828x33911,105.987.8893,ghester@dixon.info,2020-09-19,http://ramirez-payne.com/
04-Apr-2021,Debit Card,00.00,345.95,00.00,233D0C19b0eC933,6199,Lance,Bray,Brady-Harding,Lake Courtney,Kazakhstan,+1-242-939-8620,(541)236-5365x773,scarson@baldwin-estrada.com,2020-03-08,https://www.zimmerman.com/
04-Apr-2021,Interest,"542,570.00",00.00,"542,570.00",eC2077EFaaBacCc,8011,Katelyn,Petty,Wilkerson LLC,Gilbertmouth,Vanuatu,(660)836-6543x183,433.080.6973x0956,tracigoodwin@reynolds.com,2021-07-13,http://marshall-collier.biz/
04-Apr-2021,RTGS,00.00,"135,642.50","406,927.50",6b6CAdEDD30d275,3623,Kari,Vaughn,Vargas Inc,West Brittney,Sweden,975.394.3671x093,650.859.6613x008,lamdustin@roach.net,2021-04-11,http://clayton.com/
04-Apr-2021,Reversal,20.80,00.00,"406,948.30",AcB32b621dBDC09,5251,Jesus,Caldwell,"Gardner, Gilmore and Butler",Bonillamouth,Tunisia,001-637-510-7065x4620,802-204-6152x4848,bbowman@stanton-curtis.com,2020-11-26,http://dalton.com/
04-Apr-2021,Bill,02.00,00.00,"406,950.30",5036998Ab425e74,1478,Karla,Maldonado,Leach-Gilbert,Krystalville,Hong Kong,+1-292-843-6056,421-345-0261x624,wjenkins@page.info,2020-04-23,http://www.greene-morgan.info/
04-Apr-2021,NEFT,"10,637.00",00.00,"417,587.30",E2fEF1bA17A5A4B,2454,Drew,Rubio,Daugherty-Cruz,New Melaniefurt,Somalia,0394431738,001-865-775-3311,barrybrittney@ramsey-villegas.com,2020-02-14,http://sandoval.com/
04-Apr-2021,Miscellaneous,"673,738.50",00.00,"1,091,325.80",A4F6Df1d20bcd2E,849,Tommy,Mckay,Hendrix-Lin,Lake Dawn,Rwanda,(352)569-8658x959,546-229-9072x2302,valdezchristie@farrell.com,2021-06-29,http://espinoza-nolan.com/
04-Apr-2021,Cheque,00.00,"545,662.90","545,662.90",83F0B1D11A63aEB,7284,Ellen,Mcintosh,"Schroeder, Ramirez and Parker",Cynthiastad,Croatia,001-443-067-2044x65930,+1-051-015-0774x924,mullinstyrone@henry-weber.com,2020-06-06,https://www.winters.com/
04-Apr-2021,Reversal,"256,228.00",00.00,"801,890.90",9fDC942618dF0cb,3957,Jody,Jacobson,Bennett-Vang,Shariside,Sao Tome and Principe,+1-669-799-2435x91609,(431)613-1377,chadzhang@hancock.com,2020-06-02,https://www.madden.org/
04-Apr-2021,IMPS,00.00,"80,189.09","721,701.81",5aA40bA6BFEfdDE,745,Lacey,Hall,Stephenson-Moss,Virginiamouth,Lao People's Democratic Republic,001-959-410-3486x24290,(863)054-6195x48924,sydneyzavala@armstrong-bush.com,2021-04-04,https://www.stokes.com/
04-Apr-2021,Tax,00.00,"90,212.73","631,489.08",58AFDbCfcE0DCde,5716,Carl,Cardenas,Fitzpatrick-Bishop,Sheppardburgh,Sweden,001-166-638-8215x333,+1-777-284-4577,gamblehenry@fuller.com,2020-08-15,https://reeves-miranda.net/
04-Apr-2021,Transfer,00.00,"631,489.08",00.00,bB4bc97d03B0dd0,9305,Roberto,Villa,Richardson-Gallegos,Jacobsfurt,Albania,5941442960,098-492-5713x6038,pingram@faulkner.biz,2020-11-29,https://larsen.biz/
04-Apr-2021,ATM,"175,289.90",00.00,"175,289.90",1d4cdfC9229422F,7962,Jacob,Ochoa,Mosley-Potter,Dominguezberg,United States of America,001-746-039-3585,153-149-6110,kim44@jefferson.com,2020-07-03,http://velez.com/
04-Apr-2021,ATM,00.00,"43,822.48","131,467.42",adbCFFfBF1eABF0,1988,Wesley,Keith,"Vang, Shaffer and Gilmore",Suemouth,Ghana,+1-687-922-6577,(676)161-8782,kdominguez@moore.info,2021-02-14,https://case.info/
04-Apr-2021,Commission,"191,380.10",00.00,"322,847.52",E46e5aC532db578,1470,Roberta,Underwood,Lambert Inc,Prestonville,Antarctica (the territory South of 60 deg S),1457391664,(581)091-6999x3420,steven99@acosta.org,2022-05-06,http://mclean.com/
04-Apr-2021,Cash,24.60,00.00,"322,872.12",aD6f31e9Fcfed2a,6350,Randy,Cervantes,Ball-Torres,Dunnmouth,British Indian Ocean Territory (Chagos Archipelago),373.524.4064x8002,001-284-112-2711x68790,medinagavin@alexander.com,2021-04-29,https://www.bonilla.net/
04-Apr-2021,Debit Card,00.00,"53,812.02","269,060.10",66fcc960E6728A7,529,Colleen,Mcpherson,Waters PLC,Moralesbury,Burkina Faso,+1-914-039-1522x43899,667-355-8269x14996,nicolemacdonald@horn.net,2020-11-27,http://benson.org/
04-Apr-2021,RTGS,00.00,"29,895.57","239,164.53",eDdcfb47aa0d87E,8487,Stanley,Patton,Andrews Ltd,Lake Shelby,Anguilla,+1-574-527-4896x23045,001-546-480-6273x694,rothjason@sims-ashley.com,2021-01-12,https://poole-bender.com/
04-Apr-2021,Purchase,00.00,"29,895.57","209,268.96",bda31fE59E4E7C4,8079,Tina,Marquez,Skinner Group,Port Tammieview,Greece,518.278.3796,(695)636-0398,ntapia@dunlap.com,2021-10-17,http://www.gaines-todd.com/
04-Apr-2021,Miscellaneous,"32,545.00",00.00,"241,813.96",A57f47CEF3827Bd,345,Brady,Foster,Crawford PLC,Copelandmouth,Chad,973.879.7109,001-515-619-3114x890,shelby36@lawrence-love.com,2021-05-11,http://joseph.com/
05-Apr-2021,Tax,03.00,00.00,"241,816.96",b10D0aB0586ea26,8344,Dale,Escobar,Christian-Hickman,North Abigailville,Solomon Islands,4726896291,+1-241-617-4594x1654,okemp@case-estrada.com,2020-11-30,https://www.sharp-randall.net/
05-Apr-2021,Cheque,"222,509.10",00.00,"464,326.06",ecd3e390Ebcd5FA,2760,Kim,Middleton,"Parker, Hart and Schmidt",Donaldsonton,Vietnam,858.902.0388,7352117382,bernard26@heath.com,2022-03-02,http://knight.net/
05-Apr-2021,NEFT,00.00,"46,432.61","417,893.45",11D3c8fba9dBcfF,972,Lorraine,Jordan,Dudley-Ray,Websterfurt,Greenland,(577)491-5862,8376253885,prestonashley@rush.com,2020-10-13,http://www.vaughn.org/
05-Apr-2021,Cash,00.00,"417,893.45",00.00,5e5eBCeEBbcBE43,3472,Eric,Edwards,Leach-Atkinson,Hooperchester,Russian Federation,288.959.9416x1499,9451677750,carneyjon@avila.org,2020-03-12,http://avery.org/
05-Apr-2021,ATM,00.00,00.00,00.00,dFbdDC22B87A9C1,4313,Jake,Simpson,"Rosales, Mccullough and Abbott",South Arielville,Venezuela,001-301-006-2406x86392,431-174-3435,salasriley@cordova-mcconnell.info,2020-07-12,http://www.mcmillan-rose.biz/
05-Apr-2021,Debit Card,56.80,00.00,56.80,d8467E66bADD70F,4009,Laurie,Glover,Mcconnell Group,Morsetown,Libyan Arab Jamahiriya,+1-589-099-5731x44467,(569)746-3617x771,youngjennifer@stein.com,2020-03-24,https://hardy.org/
05-Apr-2021,Tax,"151,842.19",00.00,"151,898.99",EF853Ef4Bb0D531,3375,Suzanne,Forbes,Hensley Ltd,Port Bradytown,France,078.506.4033x332,484.467.5598,simonsophia@mcdonald-ayers.net,2021-09-28,http://pena-clayton.org/
05-Apr-2021,Purchase,00.00,"151,898.99",00.00,16CDE704ac1d3AC,3343,Anne,Vang,Garrett-Duffy,Brightstad,Sri Lanka,(314)613-4936x738,155.464.1136x1179,davenportmarilyn@le.com,2021-03-25,https://campos.com/
05-Apr-2021,Interest,"1,272,251.00",00.00,"1,272,251.00",fdDDfa74909210c,8994,Raven,Mcfarland,"Reeves, Tate and Nichols",Barrland,Cape Verde,(583)588-5168,+1-795-434-2304,fletcherbrent@bruce.biz,2021-12-29,https://www.hicks-irwin.org/
05-Apr-2021,Cash,"111,878.00",00.00,"1,384,129.00",C92BeD3171FDf62,5883,Mckenzie,Alvarado,Hoffman LLC,Casefurt,Saint Martin,5872657076,716.183.6630,gnolan@price-lucas.com,2020-05-04,http://petersen.com/
05-Apr-2021,Purchase,40.39,00.00,"1,384,169.39",2784BbCb568e2Ac,590,Kerri,Clayton,Burch-Glass,Port Priscilla,Egypt,+1-941-899-2480x85112,001-132-770-3273x1125,tamara83@bentley.com,2021-12-31,http://glenn.net/
05-Apr-2021,IMPS,"23,512.00",00.00,"1,407,681.39",2EBd9B32c0BafF1,9030,Samuel,Flores,Friedman-Mack,Ashleyland,Seychelles,001-264-663-6201x598,(271)151-0862x513,gloveradrienne@stanley.com,2020-06-28,https://ball-carter.org/
06-Apr-2021,Bill,"15,659.09",00.00,"1,423,340.48",b03ff12dAA1E252,8329,Christopher,Salinas,Mack-Schultz,North Stephenmouth,Azerbaijan,6207393927,001-238-901-3407,bowerslonnie@rodriguez-giles.biz,2021-10-24,http://holloway.org/
06-Apr-2021,Tax,01.90,00.00,"1,423,342.38",ECD4DE3eDBA8ca4,3913,Priscilla,Graves,Cochran-Mullins,North Rileyshire,Israel,001-523-784-9821x94055,(156)372-5520x7752,jkidd@skinner.net,2020-10-16,https://conway.com/
07-Apr-2021,Commission,00.00,"355,835.60","1,067,506.78",Fb3Bd33D4bae8F7,3128,Madison,Campbell,Lowery PLC,North Frederick,Malawi,509-415-7925,+1-466-656-0387x123,patrick96@kemp.com,2020-10-21,http://www.bridges-dunn.info/
07-Apr-2021,Commission,00.00,"533,753.39","533,753.39",DC1a7ae13Cc2EC3,7814,Carmen,Larsen,Shaw Group,South Rhonda,Syrian Arab Republic,052.938.8835x7536,(722)248-4314,sophia34@choi.com,2020-06-29,https://www.abbott.com/
07-Apr-2021,Bill,00.00,"533,753.39",00.00,baF6BF63c8fD59F,4522,Carol,Ponce,"Oconnor, Munoz and Webster",West Laurachester,Mozambique,(521)086-0721x0897,202.271.3030x5913,daryl26@hutchinson-perkins.com,2022-03-07,https://kerr.org/
07-Apr-2021,ATM,"1,882,484.80",00.00,"1,882,484.80",2733BDa2cCCfDDE,2548,Diane,Werner,Guerrero-Woodard,Sheliamouth,Somalia,4576761712,(977)523-1721x85830,mezacameron@ware-camacho.com,2021-01-21,https://cohen.com/
07-Apr-2021,Reversal,00.00,"313,747.47","1,568,737.33",7bA78B5EBb63F8e,9736,Desiree,Holden,Kelley-Simpson,Mendozaborough,Sao Tome and Principe,2222135157,001-438-358-7262x889,sloanhayley@huffman.org,2020-06-27,http://www.combs.com/
07-Apr-2021,Transfer,"1,850,090.25",00.00,"3,418,827.58",18ba23fCa0e41Fe,2961,Alexis,Barajas,Solis-Bennett,North Allisonborough,Senegal,(532)437-2882,+1-059-532-3015x89497,maureenmckay@santos-ho.net,2021-08-28,http://forbes.com/
07-Apr-2021,Transfer,230.87,00.00,"3,419,058.45",23DBb47113CD889,6536,Jason,Lester,Carson Inc,Rickeyfort,Colombia,5697606744,001-754-645-7357x557,dwayne99@hogan-carter.net,2021-05-15,http://www.bird.com/
07-Apr-2021,RTGS,00.00,"854,764.61","2,564,293.84",CAbcF4c6fE2cEf2,5280,Richard,Schultz,Lynch LLC,Josephmouth,Nepal,219-477-1573,984-327-2891x97174,lisamurray@dickson.com,2020-08-24,https://www.gutierrez.biz/
07-Apr-2021,Cheque,00.00,"427,382.31","2,136,911.53",51Caa1FF4b8D7CD,8829,Kent,Lutz,"Bean, Rasmussen and Mason",Kristiborough,Sierra Leone,419.485.1758,848-582-9553x0338,pstuart@merritt.com,2021-10-15,https://www.thomas.com/
07-Apr-2021,Cheque,00.00,"356,151.92","1,780,759.61",9C0c46fD2Dc3193,8704,Sheri,Holder,"Randolph, Simpson and Oconnor",East Molly,Botswana,(058)581-8175x791,(683)312-5539x783,cory26@allen-gonzalez.com,2022-01-06,https://www.solomon.net/
07-Apr-2021,Purchase,00.00,"445,189.90","1,335,569.71",bDAFceeAe7c9527,4454,Jamie,Shepard,Ellis PLC,West Lynnborough,Samoa,196.969.9859,151.655.0231,iankaiser@peck.com,2021-08-16,https://www.hood-ho.com/
07-Apr-2021,Purchase,"10,997.00",00.00,"1,346,566.71",dc5C2cCB0fdF0A9,4014,Adam,Caldwell,Gardner-Harrington,Lake Brandichester,Libyan Arab Jamahiriya,367.464.8278,(617)522-2361x706,levinecollin@esparza.com,2021-07-28,http://www.humphrey.com/
07-Apr-2021,Cheque,59.51,00.00,"1,346,626.22",7db9825b7a11c6D,4601,Hannah,Rowe,"Erickson, Peterson and Bass",Pamelamouth,Antigua and Barbuda,001-844-188-2738,956.391.9085x6839,justin63@greene-lucas.org,2022-01-31,http://www.sweeney-rollins.org/
07-Apr-2021,IMPS,"125,258.03",00.00,"1,471,884.25",D6AF4BeB6eC02dc,6753,Katherine,Shaffer,Bridges LLC,Juliachester,Egypt,+1-459-496-9465,(816)310-0413x728,gallowayclifford@galloway.com,2020-07-06,http://zimmerman-bray.com/
07-Apr-2021,Cash,00.00,"735,942.13","735,942.12",13bDCB4C94342fA,2951,Tabitha,Maynard,Bennett LLC,North Brad,Macedonia,(046)638-2955x623,(435)615-1815,uprice@christian.net,2020-12-23,http://www.bonilla-rodgers.com/
07-Apr-2021,Cash,"246,017.72",00.00,"981,959.84",20528c1E4f82f2b,9233,Mia,Mullins,Lutz-Knapp,Port Levi,Suriname,(515)713-6631x27102,+1-343-726-0174x06706,finleysandra@porter.com,2021-12-31,http://www.mays-benitez.com/
07-Apr-2021,Tax,"1,801,171.50",00.00,"2,783,131.34",3F8FFbEd75a777B,9608,Katie,Riley,Jensen-Nunez,Cristianbury,Congo,(616)491-9055x84392,001-234-948-2467x292,yroman@sparks-gonzales.info,2020-07-06,http://www.pacheco.com/
07-Apr-2021,Transfer,445.00,00.00,"2,783,576.34",38E5c8280BB2cE9,3358,Gregory,Mitchell,Armstrong-Dodson,South Shawna,Maldives,928-947-7639,781.844.1826,herbert79@west.com,2022-03-12,http://www.hays.info/
07-Apr-2021,ATM,00.00,"397,653.76","2,385,922.58",7A44c27C64Cd3e1,7423,Dale,Rios,Bryan-Wright,Bethburgh,Portugal,242.583.7862x19676,(919)776-1718x8623,karina57@ballard-cowan.com,2021-11-14,https://day.com/
07-Apr-2021,Commission,33.20,00.00,"2,385,955.78",24dda41e62cF13c,9470,Ian,Morris,Mullen-Holloway,Port Taylor,Saint Pierre and Miquelon,+1-241-715-5504x3151,(522)502-7508x0022,janehayes@harrington.net,2021-11-25,http://www.gomez.com/
07-Apr-2021,Cheque,01.49,00.00,"2,385,957.27",Df7B7a403cbECeE,6039,Danielle,Booth,Bush Group,Higginshaven,Bermuda,(303)203-1900x3767,148.303.1875x5630,gregoryortega@schmitt-randolph.com,2021-02-20,http://www.christensen.com/
07-Apr-2021,Purchase,05.10,00.00,"2,385,962.37",0dAEF35b5cCAa82,6915,Aaron,Ortiz,"Gill, Roman and Blair",West Bradleyberg,Vanuatu,489-652-6564x3529,+1-694-510-8865x85848,jenniferleon@santos-atkinson.biz,2020-07-19,https://simon-hendricks.com/
07-Apr-2021,Transfer,"17,565.00",00.00,"2,403,527.37",62e9288dC8FEbba,3558,Jane,Arellano,Rojas-Hughes,Singletonchester,Haiti,728-126-2350x73423,(897)773-3766x97703,melvinnielsen@acevedo.com,2021-02-03,http://www.moyer.com/
07-Apr-2021,Cash,00.00,"240,352.74","2,163,174.63",4b9aF6CB71243Df,4117,Natalie,Marshall,"Sandoval, Lowery and Dennis",New Oscarmouth,Kyrgyz Republic,3192725540,001-117-455-1231,sierrapage@valdez.com,2021-08-03,https://franco-griffith.com/
07-Apr-2021,NEFT,00.00,"540,793.66","1,622,380.97",0D3Cb620B4Ba8c7,1959,Leonard,Alvarez,Juarez LLC,West Natashachester,Gabon,001-519-669-3466x33083,+1-147-321-3306,prestonkirsten@carson.biz,2021-11-15,http://www.marks.info/
07-Apr-2021,IMPS,"1,589,017.00",00.00,"3,211,397.97",CB9Ee7105dCbc26,1262,Krystal,Mayer,Hogan Group,Carrieberg,Timor-Leste,239.061.8278x142,640.351.9188x96150,ronaldbullock@cain-watkins.biz,2020-05-04,http://davila.biz/
07-Apr-2021,RTGS,"77,810.40",00.00,"3,289,208.37",db3Cb4Df7Ca1912,4804,Beverly,Arellano,Koch Group,Port Lonnie,Venezuela,964.083.2179x9796,+1-747-099-8835,mayevelyn@reeves-york.com,2020-06-18,http://lloyd.net/
07-Apr-2021,Bill,05.28,00.00,"3,289,213.65",e2b607f76FC4bEb,5508,Brittany,Holden,"Haas, Li and Bond",Lake Cassie,Ireland,627-049-2595,659-068-7342,katelynhorne@gross.com,2021-05-25,http://long-hayden.info/
07-Apr-2021,Miscellaneous,"1,925.00",00.00,"3,291,138.65",BaECEfBBd607544,665,Monica,Richards,Howe Inc,East Jon,Cayman Islands,068.340.0475x5997,430.652.7040x7103,frenchdominic@adams.org,2021-12-05,http://www.huffman.info/
07-Apr-2021,Transfer,00.00,"411,392.33","2,879,746.32",1CcBD7160dB1Fcb,9213,Felicia,Barry,Romero-Farley,Port Jackie,Faroe Islands,309.277.3004x105,+1-997-825-3776x0028,maciasaimee@singh.com,2021-06-27,http://sandoval-silva.com/
07-Apr-2021,Cash,94.81,00.00,"2,879,841.13",5235360eEC7aCc4,5646,Jamie,Caldwell,Gilbert-Moran,West Troyland,Netherlands,001-931-719-5752,290-253-8027x68150,ostephens@cohen.com,2020-03-25,https://www.leblanc.com/
07-Apr-2021,Commission,00.00,"479,973.52","2,399,867.61",dABADFF51DBFABB,4286,Jocelyn,Webb,Travis and Sons,New Steveberg,Puerto Rico,6528480194,000.031.7689x7816,dakota29@gates-baxter.com,2020-05-12,https://roth.org/
08-Apr-2021,Purchase,"7,086.00",00.00,"2,406,953.61",D3B64e08A959dCA,2607,Jonathan,Morales,Wade Group,Carrchester,Dominican Republic,+1-159-457-0461x9278,001-397-000-2903,gwarner@fuentes.com,2021-10-06,http://ford.com/
08-Apr-2021,Debit Card,"1,078.37",00.00,"2,408,031.98",7f9C9E79fC2EC4C,5577,Matthew,Booth,"Wilkins, Beasley and Keller",Port Isaiah,Portugal,001-676-490-1595,+1-397-228-7947x113,preeves@noble-schaefer.com,2020-06-08,http://www.vincent.net/
08-Apr-2021,Cash,00.00,"301,004.00","2,107,027.98",F4EfCa5f30A68ea,8568,Jon,Sawyer,"Mcdaniel, Wolfe and Davies",East Jillside,India,796-609-4150,318.508.5635,tina66@campos-haney.net,2021-11-29,http://reed.info/
08-Apr-2021,Miscellaneous,00.00,"210,702.80","1,896,325.18",E16A0d37Bd48A8d,7282,Misty,Osborne,Monroe-Brooks,Silvaville,Macao,001-225-315-0004,+1-698-458-5288x14194,camachobrandi@horne.com,2022-02-19,https://thompson-wilson.com/
08-Apr-2021,Debit Card,"32,911.31",00.00,"1,929,236.49",166dC9a56fe1239,7461,Alejandro,Hopkins,"Gomez, Bartlett and Melton",South Julia,Ghana,0030550666,893.872.3982x307,rivaskenneth@whitaker-blevins.com,2022-02-03,https://miller-cole.biz/
08-Apr-2021,Purchase,29.93,00.00,"1,929,266.42",2b6e2eFEcb1D3Ad,3539,Sheryl,Benson,Hebert and Sons,Lynntown,Uzbekistan,(027)465-9008,(386)011-1268x613,mcconnellbenjamin@edwards.org,2020-08-22,https://www.schmitt-moran.com/
08-Apr-2021,ATM,"3,341.29",00.00,"1,932,607.71",4ede9D5B2cD79bd,2149,Joann,Mckay,Mckay PLC,Port Cole,Dominican Republic,+1-007-507-9444x917,037.504.6947x546,dlowery@austin.com,2020-12-26,https://www.knox.com/
08-Apr-2021,Cheque,18.50,00.00,"1,932,626.21",FBb0B8cdE7BB7AE,9467,Frank,Burch,Meza Ltd,Cowanbury,San Marino,700-001-1712,6627435129,russellbanks@herring.com,2021-01-24,https://www.shields.com/
08-Apr-2021,Bill,00.00,"193,262.62","1,739,363.59",fdf04eb1b5E9Cdd,9723,Grant,Barker,Church PLC,Omartown,Ghana,2395193177,001-723-800-3778x9234,kristydelacruz@mcdonald-landry.com,2020-10-07,http://richards-chapman.net/
08-Apr-2021,Commission,00.00,"248,480.51","1,490,883.08",29c9B7F94B6e2Ac,5307,Leon,Holloway,Poole-Kerr,South Bruce,Malawi,788.124.1301x98543,(964)739-4758x08024,harold22@sullivan.com,2020-02-03,http://www.murillo.com/
08-Apr-2021,IMPS,00.00,"186,360.39","1,304,522.70",14Bd8abd7779aec,7040,Bob,Austin,"Calderon, Zavala and Harmon",Whiteheadview,Guatemala,001-374-444-9239x847,109-051-7004,charlottebenitez@donovan.biz,2020-03-28,https://rocha.info/
08-Apr-2021,Commission,"32,533.29",00.00,"1,337,055.99",f8dd4fe8C286303,3289,Shawna,Neal,"Brown, Ayers and Dyer",Lake Sonya,American Samoa,+1-156-621-2274x17589,+1-906-563-8827,qmccormick@raymond-torres.org,2020-12-25,http://sheppard-bridges.com/
08-Apr-2021,IMPS,00.00,"1,337,055.99",00.00,d48e68C29CDA2fb,1546,Summer,Garrison,Bullock Inc,Perrystad,Netherlands Antilles,+1-181-104-2160x1390,(153)722-8916x35654,wyatt85@russo-ashley.com,2020-06-16,https://www.farley-moses.com/
08-Apr-2021,Miscellaneous,"21,444.00",00.00,"21,444.00",dFAFc907f1aeC3b,6357,Kristopher,Walker,"Moyer, Dean and Wang",Timothybury,Luxembourg,(182)717-3493x91523,(653)996-9600,santosjody@vazquez.com,2021-04-10,https://anderson-mcpherson.com/
08-Apr-2021,Cash,"86,977.25",00.00,"108,421.25",57B6d3584aabffa,7457,Neil,Delgado,"Mathis, Bruce and Braun",Kaitlinfort,Martinique,512-630-2244x29031,(628)846-6260x7115,stacyduncan@boyer.com,2021-08-08,https://www.eaton-serrano.biz/
08-Apr-2021,Miscellaneous,06.10,00.00,"108,427.35",6043B3aEDeB001b,585,Victor,Donaldson,Beard Ltd,Port Claire,Romania,408-072-6826x680,001-354-947-3754x916,gabriella33@huerta.com,2021-04-27,http://morales.org/
08-Apr-2021,Tax,15.70,00.00,"108,443.05",f5F9ac60Ed4a05E,8167,Amy,Castaneda,Dodson-Ruiz,Gabriellaside,Namibia,+1-982-563-0959x71239,001-507-193-6405,robersonnatalie@estes-gould.com,2022-04-22,https://farrell-harvey.com/
08-Apr-2021,Commission,"110,321.41",00.00,"218,764.46",1aD2deA0fde50BA,355,Joan,Gregory,Hartman Inc,Port Kylieville,Korea,305.639.5002,453.485.8642,xvang@schmidt.com,2020-11-01,http://blanchard.biz/
08-Apr-2021,Reversal,211.00,00.00,"218,975.46",Df9659BA5Df5fa0,850,Richard,Hampton,"Campos, Wright and Sullivan",Whiteshire,Somalia,232-489-9962x02110,601-791-2810x4257,abigail39@king.com,2021-06-12,http://fitzpatrick-vang.com/
08-Apr-2021,Interest,00.00,"109,487.73","109,487.73",3d5f76da4B5cdCd,5844,Kathy,Kirby,Reed-Bullock,Jimmyport,Romania,001-447-768-3121x6884,(954)944-3294,jimbowers@hamilton.com,2022-02-01,http://www.love.com/
08-Apr-2021,Cash,00.00,"13,685.97","95,801.76",B6dEB86bbaF3E44,8562,Perry,Lawrence,Beltran PLC,Donnashire,Libyan Arab Jamahiriya,(504)812-2484x243,(126)334-2633x02872,lawrenceyang@bean-christian.com,2020-09-30,https://www.schultz-gordon.info/
08-Apr-2021,Purchase,233.00,00.00,"96,034.76",E8977F37DF4cA71,3480,Chelsey,Clarke,"Gill, Noble and Jensen",Youngtown,Central African Republic,782.293.1961x74577,(867)010-9163x014,rushnicole@davies.net,2020-09-14,http://riggs-brooks.org/
08-Apr-2021,NEFT,122.50,00.00,"96,157.26",70cb6F327dDaEf2,5821,Russell,Mercer,Cortez-Rowland,Jayside,Barbados,853.282.5522x183,511-103-3692,isabellowe@marsh.com,2020-11-26,https://maldonado.biz/
08-Apr-2021,RTGS,00.00,"9,615.73","86,541.53",e9EDD08FE5Aa19E,9526,Loretta,Whitaker,Stokes and Sons,West Ariana,Uruguay,001-297-933-6429x601,096.407.2268x90676,melody68@key-burns.com,2020-11-16,https://www.dillon.info/
08-Apr-2021,IMPS,00.00,"43,270.77","43,270.76",5A4EadC70D8Fdde,6147,Austin,Walsh,Tate Inc,Alfredton,Venezuela,+1-322-835-1061x70149,762-992-5992,hannahelliott@hanna.com,2021-08-16,https://harvey.com/
08-Apr-2021,Cheque,"90,774.16",00.00,"134,044.92",DbaaFc709FCDf43,3215,Raymond,Hutchinson,Gay Group,Bethanyside,Hong Kong,+1-891-838-0062x993,910.796.9035x5042,cherylgomez@espinoza-good.com,2020-06-30,http://www.mccann.com/
08-Apr-2021,Miscellaneous,00.00,"134,044.92",00.00,54F7F47a2FF89a7,5758,Sonya,Rubio,Harding-Swanson,Bernardmouth,Wallis and Futuna,(643)924-4289x2825,+1-085-415-2657x1368,jillian31@jenkins-whitehead.com,2020-06-06,https://www.hickman-beck.com/
08-Apr-2021,ATM,"30,433.00",00.00,"30,433.00",fF7218cD464708E,3225,Gregory,Mendez,Espinoza-Bell,Lake Kevinmouth,Bermuda,(080)272-8356x45014,(703)589-9420x84298,crystal46@farrell-lam.org,2020-06-10,https://www.steele.com/
08-Apr-2021,Tax,05.20,00.00,"30,438.20",2d2CaE9aaDebCcA,2359,Gregory,Finley,"Bernard, Kidd and Maldonado",North Stephaniefurt,Saudi Arabia,001-331-768-2677x2949,(766)787-2336x111,abernard@perkins.org,2021-07-08,https://www.harvey-franco.net/
08-Apr-2021,Interest,00.00,"10,146.07","20,292.13",e048afAbCFa1d1E,1491,Kristopher,Mayer,Page-Morales,South Cliffordfort,Venezuela,+1-712-170-3649x77045,+1-244-037-7818x420,oscarferguson@bradshaw.biz,2022-02-16,http://www.strong.info/
08-Apr-2021,IMPS,00.00,"4,058.43","16,233.70",55e6FCbf0ed876d,6653,Shannon,Cortez,Giles-Le,Yustad,Slovakia (Slovak Republic),(293)395-2865x2251,+1-909-743-3165x993,rhays@house.com,2021-04-04,https://www.melton.info/
08-Apr-2021,Miscellaneous,00.00,"16,233.70",00.00,e5C0aF7f408aCa5,9955,Christy,Glenn,Blackburn-Rowe,Ritaview,Aruba,802-088-7303x131,(426)667-7241x6345,robertsongeorge@thomas-fuller.com,2020-12-22,https://melendez-downs.com/
08-Apr-2021,Cash,"3,228.42",00.00,"3,228.42",6b6bBD73A8ec126,9173,Caitlyn,Harmon,Harvey-Rodriguez,East Jonport,Puerto Rico,+1-106-886-4454x90386,338.487.8673,barrycolton@zuniga.biz,2022-03-07,http://www.keller.com/
09-Apr-2021,Tax,00.00,645.68,"2,582.74",68D16f428AEbf69,9600,Nicholas,Calderon,Mack-Wilson,South Taylor,Nepal,140.782.0057,+1-097-403-1496x66099,mayochristy@blake.com,2020-10-20,https://www.larsen-serrano.com/
09-Apr-2021,Bill,00.00,"1,291.37","1,291.37",6E5DABCBb2ABfA4,4355,Kenneth,Reid,Dawson-Herrera,Port Karen,Belarus,359.174.2570,718.019.0814x0956,paula22@nielsen.com,2021-10-22,http://lucero.net/
09-Apr-2021,ATM,00.00,430.46,860.91,4b8BfCd1cf834F2,5254,Raven,Walters,"Nunez, Weeks and Ingram",New Jorge,Bouvet Island (Bouvetoya),001-958-462-0151x591,475-847-5692x4151,rasmussenjeremiah@huber-mccullough.org,2020-01-31,http://richmond-good.org/
09-Apr-2021,IMPS,00.00,122.99,737.92,F87E67b330836fA,1180,Marcia,Solomon,Giles-Villarreal,Starkchester,Armenia,132.056.4203x5427,430.628.5245x8464,ubolton@avila.com,2021-08-03,http://www.todd.com/
09-Apr-2021,NEFT,00.00,105.42,632.50,D090DDBBCB4Db7b,7102,Vicki,Pacheco,"Kirk, Vega and Lester",Lake Rodneyshire,Hong Kong,012-471-5355,(335)988-5230x4978,joann09@faulkner.com,2021-12-18,https://www.cross-parker.info/
09-Apr-2021,ATM,"4,926.00",00.00,"5,558.50",a54Ccdf893A10eA,5697,Darryl,Flynn,Gibson-Salinas,Tracytown,Montserrat,(378)466-4147x7865,372-745-6798,amanda77@price.biz,2020-02-02,https://www.owen-roberson.com/
09-Apr-2021,Commission,00.00,926.42,"4,632.08",b397feF01C510a1,3753,Bryan,Wang,Sexton-Wise,Shawmouth,Ecuador,999-851-3675,528-974-4750x55810,sierra88@schultz.com,2020-01-17,http://www.williams-conley.com/
10-Apr-2021,Miscellaneous,00.00,579.01,"4,053.07",E81AADA7AFFD3a0,5354,Kristopher,Savage,"Webster, Ross and Cherry",Noblestad,Zimbabwe,744-219-9442,583-288-0000,tamiunderwood@rios.com,2021-07-09,http://www.wiley.com/
10-Apr-2021,Commission,00.00,405.31,"3,647.76",45c7C5DbEC6EcA9,9877,Diane,Hays,Frederick and Sons,Port Martha,Equatorial Guinea,413.438.1947x002,162.706.9922,kyleschaefer@day.info,2021-02-23,http://www.bolton.info/
11-Apr-2021,ATM,"1,098,583.00",00.00,"1,102,230.76",cd1D0d3ABf09FBA,430,Dan,Murray,"Mora, Compton and Gregory",Alvaradohaven,Moldova,(516)030-4038x326,580.939.6109,kathleenle@martin.com,2021-06-06,https://www.fowler.biz/
11-Apr-2021,Reversal,00.00,"1,102,230.76",00.00,28f46aC1AF64E01,5722,Mariah,Flores,"Bernard, Carroll and Taylor",North Erica,Micronesia,+1-560-198-6524x0077,655.091.3372x89495,roberto60@mata.com,2020-11-23,https://www.harrington-barton.net/
11-Apr-2021,ATM,"256,053.10",00.00,"256,053.10",48da69dadc8625C,9523,Lee,Schmidt,"Hensley, Miller and Villegas",West Williamside,Luxembourg,(062)803-4604x25879,(185)435-7945,gloveralexandra@orozco.biz,2021-05-02,http://www.logan.com/
11-Apr-2021,Transfer,"2,719.75",00.00,"258,772.85",4e536CF13ffeecB,4045,Alec,Bray,Mercado PLC,West Brandon,Guam,2707492352,001-067-359-8181x38455,farrellcesar@neal.com,2020-03-13,http://www.duke-ingram.com/
11-Apr-2021,Miscellaneous,00.00,"32,346.61","226,426.24",0A1cBEefCC25F45,5430,Lance,Reilly,Dominguez and Sons,Stanleyland,France,001-772-403-1252x048,7457648434,liuchristy@alvarez.info,2022-04-02,http://caldwell.com/
11-Apr-2021,Reversal,"2,985.00",00.00,"229,411.24",b74C5f67dE8bA4a,3202,Stephanie,Zhang,"Odom, Brock and Levine",Lynchmouth,Philippines,(592)554-3947x5170,(151)587-0695,rowen@swanson.com,2021-08-23,https://cardenas.com/
11-Apr-2021,ATM,"1,447,556.00",00.00,"1,676,967.24",7BDAD5d04a7fabB,8692,Corey,Collier,Yates PLC,Port Saramouth,France,646.517.5105x383,835.144.4520,allison49@schwartz-ortega.com,2021-11-20,https://robinson.com/
11-Apr-2021,ATM,00.00,"419,241.81","1,257,725.43",81dcffffDB34C5c,7315,Elizabeth,Wiggins,"Duke, Logan and Craig",Jillianton,Philippines,674-984-2963,714.430.9338x4455,kristacarey@cain.com,2020-10-12,https://flynn.org/
11-Apr-2021,Cash,01.90,00.00,"1,257,727.33",e5fAFBfd2C0aA5E,2040,Anita,Kelley,Olsen LLC,Port Jesusmouth,Korea,(568)624-5226x0809,001-436-648-4504x1401,joanna72@krueger.org,2022-01-22,http://haney.net/
11-Apr-2021,Bill,"3,247.80",00.00,"1,260,975.13",9417a104db49A6b,8257,Laura,Powell,Salinas LLC,East Andrewburgh,Palau,321-019-8600x8441,(086)580-7468,katelyn85@good.info,2020-05-29,http://www.mckinney-luna.org/
11-Apr-2021,ATM,"222,815.81",00.00,"1,483,790.94",3cBb4ef80f50f64,2303,Dakota,Pacheco,Mckenzie Inc,Ralphborough,Japan,416.142.8154x7807,001-516-725-4972x387,williamsonfernando@meyers.com,2021-10-29,http://williams.com/
11-Apr-2021,ATM,"76,204.78",00.00,"1,559,995.72",Aac9EdEC3bA0861,4612,Dennis,Kent,Bonilla-Horn,New Christian,Czech Republic,+1-534-411-1244x814,080-116-4260x06671,summerwiggins@fuller.net,2020-09-27,https://hopkins.com/
11-Apr-2021,Interest,57.00,00.00,"1,560,052.72",ECD4DE3eDBA8ca4,3913,Priscilla,Graves,Cochran-Mullins,North Rileyshire,Israel,001-523-784-9821x94055,(156)372-5520x7752,jkidd@skinner.net,2020-10-16,https://conway.com/
11-Apr-2021,Debit Card,00.00,"222,864.67","1,337,188.05",73aF55BdBf5eDFC,5106,Alejandra,Lowery,Lane Inc,New Dawnchester,Singapore,(831)971-4280x760,001-489-383-7182x832,jason84@hurst-gonzalez.net,2020-01-03,https://rogers.com/
11-Apr-2021,Tax,"2,593.55",00.00,"1,339,781.60",ceca114EE1CC7FF,7780,Rita,Haley,Stevens-Newman,Stanleyshire,Japan,+1-675-332-6189x997,+1-916-790-5042x481,dsullivan@compton.com,2022-02-01,http://www.esparza.org/
11-Apr-2021,Bill,00.00,"223,296.93","1,116,484.67",074a3b0bAbAa47d,5907,Gregg,Jones,Parsons-Ramsey,Calvinfurt,Dominican Republic,001-041-245-7904x9083,+1-297-232-1200,dmiranda@suarez-waller.net,2021-06-01,http://www.patton.com/
11-Apr-2021,Miscellaneous,35.78,00.00,"1,116,520.45",fA8d3f90B787641,2139,Yesenia,Shepard,Contreras-Bowers,Rollinsport,Indonesia,148.884.0565x0750,+1-702-511-2163x5356,wwilliams@khan.com,2021-02-13,https://franco-gentry.com/
11-Apr-2021,Miscellaneous,503.78,00.00,"1,117,024.23",C3a597F3b9B5F9B,9194,Sierra,Garrison,"Anderson, Deleon and Charles",Cobbview,Dominican Republic,0462350123,+1-958-138-8306x8808,johnny93@lowery-howell.com,2021-07-30,https://bauer.com/
11-Apr-2021,RTGS,00.00,"111,702.42","1,005,321.81",aebeCeAFDc4a8D5,9823,Gabriella,Tate,Bradshaw LLC,Meredithborough,United States Virgin Islands,9195233401,001-839-681-1241x268,harveylorraine@jones-schaefer.com,2021-12-04,http://sullivan-bowers.com/
11-Apr-2021,IMPS,61.80,00.00,"1,005,383.61",e5BbA364CB51FE2,5606,Carrie,Barnes,"Gutierrez, Waters and Wade",Lake Nicolas,Taiwan,0728216305,354-966-5127x777,dillon87@eaton-acevedo.biz,2020-02-21,http://www.anderson.com/
11-Apr-2021,Debit Card,00.00,"167,563.94","837,819.68",5fDf2DA29aeaE9b,6889,Julia,Gutierrez,Daniels PLC,West Darrell,Chile,001-495-059-6297,016-551-5111x1936,isabelvelasquez@cunningham.com,2021-12-03,https://rosario-wagner.biz/
11-Apr-2021,Commission,"14,063.15",00.00,"851,882.83",559373cB858Db92,4159,David,Francis,"Hughes, Townsend and Bailey",North Shelly,Trinidad and Tobago,+1-152-422-2850x04770,001-492-354-0441x4618,darrylbradley@bruce.info,2021-07-04,http://jacobson.com/
11-Apr-2021,NEFT,"3,255.00",00.00,"855,137.83",FD10C743DA516bc,9351,Jeremy,Hull,"Callahan, Walls and Mitchell",Kennethshire,Solomon Islands,692-330-2118,717-264-1377,cassiemeza@gibson.net,2021-08-02,https://www.boyer-english.org/
11-Apr-2021,Cheque,00.00,"171,027.57","684,110.26",2CE13cE0f37477e,9356,Lance,Weiss,"Kidd, Escobar and Bush",Marisachester,Finland,001-150-367-5464x6044,469.492.7922,tabitha12@sims.info,2020-08-12,http://johns.biz/
11-Apr-2021,Cheque,00.00,"684,110.26",00.00,8d32c2fcD809843,2223,Earl,Mccormick,"Montoya, Hensley and Bush",Valerieville,Afghanistan,216-956-5845,001-799-776-5269x7242,cdunlap@woodward.com,2021-03-28,https://www.curtis.com/
11-Apr-2021,Reversal,"120,184.00",00.00,"120,184.00",b41BE4f80E910Ab,8941,Elaine,Webster,Woodard-Simpson,New Douglas,Mongolia,+1-644-333-9419x42069,546.582.8599,castrogeorge@hodges.net,2020-06-12,https://castro-koch.com/
11-Apr-2021,IMPS,02.80,00.00,"120,186.80",bc011dE2C2aC99D,1645,Charles,Chen,"Beck, Ortiz and Dunn",Martinhaven,Indonesia,+1-588-534-2721x49783,298.841.1919,eclements@gordon-combs.com,2020-07-06,https://blackwell-williams.com/
11-Apr-2021,Transfer,"682,162.20",00.00,"802,349.00",Cdc99eD5f9371E7,4817,Deanna,Chaney,"Cunningham, Donovan and Patterson",North Stefaniefurt,Saint Lucia,9308070645,(231)764-1999x8740,timothyflynn@pollard.com,2022-01-14,https://www.bennett.info/
11-Apr-2021,Interest,00.00,"89,149.89","713,199.11",0bea0a0B23c286F,1699,Breanna,Merritt,Riley and Sons,Port Chrisport,Thailand,001-988-272-5771,537-435-3952,shari87@simmons-villanueva.info,2020-04-20,http://curry-blankenship.org/
11-Apr-2021,RTGS,00.00,"79,244.35","633,954.76",5d817Aba4f31b6E,5911,Cassie,Mullins,Shepard Ltd,Arthurbury,Burundi,588-399-3523x03858,107.301.7121,stanleypayne@bowen-guerrero.com,2022-01-16,http://www.preston-short.com/
11-Apr-2021,Miscellaneous,00.00,"90,564.97","543,389.79",41CEA79839eC9bd,2807,Brent,Vaughn,Parrish-West,Port Catherineborough,Vanuatu,7867684141,592-275-9609x185,russell98@cook.com,2021-07-16,http://www.wolfe.com/
11-Apr-2021,Transfer,00.00,"181,129.93","362,259.86",4eeF6290293BeB0,6682,Meredith,Brock,Cochran Inc,Brucechester,Iceland,+1-532-920-9935x990,001-019-016-5195x9460,qpatrick@robertson.com,2021-02-10,http://mclean-bruce.com/
11-Apr-2021,Transfer,00.00,"72,451.97","289,807.89",aF38bb62D8B04b4,6618,Shaun,Maddox,Vega-Pearson,North Tracey,Russian Federation,(854)495-4634,401-169-5669x203,michael64@goodman.com,2021-10-16,http://fischer.com/
11-Apr-2021,RTGS,"609,666.75",00.00,"899,474.64",55Ef2BcDaAEDCC5,6609,Latoya,Lang,Gross LLC,Leonport,Japan,(431)863-8882x521,+1-641-493-4318x05652,roblesselena@huber-arroyo.com,2021-07-31,http://chan-donaldson.com/
11-Apr-2021,Bill,165.90,00.00,"899,640.54",AacfDF795bFAC0f,6067,Alfred,Porter,Vaughn Ltd,Freyville,Comoros,+1-557-089-7966x56454,446.483.5460x6395,dzamora@mayer.biz,2020-07-06,https://garner-andrews.com/
11-Apr-2021,NEFT,16.00,00.00,"899,656.54",D70957B1aBcB5A2,929,Herbert,Carter,Miles-Baldwin,Cristinaburgh,Reunion,771.229.2081x42159,(220)579-9545x8077,alejandro25@russell.com,2022-02-01,https://www.keller.com/
11-Apr-2021,Tax,658.00,00.00,"900,314.54",7E2B825e5A2DE2D,8145,Olivia,Carter,Carlson-Williams,Lake Adambury,Sierra Leone,333.953.9619x7319,(796)590-8956,bryantasha@kent-nash.net,2021-06-10,http://www.benjamin-holloway.net/
11-Apr-2021,Reversal,00.00,"128,616.36","771,698.18",4Aa0DeFBCfFbADe,2247,Carly,Cabrera,"Ali, Wells and Blanchard",Copelandland,Denmark,(480)293-6769x305,(420)953-5385,zortega@cannon.info,2021-10-26,https://www.griffin.info/
11-Apr-2021,Transfer,00.00,"77,169.82","694,528.36",bfea3c1f5C1fAf0,5761,Pamela,Alexander,Pacheco and Sons,Bradleymouth,Tonga,001-396-511-6694x3974,001-489-983-1625x8286,erik39@waller.biz,2020-03-31,http://petersen.com/
11-Apr-2021,Reversal,"1,164,987.25",00.00,"1,859,515.61",dDbaaAe0b9FaFfd,3023,David,Blackburn,"Blankenship, Weeks and Khan",East Rodney,Finland,(802)476-5007,141-122-3744,zschroeder@weber.info,2021-08-30,https://www.pruitt-davila.com/
11-Apr-2021,RTGS,00.00,"185,951.56","1,673,564.05",CEc2AA2fc5dd5d5,9910,Sonya,Contreras,Herman Ltd,Port Warren,Tunisia,+1-885-755-8588x161,+1-165-942-2079,jonathanweiss@moore.net,2022-02-23,https://www.hurst.org/
11-Apr-2021,ATM,00.00,"185,951.56","1,487,612.49",2BAdF35eCCFBAbA,9861,Dennis,Higgins,Mclean PLC,Gailchester,Nicaragua,698-152-9668x578,207-426-5757,alexleach@sexton.com,2021-02-19,https://www.marsh-tyler.com/
11-Apr-2021,Debit Card,485.00,00.00,"1,488,097.49",8b4bdbEe01deA5C,158,Veronica,Golden,"Wright, Contreras and Wagner",North Theresastad,Falkland Islands (Malvinas),(367)700-9543x932,+1-422-724-7575x684,gacosta@stephenson-tyler.biz,2020-03-31,http://www.best.com/
11-Apr-2021,NEFT,"1,879,550.20",00.00,"3,367,647.69",74a0FbE33f348DC,4501,Alexander,Craig,Mcgrath LLC,Marksside,Somalia,9984768790,(631)391-7340x8150,dhendricks@cameron.info,2020-10-07,http://www.simmons.com/
12-Apr-2021,Debit Card,"64,566.00",00.00,"3,432,213.69",8255AdCBD23349F,4742,Darius,Jennings,Santana Group,Lake Angel,Nepal,373.642.6306x41726,+1-280-879-0754x9437,brandyewing@barron-hawkins.com,2020-11-29,https://www.wheeler.com/
12-Apr-2021,Transfer,00.00,"429,026.71","3,003,186.98",DD45d02DF247316,4005,Adrian,Norris,Gardner-Mason,East Hector,Algeria,618.756.2410x200,+1-369-741-9669x03694,laurablankenship@wolf.com,2022-02-04,http://rose.com/
12-Apr-2021,Transfer,00.00,"429,026.71","2,574,160.27",aBb1F2AC72C757B,4916,Stanley,Malone,"Patterson, Davis and Holloway",Wandaland,Italy,001-557-685-1110x224,001-653-071-3851x414,wernerlarry@riggs.com,2020-01-11,https://www.shah.info/
12-Apr-2021,Bill,"3,807.52",00.00,"2,577,967.79",cb6Ad053DB15223,1544,Tiffany,Yang,"Stevenson, Chase and Miller",East Joyfurt,Nicaragua,320-630-7617,+1-927-040-1669,sbooth@hayden-haney.com,2020-07-28,http://castaneda.com/
12-Apr-2021,ATM,40.00,00.00,"2,578,007.79",B7C8Ac33DcDA629,166,Patty,Estes,Potter-Doyle,Lake Johnathanborough,Mozambique,555.786.9024x8126,(526)826-8221x0813,vincent58@norton.com,2021-02-08,https://www.mendez-duran.com/
12-Apr-2021,Bill,00.00,"429,667.97","2,148,339.83",a8Eff9e04AdfC29,2462,Jerome,Pearson,Patel-Costa,Watkinschester,Netherlands,732.495.6762x104,+1-506-597-2261x20206,wolfmiranda@burch.com,2021-09-18,https://strickland.biz/
12-Apr-2021,Cheque,00.00,"2,148,339.83",00.00,b7Ea7eE509100FE,3138,Eugene,Washington,Fernandez-Marks,South Anne,Azerbaijan,001-735-929-3910x3271,7019136522,tbruce@spencer.com,2022-04-23,http://holt-robles.com/
12-Apr-2021,Cash,"165,388.53",00.00,"165,388.53",345bb1727648cFC,2010,Angie,Weaver,Hansen-Baxter,Trujillomouth,Northern Mariana Islands,001-736-172-0169x63097,001-039-562-2083x664,pettysydney@rivas.com,2020-11-04,http://www.franklin.com/
12-Apr-2021,Purchase,00.00,"16,538.85","148,849.68",Dcae5D501C9adD3,1857,Monique,Alexander,"Small, Fox and Lamb",West Shellyview,Bolivia,001-999-291-7401x8115,775-142-8391x19212,arthurwang@pittman-foster.com,2021-07-03,https://www.johns.com/
12-Apr-2021,ATM,216.00,00.00,"149,065.68",cbE7c28a29871CD,2750,Norman,West,"Mack, Hendrix and Baker",East Ricky,Jersey,001-834-730-8339,788-005-3358,ddaugherty@travis.com,2020-06-24,http://www.woodard.com/
12-Apr-2021,Interest,00.00,"14,906.57","134,159.11",5167E3bEa50df7a,9596,Clarence,Nelson,Lawrence-Hood,North Katherineshire,Palau,8612421817,451.788.6324,nsheppard@matthews.com,2020-07-26,http://www.ashley.biz/
12-Apr-2021,Debit Card,"30,606.00",00.00,"164,765.11",b0A0e04fFcaEdbc,9686,Alexandra,Davis,Mora-Haley,South Mary,Congo,001-081-784-7107x67946,3513395676,josborne@huffman.com,2020-01-25,http://durham-drake.com/
12-Apr-2021,RTGS,"5,939.27",00.00,"170,704.38",861c02a9302a09D,3645,Lindsey,Frazier,"Hodge, Rush and Singleton",East Karina,Jersey,+1-159-446-6984x9015,(632)731-9287x181,baileystevenson@herrera.biz,2021-05-24,https://joseph-maynard.biz/
12-Apr-2021,Bill,"13,959.00",00.00,"184,663.38",7dBbbA4F7f4eeC1,8290,Nathan,Donaldson,Delgado Inc,Cummingsport,Cote d'Ivoire,(274)255-4865x480,381.739.4422,jvilla@phillips.com,2020-11-15,https://www.long.com/
12-Apr-2021,Reversal,00.00,"18,466.34","166,197.04",Fc1AEA19E7D000B,2003,Jade,Oneal,Harding-Barber,South Mikaylabury,Estonia,(259)793-8011x185,001-792-433-2130x76837,dshaw@baker-morris.com,2020-07-01,https://cervantes.com/
12-Apr-2021,Purchase,"25,513.30",00.00,"191,710.34",0aEdFcbdb76637c,446,Caitlyn,Cross,Bentley-Moyer,Lake Tannerstad,Solomon Islands,001-526-323-6313x65050,806.154.2363,jefferyhammond@guerra-chase.biz,2020-05-10,https://www.rivera.com/
12-Apr-2021,Tax,00.00,"31,951.72","159,758.62",eB53B2FaD51aeF7,72,Wesley,Cobb,Bruce LLC,Port Spencer,Congo,480-924-1413,6577055396,austinvang@glenn.com,2021-06-22,https://deleon.com/
12-Apr-2021,Reversal,00.78,00.00,"159,759.40",a3AC64E3e9D9DfF,4948,Frederick,Marks,"Shields, Garcia and Browning",Pennyburgh,Trinidad and Tobago,(283)555-5229,9348738998,ubanks@black.com,2020-11-16,http://www.flowers-sutton.com/
12-Apr-2021,NEFT,00.00,"31,951.88","127,807.52",624e2aEbFf6C72b,2504,Kristin,Hull,Aguilar-Zimmerman,Basston,Martinique,627-486-3182x6880,810-757-7863x6863,brucenancy@burke.com,2020-03-15,https://www.dunlap.com/
12-Apr-2021,Transfer,00.00,"42,602.51","85,205.01",0CE6799ca3D1E20,5018,Dan,Blevins,Rosales-Banks,Allenborough,Cuba,961.963.3695,309.939.9386,andreshoward@yoder.net,2020-06-29,http://www.norton.com/
12-Apr-2021,RTGS,00.00,"21,301.25","63,903.76",88aa37c1B5Bb4Cc,3958,Sophia,Whitney,"Wolf, Hobbs and Houston",North Brooke,Ghana,097-355-9437x28801,+1-139-580-4154x19391,frederickcandice@mata-collins.com,2020-06-02,http://cochran.com/
13-Apr-2021,IMPS,"113,075.30",00.00,"176,979.06",d07882386D90Af8,1794,Julia,Williamson,"Murray, Jennings and Mccarty",Moorefurt,Cote d'Ivoire,+1-000-610-1378x37842,913-094-6948,cassiesilva@patton-edwards.com,2022-04-10,http://www.mejia.com/
13-Apr-2021,ATM,00.00,"19,664.34","157,314.72",1335D5EF4cFCFce,696,Stephanie,Mcknight,Fisher-Villanueva,Jimenezside,United States Minor Outlying Islands,5932096162,+1-505-748-5134x594,ravengriffith@hess-walker.org,2021-07-25,https://brooks.com/
13-Apr-2021,Cash,746.34,00.00,"158,061.06",ca16Cf2cd907CA0,1045,Robert,Mcbride,Wallace Group,New Catherineside,Jamaica,296-076-3591,1899941634,reneestokes@pruitt.com,2021-03-25,https://www.richards-meza.org/
13-Apr-2021,RTGS,00.00,"39,515.27","118,545.80",1BbDa5FedBC3CE5,3651,Carmen,Mercado,"Robbins, Patrick and Melton",South Tabitha,Somalia,(492)849-0072,411-642-7479x8001,carrillojon@santana.com,2021-02-05,https://www.delgado.com/
13-Apr-2021,Commission,00.00,"39,515.27","79,030.53",A70fcbC0Af58085,2308,Drew,Vega,"Howe, Bowman and Wallace",West Roy,Antarctica (the territory South of 60 deg S),604-575-9747x72770,661-921-2507x9998,gpratt@rivas.biz,2020-11-06,https://lee-hebert.com/
13-Apr-2021,Reversal,49.00,00.00,"79,079.53",52Fb9e67D0bB21F,932,Samantha,Fletcher,Cowan Ltd,Tamifort,Nepal,621.138.7653x46963,001-386-607-2057,jacobsondorothy@garza.com,2021-03-10,https://logan.com/
13-Apr-2021,Bill,40.80,00.00,"79,120.33",07a0251Cff0A6Bb,5735,Dale,Pruitt,Burnett Ltd,Port Hollystad,Russian Federation,505-469-2224x227,+1-236-835-9930,xmora@barron.net,2020-05-07,https://pugh.com/
14-Apr-2021,Reversal,00.00,"39,560.17","39,560.16",A425ace78C9Bf03,7345,Colton,Durham,"Morton, Cantu and Conley",Grantfort,Ecuador,(330)649-8299x019,704-915-7161x18640,traciethompson@patterson.biz,2020-11-19,https://kaiser.com/
14-Apr-2021,NEFT,00.00,"3,956.02","35,604.14",2a4AEDf4ddDBEFD,4471,Kirk,Travis,"Watson, Tucker and Flowers",Henryside,Papua New Guinea,001-151-733-7625x84072,001-566-309-0195x7049,butlersean@hurley.net,2021-03-21,http://www.cuevas.com/
14-Apr-2021,Miscellaneous,00.00,"11,868.05","23,736.09",bBB6Bb4194361cC,122,Holly,Fletcher,Ford and Sons,Newmanbury,Thailand,001-583-336-8021x57385,+1-072-547-1221x03876,pammorales@james-benjamin.net,2021-03-17,http://werner.org/
14-Apr-2021,Cash,91.30,00.00,"23,827.39",c672a7Ec1652ddd,1285,Whitney,Rojas,"Crane, Hebert and Velez",Port Bradleyland,Iran,(761)590-7983,001-663-320-0183,lovemaria@shepherd-mcfarland.net,2022-04-16,http://bullock-stevenson.com/
14-Apr-2021,ATM,00.00,"23,827.39",00.00,64619Ffb49EcFcf,4863,Jeff,Bolton,"Duke, Fritz and Elliott",East Mikaylaberg,Malawi,625.357.5746,001-582-662-6994x687,watsonsarah@tucker.com,2021-01-15,https://chan-rodriguez.biz/
14-Apr-2021,Transfer,"4,063.81",00.00,"4,063.81",8b7E8fa6F8da7Ba,4353,Cory,Sosa,"Le, Carlson and Horton",East Leahton,Seychelles,+1-065-226-3481x88359,035.712.9262x85697,brocha@cantu.biz,2020-01-03,http://pineda.net/
14-Apr-2021,Cheque,"29,639.15",00.00,"33,702.96",1a2bBCCDC06dB2f,7679,Chelsea,Dickerson,"Hardin, Page and Holmes",Moranberg,Isle of Man,687-767-0321,337.477.7206,conwaycandace@daugherty-copeland.com,2021-02-12,https://gardner.com/
14-Apr-2021,Commission,06.40,00.00,"33,709.36",Bc9Cda3AAEED2DA,434,Kristi,Dixon,Kim Inc,South Rodneystad,Palau,(523)214-3540,001-614-536-6394,lindsaymiranda@atkinson.info,2021-12-04,https://wiggins.com/
14-Apr-2021,Purchase,"4,083.50",00.00,"37,792.86",Bb9F7Ee4a5Db396,9037,Carl,Whitehead,"Carter, Mckinney and Perry",Victorbury,Portugal,152-804-3798x0744,+1-060-555-7925x5672,marie46@norman.com,2021-01-22,http://www.lynn.net/
14-Apr-2021,Reversal,03.62,00.00,"37,796.48",2DcCde9EE476aA1,5103,Doris,Montgomery,Anthony Group,West Anna,Saint Helena,020-823-7753,+1-650-194-6286x13509,gail36@baldwin.com,2021-06-02,http://wheeler.com/
14-Apr-2021,NEFT,"24,046.10",00.00,"61,842.58",FFD9e89224Aaef0,4439,Angela,Fields,Werner LLC,Lake Joann,Maldives,346.738.3069x05079,+1-332-461-3610x3952,crosbysheena@kline.com,2022-03-09,https://www.dixon-flowers.com/
14-Apr-2021,Reversal,139.94,00.00,"61,982.52",0Baaeef2A4bAFCc,2064,Christine,Reynolds,Murphy-Hebert,Arellanoburgh,Lao People's Democratic Republic,(579)233-4974x66128,874-948-6778x56390,simonbradley@hodges.com,2020-11-07,http://www.morrison.info/
14-Apr-2021,IMPS,00.00,"10,330.42","51,652.10",cbD80CceD14e420,7967,Casey,Johns,"Craig, Tate and Chandler",South Jeffrey,Zambia,(740)970-1898,+1-357-607-9571x075,tross@le-proctor.com,2020-06-12,https://galloway-york.com/
14-Apr-2021,Commission,"26,007.90",00.00,"77,660.00",DbE06ca1BF426bb,5272,Lonnie,West,Frazier LLC,Mercadoberg,Colombia,2065726016,668.232.0104x45281,phyllis50@padilla.com,2020-11-05,https://www.bowers-velazquez.com/
14-Apr-2021,Tax,"233,695.50",00.00,"311,355.50",b5988BAea396458,2306,Evan,Yu,Hines PLC,Fostermouth,Greenland,715.900.6400x3228,+1-431-302-0386,kaitlynstevenson@crane.info,2021-11-01,http://www.stevens.com/
14-Apr-2021,Tax,00.00,"38,919.44","272,436.06",6d7b787f2Fdcd5b,9752,Sierra,Middleton,Russo-Daniel,Jakebury,New Caledonia,+1-387-962-6228,(186)951-0086x53533,aduffy@weaver.org,2021-12-10,http://www.montes.info/
14-Apr-2021,Bill,00.00,"68,109.02","204,327.04",f41dF8Fd2aF69d5,2248,Haley,Davies,"Hendrix, Meyers and Braun",North Albertborough,Guinea-Bissau,351.505.8558x6249,001-992-635-7508x439,camachooscar@clark.com,2021-11-05,https://www.kirby.com/
14-Apr-2021,ATM,"1,818,604.80",00.00,"2,022,931.84",EdaD8a6A5ec1eeb,6310,Kristen,Harrell,Mitchell Ltd,East Lorraine,Qatar,001-565-785-2455x345,+1-302-617-4416x651,omckenzie@coleman.org,2020-05-20,https://www.shea.com/
14-Apr-2021,Tax,00.00,"2,022,931.84",00.00,4277ca3aa0c7aE2,2726,Aaron,Hamilton,Decker Inc,Cesarbury,Nicaragua,923-194-6702x8699,(801)805-2422x474,zpark@carter-compton.com,2021-10-08,https://www.neal.org/
14-Apr-2021,Purchase,06.00,00.00,06.00,Ace6AE3C4e2cDDa,9136,Mitchell,Donovan,Ali-Gay,South Jakeshire,Taiwan,(646)366-1173x3107,552-125-1051x71046,combsjane@stein-molina.com,2021-01-01,http://swanson.com/
14-Apr-2021,Bill,00.00,03.00,03.00,c2890efA85cA3Ba,3265,Jill,Morrow,Carroll Group,Sophiaton,Italy,001-987-846-7320,454-885-9338,copelandrebecca@meyers.com,2020-03-19,http://www.dalton.info/
14-Apr-2021,Bill,"2,955.20",00.00,"2,958.20",Ffb73C1AF28Fc7D,1905,Franklin,Herman,Cantu Ltd,Allenhaven,Ecuador,217.091.3915,(214)546-4840x58518,salinasjasmin@jackson.com,2021-01-22,http://everett-wheeler.com/
14-Apr-2021,Tax,55.10,00.00,"3,013.30",f20Cac39a9bB582,6727,Kristi,Mitchell,"Carr, Parsons and Weaver",West Sheena,British Indian Ocean Territory (Chagos Archipelago),053.650.9093,001-407-106-2390x5626,agilbert@abbott-patrick.org,2021-03-23,http://rogers.com/
14-Apr-2021,Purchase,"207,209.00",00.00,"210,222.30",D4e86cFdDb63413,2299,Cheyenne,Weiss,Clements-Pace,North Hectormouth,Malawi,868.638.4119x88208,001-702-560-2026x68812,dmoyer@johns.com,2022-02-26,http://www.whitney.org/
14-Apr-2021,IMPS,"3,684.00",00.00,"213,906.30",beeF22589d6bb3A,3013,Cindy,Kelly,Thornton-Bell,Donnaton,Tanzania,7692029723,(769)796-5707,tina86@morrow.org,2021-02-03,http://bass.com/
14-Apr-2021,NEFT,00.00,"71,302.10","142,604.20",4cD5e1FEc5da5EA,7542,Jackie,Chavez,Mckay-Joseph,Stevensonton,Sudan,001-687-122-1183x8306,276-409-4332,manuelgallegos@ruiz.info,2021-07-16,http://www.pena.com/
14-Apr-2021,Tax,00.00,"28,520.84","114,083.36",A900ebAB9C1A591,2563,Dominic,Cowan,"Zhang, Castaneda and Boyer",North Bethany,United Arab Emirates,846.853.5593x2790,+1-892-570-0528,psanders@baldwin.com,2021-10-15,https://mckee.org/
14-Apr-2021,IMPS,00.00,"57,041.68","57,041.68",0DBBfcBd1e88F5D,3534,Jody,Mooney,Richard-Warren,West Tim,Palau,633-570-0780x60794,+1-519-071-3379x998,pattyhunter@davies-shelton.com,2020-04-24,https://garza-valdez.com/
14-Apr-2021,Miscellaneous,165.00,00.00,"57,206.68",0A8Ab0Fffb2835f,7178,Carol,Velez,Barrera LLC,Sherylmouth,Singapore,548-343-3775x3501,001-996-701-3133,brendan91@shea-bond.com,2020-12-31,https://hardin-wilkerson.com/
14-Apr-2021,NEFT,00.00,"8,172.38","49,034.30",8A96EECfBD1E182,199,Robyn,Abbott,"Dodson, Weaver and Barajas",Jodiberg,Somalia,001-158-488-8157,(812)515-3121x0742,breanna32@mayer.net,2020-12-31,https://www.jordan-phelps.org/
14-Apr-2021,RTGS,00.00,"5,448.26","43,586.04",AA4549c3Ba58Aa1,4314,Shane,Francis,"Valentine, Peterson and Costa",West Allisonton,Colombia,001-008-596-7689x5580,694-198-3626,basshenry@brandt.com,2020-02-08,http://kline.info/
14-Apr-2021,Cheque,203.00,00.00,"43,789.04",84b6F2aF4DFEFC4,9148,Carlos,Winters,"Wiggins, Potts and Ramos",New Brandy,Mexico,001-180-221-6721,1161654412,fodom@beasley.net,2020-08-24,https://www.fuentes.biz/
14-Apr-2021,Cash,00.00,"4,865.45","38,923.59",AcCbFad777D0711,8770,Nichole,Parrish,Patton PLC,Jeromehaven,Saint Barthelemy,8674945527,303.202.5737x55242,gabriellamcmahon@levy-fernandez.net,2022-03-18,http://www.pitts-sampson.org/
14-Apr-2021,Purchase,07.00,00.00,"38,930.59",8ea18A462e6b4ED,6462,Greg,Floyd,"Sexton, Howell and Mcgee",Wolfechester,Costa Rica,001-290-172-0104x623,(954)193-6871x7217,erincombs@haley-hubbard.net,2021-10-09,https://www.trujillo-porter.net/
14-Apr-2021,IMPS,"241,158.50",00.00,"280,089.09",A3eCbfde03704fc,5947,Mason,Berry,Hampton-Craig,West Blakeville,Paraguay,700.760.1260x32215,7765246895,derrick89@turner.com,2021-01-20,https://nelson.biz/
14-Apr-2021,RTGS,214.40,00.00,"280,303.49",8117ccb51bc0351,3513,Ashley,Pruitt,"Gomez, Walls and Olson",Port Zoebury,Malawi,001-000-659-8440x51897,039-025-7753x208,yesenia45@greene.net,2020-12-22,http://www.ponce.biz/
14-Apr-2021,Tax,00.00,"280,303.49",00.00,ec786A3A7879A48,6570,Deborah,Chang,Hicks-Small,South Phyllisside,Netherlands,(095)032-6123x38177,181-698-7579,arianasandoval@shea-atkinson.info,2020-08-14,http://www.farley.com/
14-Apr-2021,Commission,"1,631.50",00.00,"1,631.50",39AfAab3dEf0cc5,5036,Tammie,Glenn,"Petty, Franco and Oconnell",Susanstad,Bahrain,(467)659-0848,860-606-6266x3708,jane10@west-stone.biz,2020-11-23,http://www.cain.com/
14-Apr-2021,Purchase,00.00,815.75,815.75,Eb307A7082Cd6Fe,918,Maria,Robertson,Zimmerman Ltd,Bobshire,France,697-591-1231x62667,647.924.7139,snowsheryl@eaton-foster.com,2021-09-11,https://www.thompson.biz/
14-Apr-2021,Miscellaneous,00.00,203.94,611.81,eEeeBC5f877DdF5,6692,Ebony,Harrison,Larsen Inc,Beverlyview,Jordan,805-916-5642x04643,9222648505,thomasselena@patton.com,2022-03-25,http://bautista-kelly.com/
14-Apr-2021,Bill,00.00,122.36,489.45,Cb1cCdB8cc0C6CA,5460,Kaylee,Hardin,"Mosley, Johnson and Weeks",Bradyfort,Lebanon,001-729-803-3682x91674,161.996.0536,rsummers@paul.org,2020-04-12,http://peck.biz/
14-Apr-2021,Purchase,00.00,122.36,367.09,2cd3cEBb3Bb9c3f,9816,Nina,Boyer,"Brady, Lynn and Gallagher",South Kathryn,Saint Vincent and the Grenadines,738.100.5607x3601,190-674-6921x29242,jasmin50@sanders.info,2021-09-10,http://mckay.com/
14-Apr-2021,Commission,00.00,45.89,321.20,ed185ddD0DCc66A,4992,Sierra,Diaz,Mcpherson Inc,East Darrenland,Hungary,+1-803-501-3477x8101,400.009.3515,charlotte76@booker.com,2021-11-17,http://www.braun-mccullough.info/
15-Apr-2021,IMPS,"219,058.50",00.00,"219,379.70",34e58FDfe6CeAE6,7559,Derek,Weaver,Glass PLC,Bridgethaven,Peru,(303)511-5921,+1-411-184-3489x96449,swallace@owens-bruce.com,2021-03-02,http://flores-hale.biz/
15-Apr-2021,ATM,"136,150.00",00.00,"355,529.70",695cA606ecF5F75,1740,Danny,Barron,Yates Group,Lake John,Niger,+1-182-320-6044x282,857.685.9812x80466,lwood@davila.info,2021-04-12,https://www.morgan-brooks.com/
15-Apr-2021,Cash,00.00,"118,509.90","237,019.80",Ba8e7CDa24f8aD0,4244,Allen,Moore,Barnett-Carpenter,West Denniston,Botswana,+1-613-435-1063x9334,965.424.7779x037,tara91@lynch.com,2020-03-15,http://www.strong.net/
15-Apr-2021,Interest,00.00,"23,701.98","213,317.82",dfcC122F9aeDD48,8112,Darrell,Irwin,"Andrews, Hunt and Snow",Joannestad,Guatemala,(642)756-1033x43938,+1-893-713-6908x42001,ologan@berry.org,2020-06-27,http://www.everett.com/
15-Apr-2021,IMPS,00.00,"30,473.97","182,843.85",7284dE094D9E0AB,7480,Katherine,Gutierrez,Wallace LLC,Merrittfurt,Anguilla,001-637-206-1290x94155,132.822.1409,theresadominguez@travis-rich.biz,2021-11-09,https://www.mosley.net/
15-Apr-2021,Debit Card,77.30,00.00,"182,921.15",d1a8e4c3AAf49A6,7522,Rita,Durham,"Odom, Nicholson and Esparza",Marychester,Uzbekistan,001-703-638-8353x4532,975.733.2152x38178,jmahoney@skinner.com,2022-01-23,https://jensen-mills.biz/
15-Apr-2021,IMPS,"17,432.10",00.00,"200,353.25",2ce72b22eB0AbC8,4651,Jake,Hammond,"Barton, Strong and Cantu",Rachaelborough,Azerbaijan,001-181-346-1159x2055,083-785-1994,brett13@kidd.com,2021-01-12,https://www.ibarra.com/
15-Apr-2021,Cash,00.00,"66,784.42","133,568.83",DA7fB3b0f560FbE,4294,Kathryn,Walters,Stone-Obrien,Marisaton,Morocco,(683)928-6127,184-813-4291,obarajas@gates.net,2021-11-26,https://www.taylor.com/
15-Apr-2021,Commission,319.00,00.00,"133,887.83",C1DBc8d4CB9b8F2,338,Carrie,Downs,Barker PLC,New Miaburgh,Jamaica,001-208-863-9743x44787,001-634-376-4921,marilynandrews@cobb-watkins.com,2021-01-05,http://www.leach.com/
15-Apr-2021,IMPS,123.17,00.00,"134,011.00",2C8fD3b5b9B9Fa3,8892,Patricia,Byrd,Aguilar-Mckay,New Corey,Monaco,(865)674-4330x677,(879)602-2338,uguerrero@oconnor-hutchinson.biz,2022-01-12,https://bender.org/
15-Apr-2021,Bill,00.00,"16,751.38","117,259.62",E7B6DfeCce3EFf4,742,Catherine,Willis,Pruitt-Howe,Tannerside,Tajikistan,009-638-0514,487.963.0835x425,herringmelvin@little.org,2022-04-03,https://ingram.com/
15-Apr-2021,Transfer,"1,357,261.50",00.00,"1,474,521.12",a9dCa7ac9Ce2Ab2,987,Marvin,Fitzgerald,Matthews-Buckley,Stacytown,Martinique,+1-227-729-5055x928,(699)160-4397x611,eperez@thomas-montoya.com,2021-12-22,http://mays-saunders.com/
15-Apr-2021,Purchase,00.00,"245,753.52","1,228,767.60",DFf951FF9Be6FCF,8508,Kaitlin,Valencia,"Petersen, Wilkinson and Cooper",North Savannah,Swaziland,+1-495-698-4425,906.207.2160x0696,dodsonashley@sheppard.org,2020-01-04,https://www.stafford.com/
15-Apr-2021,IMPS,00.00,"136,529.73","1,092,237.87",73D2bA084Cadac5,4541,Wesley,Le,Dawson LLC,Hodgesberg,Sri Lanka,604.351.2315x074,(820)898-3610x08449,cassieday@delacruz-hensley.com,2020-03-03,http://www.coffey-small.com/
15-Apr-2021,Miscellaneous,00.00,"218,447.57","873,790.30",4A7175B251F289f,3242,Kaitlin,Holt,Herrera PLC,Eugenebury,Niger,001-886-355-1368x00537,+1-127-581-1831x5587,callahancrystal@little-castaneda.biz,2022-01-07,http://www.howard-mueller.com/
15-Apr-2021,Miscellaneous,00.00,"124,827.19","748,963.11",ddEe60B8e39AF8d,369,Bill,Hardy,"Mason, Proctor and Freeman",North Jessechester,Fiji,135-097-2385,(754)344-9493,antonio01@schmidt.org,2021-11-19,https://reese.biz/
15-Apr-2021,Bill,00.00,"748,963.11",00.00,e89bd0bA96B2FED,8210,Adam,Mcknight,Hill-Ballard,Brendabury,Netherlands Antilles,518.431.1423x42869,176.341.9952x679,hoovergene@pugh-hurley.com,2021-02-11,https://www.morris-padilla.info/
15-Apr-2021,Miscellaneous,"4,092.00",00.00,"4,092.00",Cb84dcFdDd42a06,193,Barbara,Cardenas,"Rios, Bautista and Reed",Shanehaven,Tuvalu,+1-077-894-3370x799,227.320.8552,wflynn@andersen.com,2021-03-10,https://www.anderson.com/
15-Apr-2021,Debit Card,00.00,818.40,"3,273.60",b86AfB34C99d83e,1581,Derrick,Braun,Schultz-Montoya,Sergioborough,Sweden,+1-940-585-6448x85995,607-836-7219,tstevenson@mcguire.com,2021-02-17,https://kline.com/
15-Apr-2021,Tax,"17,788.40",00.00,"21,062.00",b1BCbA94f5A288F,8095,Edward,Chaney,"Long, Collier and Kent",West Jennifershire,Luxembourg,206-189-7709x6895,418.609.3227x20016,tzamora@greer.com,2020-07-24,http://www.fisher.com/
15-Apr-2021,Cheque,00.00,"3,510.33","17,551.67",dFf0beC1aE7b2Ce,6649,Gene,Warren,Cortez PLC,North Virginiamouth,Japan,+1-454-508-7393x587,001-536-830-5586x7400,clintonnorris@griffin.biz,2021-03-05,http://www.bowman-dyer.com/
15-Apr-2021,Interest,04.70,00.00,"17,556.37",8a4d8eFE2F552D8,2336,Raven,Peters,Pittman-Ford,Allenfort,Turks and Caicos Islands,001-460-635-8606x35366,+1-164-072-5820,houstonyolanda@aguirre.net,2021-01-17,https://lozano.info/
15-Apr-2021,Interest,00.00,"3,511.27","14,045.10",7Cbfb6Cd73CAbeF,8944,Kellie,Cortez,"Singleton, Hayes and Diaz",East Eduardostad,Czech Republic,001-741-839-1507x1520,+1-523-669-0880x223,ymorrow@stanton.com,2020-09-20,https://www.shannon-shaw.org/
15-Apr-2021,ATM,02.70,00.00,"14,047.80",0a61b3DDCb9a18b,4363,Mikayla,Hanna,Hill-Richard,Gwendolynbury,Guyana,384.451.8292,(175)387-3412x52201,vwong@love-matthews.org,2020-03-01,http://www.hatfield.com/
15-Apr-2021,Debit Card,53.00,00.00,"14,100.80",def2E9c2A65F31C,786,Johnathan,Gibson,Osborne-Hebert,Bennettmouth,Benin,783.988.4035x513,643.190.3892,edwardlawson@hester.com,2022-02-22,http://galloway.com/
15-Apr-2021,IMPS,00.00,"14,100.80",00.00,5B65b13dcDeBFa4,579,Jermaine,Pittman,"Calderon, Bradford and Caldwell",Caitlinland,Turkey,(826)772-7605x725,966.816.3434x2156,gcobb@mcclure-weber.com,2022-03-14,https://benjamin-dudley.com/
15-Apr-2021,Debit Card,"1,495.00",00.00,"1,495.00",dC26cDe880F3Cf7,1178,Glenn,Hartman,Mcknight-Giles,Perryville,Benin,001-986-894-8752x738,032-725-1174x4602,michaela64@schaefer.com,2021-03-06,https://roth-odonnell.info/
15-Apr-2021,IMPS,"5,377.90",00.00,"6,872.90",Fb7B38BAF8039EF,1385,Ronald,Conway,Holmes-Donaldson,Bryanshire,Anguilla,313-886-2163x28559,001-844-545-1404x259,brittanywells@hays-skinner.com,2021-03-01,https://dunn-cervantes.com/
15-Apr-2021,Reversal,00.00,"1,145.48","5,727.42",C24caA81ad61d6c,2409,Shawna,Erickson,Chen Inc,Port Gwendolynhaven,Seychelles,358.460.4582x773,7553849200,rodney94@vance.biz,2021-02-14,https://www.sparks.info/
15-Apr-2021,NEFT,"160,084.00",00.00,"165,811.42",0B8bc12c8B4D44e,7833,Jay,Ferrell,Porter-Koch,Alisonside,Cook Islands,001-647-389-9947x355,7469253049,caldwelltanya@mcguire.com,2020-02-23,http://kline-vang.info/
15-Apr-2021,Cash,00.00,"165,811.42",00.00,d25bf3d67AAEA25,4115,Jared,Yang,Cardenas-Suarez,West Kathryn,Guinea-Bissau,(973)666-2797x58876,204.162.1356x525,melindafrazier@dixon.com,2020-08-31,https://www.goodwin.net/
15-Apr-2021,Cash,466.00,00.00,466.00,1A9bE5EbBfdC9b6,6948,Lauren,Ingram,Bird Ltd,Port Bobbymouth,Antigua and Barbuda,001-895-793-9015,434.563.2208,stacy08@gentry-neal.com,2020-10-14,http://www.clarke.com/
15-Apr-2021,Tax,00.00,51.78,414.22,ac4D0fAf91dB7dB,8008,Regina,Mosley,"Chen, Myers and Davidson",Hunterport,Pitcairn Islands,783.997.4297x90582,+1-760-800-1057x65903,angelamcintyre@sherman.info,2022-04-15,https://shaffer-melendez.com/
15-Apr-2021,Transfer,95.42,00.00,509.64,0F85AaD9bd7fDaD,5004,Laura,Manning,Reed-Knight,Pittsview,Indonesia,1923538674,001-401-676-6373x5593,ocordova@huff.com,2022-05-16,https://huynh-faulkner.com/
15-Apr-2021,Interest,00.00,72.81,436.83,1aa3CDB10F71B9f,226,Kendra,Wilson,Rivers-Woods,North Nina,Bolivia,+1-888-655-3187x97227,122.368.5637x8695,lucas94@barrera.com,2021-02-16,https://booth-guzman.info/
15-Apr-2021,Interest,00.00,218.42,218.42,65c1bbfeD1a0031,6330,Shirley,Michael,Rodgers Inc,North Marilynstad,Kuwait,576.614.1299x13645,9702829870,christyhuffman@osborn.biz,2021-07-01,https://hines-jones.net/
15-Apr-2021,Reversal,00.00,54.61,163.82,67BaEcFa13Adf5C,7832,Veronica,Kim,"Gates, Ingram and Scott",South George,Singapore,805-904-3661x36477,7762684396,roy03@kemp.biz,2021-10-05,https://hardin-kaufman.com/
15-Apr-2021,Miscellaneous,00.00,32.76,131.06,6DD5Fa3CB2b46fF,9122,Jenna,Dorsey,Hansen-Goodman,New Bryce,Dominican Republic,001-244-013-5029,272.913.3032,jaime60@sawyer.org,2022-05-24,http://www.marquez.com/
15-Apr-2021,Commission,00.00,65.53,65.53,c3FE9fCd5D26e8E,6960,Bruce,Meyers,Olson-Parsons,Beanberg,Fiji,0905184444,395.193.8608,phamjaime@schultz.com,2022-05-16,http://www.stanton-griffith.info/
15-Apr-2021,Transfer,"457,354.00",00.00,"457,419.53",ECCE6f3d2bbe65F,7686,Denise,Rodriguez,Medina and Sons,South Evelynberg,Argentina,039-036-0378x535,2192116779,selena30@harmon-shelton.biz,2020-10-27,https://www.blake.com/
15-Apr-2021,Cheque,"206,178.00",00.00,"663,597.53",Cb1cCdB8cc0C6CA,5460,Kaylee,Hardin,"Mosley, Johnson and Weeks",Bradyfort,Lebanon,001-729-803-3682x91674,161.996.0536,rsummers@paul.org,2020-04-12,http://peck.biz/
15-Apr-2021,Tax,00.00,"82,949.69","580,647.84",7aD25ca2caA1c37,4012,Sue,Tanner,"Rowland, Barker and Cruz",East Jean,Latvia,741.638.5816x46148,278-560-4439x9798,leviflynn@barr-myers.biz,2022-04-30,https://www.mckee.org/
15-Apr-2021,RTGS,"3,450.30",00.00,"584,098.14",4fA018fb372a8EF,2355,Ryan,Bradford,Bennett-Mcfarland,Lake Yvette,Macao,001-998-883-6818x3196,+1-063-013-0220x82289,haneysonia@petersen.info,2021-03-27,https://www.benitez-chavez.com/
15-Apr-2021,Reversal,00.00,"97,349.69","486,748.45",BCAB40FE65fE3AD,6260,Vicki,Jordan,"Singh, Velazquez and Mooney",Farmerberg,Taiwan,596.770.5777x8632,(030)096-0051,wcampos@murphy.com,2020-05-31,https://www.roman.com/
15-Apr-2021,Purchase,00.00,"162,249.48","324,498.97",AeaA86673657cBD,4361,Jonathon,Santiago,"Frey, Cummings and Sexton",Geoffreytown,Pitcairn Islands,+1-416-628-4269x39406,720.664.7110,danielle35@rich.com,2020-11-06,https://www.mclean.com/
15-Apr-2021,NEFT,08.00,00.00,"324,506.97",497A81a8Bc137FF,8464,Joel,Ho,Goodman-Osborne,Lawsonmouth,Guam,6680074387,(334)717-7618,cody23@robinson-mooney.com,2021-08-13,http://www.ortega.biz/
15-Apr-2021,Cheque,06.56,00.00,"324,513.53",20De1e87BFD55C8,5639,Alice,Evans,"Adams, Baird and Osborn",Port Blaketown,Gambia,229-212-1862,001-069-298-7666,wparrish@cisneros-mason.biz,2020-12-19,https://mcdonald.com/
15-Apr-2021,Bill,"1,519.70",00.00,"326,033.23",8df0bc36DdEd85B,5657,Brianna,Garza,Oneal-Cohen,Burnsland,Fiji,(138)958-9282x703,+1-782-139-6618x1151,uhurley@graham.com,2021-03-03,https://www.higgins.org/
15-Apr-2021,Debit Card,00.00,"65,206.65","260,826.58",c9D86f4fA51D9c4,3198,Kristi,Bishop,"Moran, Soto and Whitehead",East Carolynmouth,Falkland Islands (Malvinas),3568240392,8089199088,diane76@mills.org,2021-02-25,https://www.noble-villa.com/
15-Apr-2021,ATM,"254,435.00",00.00,"515,261.58",16e30af2efbd892,5559,Neil,Castro,Perry LLC,Kimborough,Hungary,+1-838-474-6768x6751,789.948.2000x10108,inorris@crane.com,2020-10-03,https://www.floyd.com/
15-Apr-2021,Debit Card,00.00,"85,876.93","429,384.65",43c4EAeB121dECf,607,Isabella,Rosario,Giles-Fischer,Marquezfort,Italy,992.000.5140x36403,001-279-362-7201x523,ekidd@lopez.com,2021-11-18,http://shea.net/
15-Apr-2021,Debit Card,00.00,"429,384.65",00.00,8Bb66a004b0BF0a,1309,Robin,Potter,"Chan, Waller and Chaney",Mathisport,San Marino,001-826-813-6429x3891,167.586.0435x946,freemantravis@norman.net,2021-01-19,https://torres-medina.com/
15-Apr-2021,Cash,"30,996.43",00.00,"30,996.43",B14E7ED4dC4CBBf,280,Deborah,Atkins,Wagner-Ayala,North Mindyview,Cook Islands,(698)435-4856,106.482.9107x4369,brettmorrison@bernard-knapp.com,2020-06-21,https://www.weiss-foley.net/
15-Apr-2021,Tax,00.00,"15,498.22","15,498.22",dA3669d0BaD459C,9377,Jade,Beasley,Stafford-Rosario,Bruceburgh,Venezuela,026-852-0074x943,+1-145-399-8308x6996,jprice@dunlap.biz,2021-03-06,https://arias-barry.org/
15-Apr-2021,Tax,22.00,00.00,"15,520.22",28AdFC167EA26B1,994,Ricardo,Hanna,Rich-Jones,South Jesus,Serbia,657.437.9532,786-769-6578x827,kendrablevins@dominguez-watts.com,2020-05-08,https://www.barton.net/
15-Apr-2021,Debit Card,371.20,00.00,"15,891.42",7F23F7acC9700EC,3061,Lorraine,Herman,"Berger, Barton and Huffman",New Michaela,Sudan,001-301-655-3175,533.040.0548x08673,hooverbenjamin@parker.net,2021-01-21,http://velez-shields.biz/
15-Apr-2021,Debit Card,00.00,"15,891.42",00.00,de0d74D6faC29A9,1207,Howard,Peters,"Moreno, Todd and Obrien",Jodystad,Korea,(979)348-5414x137,606-017-3757x90294,curtisbilly@cherry-werner.info,2022-05-08,https://www.harrison-church.org/
15-Apr-2021,Transfer,"1,389,840.00",00.00,"1,389,840.00",4FEEa0fF0e0Ac9d,1390,Wanda,Mooney,Wong LLC,Lake Tabitha,Zimbabwe,(402)978-0268x737,001-818-873-4183x018,glandry@moody.org,2020-01-22,http://huffman-colon.com/
15-Apr-2021,Interest,396.30,00.00,"1,390,236.30",dAE25B64E0AbFC1,317,Katie,Rios,"Zhang, Christian and Cruz",North Chad,Croatia,878.633.3191,833-852-7856x6413,jeffersonbrandi@cannon-trevino.com,2021-11-21,http://robbins.com/
16-Apr-2021,Cheque,05.30,00.00,"1,390,241.60",b00fDE199d877CC,7853,Morgan,Mata,Neal-Singleton,Hannahmouth,Dominican Republic,001-187-862-6443,001-648-600-3084x4477,eduardodiaz@boyer.biz,2021-02-03,https://www.olson.com/
16-Apr-2021,ATM,"7,112.16",00.00,"1,397,353.76",FBa4CdA74f5D1F4,9294,Alexandra,Barton,"Hughes, Schwartz and Haley",South Eugene,Aruba,001-560-584-9505x67587,4550545012,rdunn@stark.com,2020-12-23,https://bowen.net/
16-Apr-2021,Debit Card,183.53,00.00,"1,397,537.29",bA34810aC7B7aE7,1796,Destiny,York,Juarez PLC,Mezaborough,Kazakhstan,937.545.7338x134,006-948-3832,lucasconway@hardin.net,2020-08-02,https://www.webb.info/
16-Apr-2021,Debit Card,154.56,00.00,"1,397,691.85",cf5EfBBBcF9eDcb,7010,Sandy,Delgado,Pennington Inc,Maciasville,Uruguay,+1-562-318-0154x5624,544.070.9619x9515,mindy57@yu.com,2021-06-04,https://chambers-robertson.com/
16-Apr-2021,Commission,00.00,"155,299.09","1,242,392.76",C1e2f27674cB9e3,6233,Lindsey,Ramos,Cowan-Rivera,Aliceville,Martinique,001-186-311-9296x6384,274.441.2656x53685,hollowaydrew@mora-morrow.info,2022-05-21,http://www.travis.info/
16-Apr-2021,Bill,"28,587.10",00.00,"1,270,979.86",9EBDc5A06dF5EAC,6831,Gregg,Johnston,Irwin Ltd,Bernardfort,Korea,001-243-591-3118x430,8962531839,tcowan@sutton.com,2022-01-28,http://www.sheppard.com/
16-Apr-2021,Cash,"1,458,566.00",00.00,"2,729,545.86",5036998Ab425e74,1478,Karla,Maldonado,Leach-Gilbert,Krystalville,Hong Kong,+1-292-843-6056,421-345-0261x624,wjenkins@page.info,2020-04-23,http://www.greene-morgan.info/
16-Apr-2021,Purchase,00.00,"389,935.12","2,339,610.74",e0510d8AfBE0e2C,6100,Charlene,Mullen,Calderon LLC,New Kimchester,Bosnia and Herzegovina,(890)744-2764,848.683.5632,aayers@warren-burch.info,2020-01-13,https://www.harvey.net/
16-Apr-2021,IMPS,"2,440.00",00.00,"2,342,050.74",8484EBAd0518576,3454,Stacie,Hutchinson,"Mullen, Bolton and Hunt",Lake Joshua,Anguilla,(179)680-4981,+1-491-436-2507x11551,lynnchurch@horne.net,2022-02-08,http://www.finley-wong.biz/
16-Apr-2021,Debit Card,35.39,00.00,"2,342,086.13",bcafCACB12afEDB,8756,Leon,Vega,Barron LLC,Pettyborough,United Arab Emirates,746.302.5480x15080,7985002609,sdeleon@jennings.com,2020-04-18,https://www.calderon-webster.com/
16-Apr-2021,Interest,"1,520.77",00.00,"2,343,606.90",8bFE9aaDFdbfB59,5542,Jesus,Chaney,"Odonnell, Knight and Wu",South Mathewside,Guernsey,(304)133-2020x2431,883.746.2369,kaylee52@sloan-huang.info,2021-12-24,http://www.bennett-roy.com/
16-Apr-2021,IMPS,00.00,"390,601.15","1,953,005.75",8feF496A4A4ea2b,1242,Sheri,Stein,"Sandoval, Richard and Conner",Port Bettyburgh,Albania,626-151-5025x11371,205-062-4113x30726,bradleyjeremy@wu.biz,2021-05-23,http://www.rodgers.com/
16-Apr-2021,Cheque,05.66,00.00,"1,953,011.41",eBcEBD4bF39B1E9,9511,Darlene,Burnett,"Eaton, Vincent and Moss",Juanberg,Vanuatu,121.992.3556x351,791-475-9541,benjaminbullock@hull.biz,2021-07-06,https://www.clayton.com/
16-Apr-2021,Cheque,00.00,"279,001.63","1,674,009.78",19dfE8dBdA1Fe80,9315,Jeanette,Harmon,Tran-Beltran,Villarrealport,Estonia,001-614-478-2933x20609,001-496-927-0922x4246,rhodges@hammond.com,2021-08-11,http://banks.biz/
16-Apr-2021,NEFT,00.00,"558,003.26","1,116,006.52",9cBEac757D6dcBB,2683,Natalie,Dalton,"Cowan, David and Suarez",Cochranview,Burkina Faso,681.299.2250x436,+1-389-229-1187x096,gmurphy@brown.info,2022-05-06,http://www.villa-melendez.com/
16-Apr-2021,Transfer,"197,625.00",00.00,"1,313,631.52",7837f7a99B762c4,7571,Jenna,Valencia,"Hawkins, Hebert and Shea",East Steven,Greece,+1-308-366-6759x8776,9557745413,fchapman@wilcox.com,2020-04-26,http://www.hayes.com/
16-Apr-2021,Debit Card,00.00,"328,407.88","985,223.64",AFebeb9aE5A5e30,5817,Tricia,Rivers,"Atkinson, Robbins and Sawyer",West Alex,Suriname,227.135.3572x3259,+1-992-838-1296x444,nortongloria@knox-dudley.biz,2020-11-27,https://chen-kelly.net/
16-Apr-2021,RTGS,402.00,00.00,"985,625.64",c0fBFEbf1dDF0f6,2617,Reginald,Key,"Barr, Abbott and Hodge",Lake Jose,Angola,320.524.2117x1982,526-706-3820,mccormickselena@middleton.com,2020-05-11,https://becker-guzman.com/
16-Apr-2021,Commission,00.00,"985,625.64",00.00,5eA4d5B2Fb28BE5,7380,Jenna,Webster,"Berger, Lewis and Small",Ryanshire,Ukraine,485-735-6231,084.269.7099,belinda97@lopez-shaffer.net,2021-03-05,http://donovan.net/
16-Apr-2021,Purchase,06.73,00.00,06.73,4cAb8c0eC5811B5,2654,Rick,Johnson,"Noble, Holloway and Silva",West Ana,Heard Island and McDonald Islands,+1-518-849-5010x343,463.574.1156,englishtroy@castro-farley.info,2020-10-30,http://www.evans-frank.com/
16-Apr-2021,RTGS,"9,743.00",00.00,"9,749.73",9163deeC45020Fe,7635,Emily,Sharp,Anderson Inc,South Edwin,Taiwan,898.240.8662,358.268.7598,iwatkins@sanchez.com,2020-07-01,https://www.cantu.org/
16-Apr-2021,Bill,13.70,00.00,"9,763.43",87AEb696FBA2e7a,3005,Clarence,Gaines,Freeman PLC,Caseton,United States of America,697.220.3788x8731,010.537.1005,maria80@mcknight.com,2021-10-13,http://murray-ford.com/
16-Apr-2021,RTGS,06.00,00.00,"9,769.43",38ad1494129579d,2004,Ronald,Bryan,Beltran Ltd,Fitzgeraldfurt,Malta,065-433-5637,+1-058-132-5152x7767,aimee87@riggs.com,2021-12-24,http://www.chavez.com/
16-Apr-2021,Transfer,00.00,"1,395.63","8,373.80",c6A66ab99886c2B,7191,Benjamin,Booth,"Gill, Everett and Beard",Rogerstad,Spain,740-621-2074x46964,001-345-548-8526x654,stephenrowe@cantrell.info,2021-02-04,https://herring.net/
16-Apr-2021,Tax,00.00,"1,196.26","7,177.54",d8BE2fA1d0D0803,5534,Krista,Guerra,Valenzuela-Webb,Cardenasshire,Haiti,672-744-4061,(182)478-4741x22299,cynthiahouse@mata-parsons.com,2022-02-20,http://horn.net/
16-Apr-2021,Interest,00.00,"2,392.51","4,785.03",f21CF91B332Dac8,9967,Margaret,Hines,"Wilkinson, Lamb and Holt",Gouldview,Guyana,727-808-0986x9527,868.979.0956,cheyenneboyd@tucker.biz,2022-01-15,https://www.mann.com/
16-Apr-2021,Transfer,00.00,"1,196.26","3,588.77",8eAbA65944cC3bb,3200,Kristy,Ward,Carroll-Pearson,Lake Jasonshire,Romania,(636)162-8737,001-312-201-5023x623,myoung@shaffer.com,2020-07-29,http://sims.com/
17-Apr-2021,Cheque,00.00,897.19,"2,691.58",4244D72Ab6a5c2D,988,Lynn,Booth,Morton-Petty,Geraldtown,Peru,(111)338-4918,3474514709,david48@everett.info,2021-08-29,http://kirk-zhang.com/
17-Apr-2021,Transfer,00.00,"2,691.58",00.00,dD1cD80Db48C644,8294,Rebekah,Jensen,Bolton-Goodman,Cooperstad,Russian Federation,001-107-068-7150,071.331.8710x9532,fdoyle@peck-cunningham.com,2020-07-06,http://gross.biz/
17-Apr-2021,IMPS,"1,534,198.00",00.00,"1,534,198.00",E5B87FC32BdCe3C,791,Catherine,Schmitt,Cherry-Nunez,North Stephaniemouth,Togo,+1-793-441-4448x348,+1-444-799-6940,nhood@hendrix-petty.com,2020-09-04,https://www.duncan.biz/
17-Apr-2021,NEFT,"3,143.00",00.00,"1,537,341.00",f0dAFe2BC8C22c0,3315,Heather,Zhang,Bryan Inc,Alanfort,Israel,(297)212-2829x633,9901285171,bennettmakayla@erickson-contreras.org,2020-12-16,http://fields-shah.com/
17-Apr-2021,Cash,"787,539.80",00.00,"2,324,880.80",A6f77F0De5a6cCB,8376,Cathy,Esparza,Massey and Sons,West Becky,Iceland,(912)501-4734,487-514-7748,audrey61@harper-salinas.biz,2021-04-19,https://harvey.info/
18-Apr-2021,Purchase,"13,501.00",00.00,"2,338,381.80",51B6d21abcc449e,592,Christie,Valdez,"Sellers, Levy and Wilkinson",Port Ricky,Saint Pierre and Miquelon,+1-429-274-5434x054,+1-791-857-2689x204,aruiz@baker.biz,2022-02-12,https://www.harrison.net/
18-Apr-2021,Commission,"21,807.00",00.00,"2,360,188.80",bffF52a944A3652,8254,Dean,Bruce,Cabrera Ltd,Wernermouth,Antarctica (the territory South of 60 deg S),762-256-4477x67554,(772)855-7711x83954,omckay@daugherty.com,2020-12-01,http://www.kelley.com/
18-Apr-2021,Cheque,03.20,00.00,"2,360,192.00",7E11e6CacBddfDd,9425,Glenn,Chandler,Conway-Duran,Lake Natashamouth,Cambodia,(100)039-3443x39217,(083)227-3197x642,barbaracook@kirby-buchanan.com,2022-04-12,http://lester.org/
18-Apr-2021,RTGS,00.00,"262,243.56","2,097,948.44",6ADdaC7BE76DbB2,7921,Andrea,Koch,Cordova-Dillon,East Xavier,Jamaica,(520)201-7880,001-711-324-6957x49258,tom01@harper-roth.com,2020-05-06,https://nelson-cameron.org/
18-Apr-2021,Commission,00.00,"419,589.69","1,678,358.75",660DF2Bc128c66e,4143,Jason,Roberson,Sullivan LLC,New Kerry,Philippines,(023)709-6994x3354,(317)472-3422x700,devinwolfe@garrison.info,2020-07-08,http://www.coleman.com/
18-Apr-2021,Commission,"151,467.50",00.00,"1,829,826.25",6b50Fd669Ee0eA1,6934,Gabriel,Booth,"Cabrera, Francis and Parrish",East Alejandrofort,Georgia,938.813.4909x42394,001-431-415-6104x136,sonyalyons@branch.org,2020-01-05,https://www.moses.com/
18-Apr-2021,ATM,"1,402.00",00.00,"1,831,228.25",E00A87b6bDE631b,6452,Seth,Kennedy,"Guzman, English and Saunders",Neilchester,Myanmar,195-029-4497,+1-942-436-3695,alishali@larsen.net,2022-01-03,http://www.chan.net/
18-Apr-2021,Bill,41.65,00.00,"1,831,269.90",FEB9bAd1b77B63D,9072,Darlene,Gonzales,Herring-Moon,East Shawna,Mali,(918)056-7772,001-475-705-0697x3441,alvinriley@meadows.biz,2020-04-12,https://www.lyons.com/
18-Apr-2021,RTGS,00.00,"183,126.99","1,648,142.91",543B060D55adf9A,4176,Kaitlin,Andrews,Miller Group,Shawnaview,Sri Lanka,(663)576-4966x992,(926)503-0622,corypayne@conway.net,2021-01-13,http://www.woodward.com/
18-Apr-2021,Commission,356.75,00.00,"1,648,499.66",909AdCeaf0db5c0,5835,Joel,Camacho,Chang-Woods,Rayland,Ireland,001-918-370-5334x57956,889-854-9766x841,alexander05@rubio.org,2020-04-17,http://escobar.biz/
18-Apr-2021,ATM,00.00,"274,749.94","1,373,749.72",77ECeDc4ECFE3e7,6055,Donald,Frank,"Hays, Shaw and Perkins",South Theresachester,Niue,085-270-5158x82630,001-752-467-4977x15704,xbarr@shelton.com,2021-12-27,http://www.mayer-wu.com/
18-Apr-2021,Interest,188.50,00.00,"1,373,938.22",dAccaA95A27293c,6443,Terrence,Grimes,"Potter, Potter and Meza",South Kylie,Seychelles,998.274.4472x1843,001-722-866-7241,lromero@drake.com,2020-06-05,http://www.flores-cummings.com/
18-Apr-2021,IMPS,00.00,"274,787.64","1,099,150.58",17ef9E711F27a76,534,Terri,Fleming,"Bridges, Wiley and Rush",New Stacyborough,Guinea,(115)555-6807,(779)966-7094x1928,loganschneider@blake.info,2022-02-25,http://mcpherson-henry.com/
18-Apr-2021,Bill,00.00,"274,787.65","824,362.94",2d3EE83ce44AbB2,121,Curtis,Middleton,Bridges-Cortez,Briannashire,Luxembourg,(206)189-5437,+1-667-386-1208x677,vernon36@browning.info,2021-06-28,http://parrish.com/
18-Apr-2021,Miscellaneous,38.30,00.00,"824,401.24",eDe45bf6aC8ADf2,2165,Daniel,Saunders,Deleon PLC,Murillomouth,Anguilla,+1-303-100-7355x72073,(339)014-6677x12329,lshea@davis.biz,2020-11-09,http://espinoza.com/
18-Apr-2021,Transfer,00.00,"274,800.41","549,600.83",EDeE6FcBe021AbF,8639,Kelsey,Medina,Odonnell Group,North Lisa,French Southern Territories,+1-410-692-7968x5464,+1-082-579-2667x503,portermackenzie@cline-dawson.net,2021-10-27,https://dodson.com/
18-Apr-2021,Purchase,47.22,00.00,"549,648.05",48da69dadc8625C,9523,Lee,Schmidt,"Hensley, Miller and Villegas",West Williamside,Luxembourg,(062)803-4604x25879,(185)435-7945,gloveralexandra@orozco.biz,2021-05-02,http://www.logan.com/
18-Apr-2021,Miscellaneous,00.00,"68,706.01","480,942.04",decAB0399a52DeF,6519,Shawn,Mercer,Ramsey Group,Jeffersonborough,Northern Mariana Islands,383.820.3967x3625,(307)666-7945,perezjenny@rowland.biz,2020-02-10,https://www.villarreal.com/
18-Apr-2021,Commission,"1,605,695.00",00.00,"2,086,637.04",35fc2050bF9b142,8142,Jessica,Brennan,"Houston, Bender and Lara",Mullenfort,Netherlands Antilles,(257)881-0460x7036,524.530.8521x6403,peter11@meyers-huber.com,2020-07-28,http://www.mathis.org/
18-Apr-2021,Transfer,00.00,"2,086,637.04",00.00,8F37E9Cb539Ab37,4624,Sandra,Herman,"Hughes, Bullock and Mayo",Lake Cole,Denmark,001-228-563-0044x89663,153.691.9404x0311,graypam@pruitt-benjamin.com,2021-06-18,http://www.torres.biz/
18-Apr-2021,NEFT,12.00,00.00,12.00,846bC7DF25683E6,5256,Tom,Mclaughlin,Luna-Moses,East Yolanda,Albania,0237516785,001-508-445-2057x43687,emily15@rice-elliott.net,2022-02-08,https://nolan.net/
18-Apr-2021,Interest,00.00,12.00,00.00,3DaDb9E6Af1afc8,7794,Dawn,Sharp,Ayers Ltd,West Darren,Benin,+1-872-478-4247x65823,929.102.4184x704,ohughes@herrera.com,2021-11-08,https://www.kim-norton.org/
18-Apr-2021,RTGS,487.00,00.00,487.00,A3d3B2Ffea9946d,6129,Madison,Thompson,"Clark, Crane and Hanna",North Christinaland,Comoros,734-151-3999x70972,001-099-343-6167,shellyconner@jefferson-lowe.com,2021-07-23,https://lin.com/
18-Apr-2021,RTGS,00.00,81.17,405.83,6fA8A85C2e0d708,3690,Carly,Wall,Drake-Allison,Lydiafurt,Falkland Islands (Malvinas),(077)044-5712,710.061.5081,alisha98@bennett-frazier.com,2022-04-26,https://www.petty.com/
18-Apr-2021,Transfer,00.00,81.17,324.66,FaD7BcB59a69F04,5344,Cole,Mcdowell,Martinez-Casey,Dillonview,Reunion,091.366.5461,+1-173-411-6745,drewknight@mckenzie.net,2021-06-01,https://silva-gates.com/
18-Apr-2021,Reversal,00.00,108.22,216.44,074A2bEbfcA81F7,3961,Logan,Gross,Bautista-Avila,Danielstad,Belarus,(779)157-4807x6133,001-083-032-4921,willie03@brandt-kline.com,2020-02-28,http://www.arias-pruitt.com/
18-Apr-2021,IMPS,00.00,21.64,194.80,adbCFFfBF1eABF0,1988,Wesley,Keith,"Vang, Shaffer and Gilmore",Suemouth,Ghana,+1-687-922-6577,(676)161-8782,kdominguez@moore.info,2021-02-14,https://case.info/
18-Apr-2021,Bill,"51,915.09",00.00,"52,109.89",DbB5181C9B26B4e,2819,Mckenzie,Harrison,"Carpenter, Novak and Lester",East Edwin,Antigua and Barbuda,722-772-1231x8162,+1-693-958-7938x783,gbryan@krueger.com,2020-09-05,https://gallegos.info/
18-Apr-2021,RTGS,00.00,"5,210.99","46,898.90",309E4a099951Da1,9719,Joseph,Contreras,Kaufman PLC,North Sheenatown,Timor-Leste,636.135.0525,001-571-817-3043x12415,glenda32@gamble.com,2020-06-20,http://davidson.com/
18-Apr-2021,Cash,363.60,00.00,"47,262.50",9E0375Ff1c3Cf4f,2864,Chad,Wilson,"Rojas, Greer and Davenport",New Anitashire,Tuvalu,+1-377-470-5985x56363,001-071-786-7214x717,joannevillarreal@mata.org,2022-01-04,http://gilmore-chung.com/
18-Apr-2021,Transfer,00.00,"47,262.50",00.00,0748BdEFeb4834F,26,Mackenzie,Williamson,Hart-Klein,New Maxhaven,Saint Helena,+1-605-640-1833x70183,656.931.4990,zramos@haney.org,2020-03-06,http://www.allison-clements.com/
18-Apr-2021,Miscellaneous,"241,005.50",00.00,"241,005.50",add8585D174a0cB,1895,Joy,Crosby,Trevino-Mathews,South Charlestown,Isle of Man,564.723.7447,001-739-111-0380x9519,priscilla20@david.com,2020-12-07,https://www.cunningham-sanders.info/
18-Apr-2021,RTGS,00.00,"120,502.75","120,502.75",7Cb95D11c747Ae3,6832,Crystal,English,"Hooper, Wilson and Peterson",New Natashafort,Bulgaria,001-160-047-9031x494,001-171-205-4733x169,robertaduke@case.com,2021-07-16,https://www.woods.com/
18-Apr-2021,Cash,10.76,00.00,"120,513.51",83D3EfF10D3fCE7,8317,Clinton,Shannon,Rojas Group,West Darlene,Finland,201.127.5206,082.880.5381x29459,molly02@noble.com,2020-10-27,http://fischer.net/
18-Apr-2021,Commission,"127,365.38",00.00,"247,878.89",58AFDbCfcE0DCde,5716,Carl,Cardenas,Fitzpatrick-Bishop,Sheppardburgh,Sweden,001-166-638-8215x333,+1-777-284-4577,gamblehenry@fuller.com,2020-08-15,https://reeves-miranda.net/
18-Apr-2021,NEFT,00.00,"61,969.72","185,909.17",7022d84c9cBc309,401,Bradley,Sanford,French-Berg,Selenatown,Honduras,158-673-3550x484,7432518490,nunezsavannah@henderson.info,2021-11-16,https://vaughn.com/
18-Apr-2021,Debit Card,00.00,"46,477.29","139,431.88",6d1dB53a9ad2E25,6826,Chase,Archer,Davidson-Barton,North Sabrina,Mexico,001-917-302-1382,909-189-3074,jay67@patel.com,2022-03-26,http://mccormick.org/
18-Apr-2021,Cheque,00.00,"17,428.99","122,002.90",62472c95c7A68dE,3624,Max,Mitchell,"Lang, Trevino and Sandoval",Brandonchester,Zimbabwe,069.960.7434x178,(948)978-0815,darin48@lane.org,2022-02-12,http://www.branch.com/
18-Apr-2021,Cheque,"229,863.00",00.00,"351,865.90",908Ee0D2FDAf215,3935,Stephen,Blevins,Mccoy-Fernandez,Carrstad,New Zealand,702-177-6288x6612,(615)804-3091x88007,lsilva@chaney.org,2021-03-30,http://www.riddle-james.net/
18-Apr-2021,Tax,"19,757.80",00.00,"371,623.70",9aE76C4FAfdc245,5593,Lindsay,Jarvis,Hahn LLC,Noahstad,Sri Lanka,402-271-8142x836,7276811001,qhopkins@thompson-jefferson.com,2021-05-09,http://www.warren.com/
18-Apr-2021,Tax,00.00,"371,623.70",00.00,3db7df88F2eB7a9,2102,Brett,Miles,Fuentes-Savage,Port Calebstad,Cambodia,7511212632,2853011278,lynnkellie@powers.info,2020-07-27,https://www.sherman.net/
18-Apr-2021,Bill,"2,756.50",00.00,"2,756.50",65b46e79ccD48de,5765,Lucas,Pena,"Becker, Oconnell and Aguilar",Leachborough,Eritrea,001-909-990-0940,+1-390-148-0396,petersengwendolyn@walters.com,2021-04-18,http://mejia-howe.com/
18-Apr-2021,ATM,"227,452.00",00.00,"230,208.50",66E95eA94Ec95F9,6347,Tony,Reynolds,Villa-Mckenzie,South Juan,Martinique,832.894.4691x362,001-597-702-3226x35787,ltanner@valdez.com,2020-07-06,http://www.gutierrez.info/
18-Apr-2021,Interest,"1,751.20",00.00,"231,959.70",9Ea679de7eE92bC,5527,Jeff,Ballard,Oconnell-Dyer,North Chelsea,Philippines,001-776-526-6951x541,007.465.9578x9224,mackenziebeck@haley.com,2020-09-30,https://page.com/
18-Apr-2021,Interest,00.00,"77,319.90","154,639.80",9AA4c0bbAeEadf2,6786,Cassandra,Barnes,Cortez LLC,Edwardport,Palau,+1-482-413-7046x7213,6826624532,lmcintyre@alexander.org,2021-01-17,http://frost-aguirre.net/
18-Apr-2021,Cash,00.00,"19,329.98","135,309.82",0bB1414eEdd0Bd0,927,Stuart,Ray,Abbott LLC,Mckenziehaven,Bulgaria,514-443-4395,063.042.8550x738,scott45@sanford-obrien.org,2021-06-30,https://mccoy.info/
18-Apr-2021,Cash,"2,187.00",00.00,"137,496.82",e1Ee301D7d6ac1e,2707,Shane,Holloway,Davila-Trujillo,West Reginald,Korea,116-124-8781x69177,(784)179-4826,fritzgabrielle@hebert.biz,2021-04-01,https://www.barajas.org/
18-Apr-2021,ATM,15.00,00.00,"137,511.82",059e4fccDe20e8d,5713,Megan,Armstrong,Ochoa PLC,Natashaville,Korea,401.702.0903x15570,030-737-6213x33648,andre97@robbins.org,2021-11-10,https://alexander.com/
18-Apr-2021,Interest,00.00,"22,918.64","114,593.18",c4f04892ee673bE,7252,Melvin,Jenkins,"Mccarty, Browning and Mclaughlin",Port Theodoremouth,Mayotte,001-740-236-4310x0088,308.514.0641x585,marisanewman@drake.com,2022-04-17,https://www.phillips.com/
18-Apr-2021,Interest,00.00,"11,459.32","103,133.86",632CbfBa0E8EFf0,1874,Ray,Costa,"Heath, Berg and Gibbs",Port Marilynmouth,Liberia,(267)090-3873x73189,590-919-1051x3235,rherring@galloway.info,2020-12-08,http://marsh-oconnor.com/
19-Apr-2021,Miscellaneous,00.00,"10,313.39","92,820.47",Fce60568960e726,4568,Mackenzie,Murphy,Beasley-Kim,Lake David,Montserrat,+1-551-970-1239x71090,651-644-7495,vwebb@hoover.net,2021-12-25,http://www.dunn.net/
19-Apr-2021,NEFT,00.00,"18,564.09","74,256.38",6761CdEFBf35cA2,9277,Jane,Ochoa,Gilbert Inc,Dyerside,Maldives,523-523-3824x146,+1-414-967-0513x294,solislinda@bender-salazar.com,2020-10-30,https://juarez-herring.com/
19-Apr-2021,Commission,"209,037.10",00.00,"283,293.48",c5fF9EBcBe49baF,2751,Joe,Joseph,"Boyer, Bullock and Phelps",Gracehaven,Lithuania,237.360.2497,445-458-6323,joel53@reed.com,2020-04-02,https://rubio.com/
19-Apr-2021,IMPS,00.00,"35,411.69","247,881.80",d575c37CAD9B3D1,2804,Harold,Carlson,Meza Group,Lake Tashaborough,Zimbabwe,+1-818-748-6059x7404,752.731.8428x0924,sandovalmary@woodward.com,2020-12-19,https://lowe-matthews.com/
19-Apr-2021,Miscellaneous,00.00,"49,576.36","198,305.44",31C0ADfa5F40c40,465,Shirley,Anthony,Maxwell Ltd,West Tonistad,French Polynesia,+1-193-838-3198x1601,5959421166,phillipshayley@carr.com,2020-05-08,http://mcdowell-pugh.info/
19-Apr-2021,NEFT,"3,673.50",00.00,"201,978.94",ab5fcAF6C108a6f,7303,Alice,Diaz,Odom-Mejia,North Jeffery,Gambia,872-741-9897,(862)769-0774x99329,nrichardson@blair.biz,2022-02-23,http://conner.info/
19-Apr-2021,Reversal,"13,061.10",00.00,"215,040.04",ACEfEa8bcE2BCa4,9904,Bill,Barnes,Stanley-Bates,West Sylviamouth,Comoros,948-510-5107x6670,001-979-021-1765x565,coopertheodore@prince-carpenter.biz,2020-08-22,http://pearson.com/
19-Apr-2021,Purchase,304.49,00.00,"215,344.53",128aB9ca17FCcF8,6982,Leah,Yu,"French, Riley and Lee",South Kellyfort,Palestinian Territory,+1-039-248-2513x8095,001-505-600-6588x36904,rbates@webster-mcintyre.com,2020-01-03,http://wiggins.com/
19-Apr-2021,Purchase,00.00,"30,763.50","184,581.03",dAAA0a0f13cDe0D,8512,Tami,Yang,Gentry-Newman,Sherylbury,Bahrain,+1-147-607-9032x64548,+1-938-330-2970x6399,timothycooke@harding-hood.biz,2022-05-06,https://www.brady-sanford.com/
19-Apr-2021,ATM,00.00,"26,368.72","158,212.31",cc5c8CBDe60eb46,940,Troy,Gentry,Fuller-Berger,West Barrybury,Cook Islands,+1-456-013-7352,9671127981,mhayes@lester.com,2021-11-05,http://www.mendez.com/
19-Apr-2021,IMPS,"75,960.00",00.00,"234,172.31",8Acb14a4FBB1F42,7383,Tammie,Good,"Jordan, Bradshaw and Barber",South Jayhaven,Djibouti,001-626-577-9248x0032,382-920-2668x05668,chaselarsen@holland.info,2020-02-03,https://www.bright.com/
19-Apr-2021,Debit Card,"23,241.00",00.00,"257,413.31",45fAcb9b399d894,663,Andres,Nash,Baldwin PLC,Leviborough,Norway,1787227957,0920114892,jon73@glenn.info,2020-08-25,http://www.morrow.info/
19-Apr-2021,Miscellaneous,"1,339.80",00.00,"258,753.11",2aaeCCc007f43c5,5715,Albert,Bean,"Pennington, Kirk and Rasmussen",Jonesland,Paraguay,+1-759-876-1302x57722,001-647-109-9023x377,blanchardearl@butler.info,2020-07-17,https://www.rivas.com/
19-Apr-2021,Miscellaneous,"5,098.10",00.00,"263,851.21",F2E6dB05ACb4e51,4080,Robyn,Randall,"Meadows, Kline and Buckley",East Jesse,Argentina,+1-855-938-4225,991-301-1432x66247,maria83@villanueva-cordova.com,2020-06-11,http://sutton.com/
19-Apr-2021,Tax,00.00,"37,693.03","226,158.18",4A48c1A6738E6DC,3589,Joy,Kramer,Knox-Oliver,East Kurt,Singapore,(940)517-2899,(514)423-5929,ponceallison@wang.net,2020-06-20,https://lam-garner.com/
19-Apr-2021,Tax,00.00,"75,386.06","150,772.12",a5b4D563dcddAEa,6430,Isabel,Sheppard,"Walton, Frost and Hunter",Johnathanchester,Burkina Faso,927.933.9786,+1-045-632-6607x733,rickholt@pena.com,2020-08-19,https://www.carlson-moreno.biz/
20-Apr-2021,Transfer,187.10,00.00,"150,959.22",980196D28cE27Ab,5651,Lorraine,Cochran,Wiggins-Shah,Alberttown,Thailand,+1-663-917-9102,5567946904,hector38@frey.org,2021-10-12,http://gay-weber.org/
20-Apr-2021,Debit Card,00.00,"18,869.90","132,089.32",b8bf7E6c86AE1cb,2443,Ricky,Daniels,"Burke, Cantu and Navarro",Hayleytown,Saint Helena,074-247-9621x87465,(412)754-9977x816,jonathon83@fitzpatrick.info,2022-04-08,http://reilly-pennington.com/
20-Apr-2021,Purchase,00.00,"33,022.33","99,066.99",7E28aDB65b9D6Db,331,Anthony,Clarke,Bonilla Group,Reeseshire,Martinique,+1-043-839-9795x17910,390-366-6570x169,warelydia@coleman-morrow.com,2020-08-04,https://www.underwood.com/
20-Apr-2021,Debit Card,00.00,"49,533.50","49,533.50",b95f5fFaba722AC,4980,Casey,Schmidt,Marks-Manning,West Candacebury,Cook Islands,+1-485-518-1094x63757,262.397.8388,nashross@hebert.com,2021-07-14,http://gibbs.com/
20-Apr-2021,Reversal,201.03,00.00,"49,734.53",D0a8C3b58239C71,1486,Kirsten,Williamson,"Huffman, Hubbard and Walters",West Cassandra,Iran,+1-730-799-8199x38349,+1-120-168-9813x3223,ruth94@ashley.com,2020-09-12,http://www.shepherd-parks.com/
20-Apr-2021,RTGS,"9,353.75",00.00,"59,088.28",bdF86AA3F22bD7a,2799,Jon,Stevenson,"Joseph, Bullock and Turner",Reedberg,Antigua and Barbuda,+1-114-352-4670,(190)828-9524,reynoldsjeffery@branch.info,2022-04-26,https://jensen-morrison.org/
20-Apr-2021,Reversal,00.00,"11,817.66","47,270.62",a8232f3045ee0ae,1066,Martin,Lynn,"Gutierrez, Farley and Holden",Jensenport,Kyrgyz Republic,828.376.7898x331,501-267-0315x4710,imccullough@west.info,2020-01-13,https://escobar.net/
20-Apr-2021,NEFT,00.00,"47,270.62",00.00,b9c7C4ab1c1E053,4264,Hailey,Frost,Daniels-Combs,Dicksonland,Gabon,001-016-296-5366,001-199-930-4021,arichard@espinoza-spears.com,2020-08-13,http://daniels-costa.org/
20-Apr-2021,IMPS,"20,494.90",00.00,"20,494.90",7b51eFDe2CCfdfD,9884,Travis,Calhoun,Wilcox Group,Wilkinsonchester,Italy,+1-839-171-1980,463-805-5627,shirley87@medina.biz,2020-10-04,http://bartlett.info/
20-Apr-2021,Cheque,"15,090.00",00.00,"35,584.90",7056b2906ec1Ba2,5864,Shannon,Gallagher,Price LLC,Dixonfurt,Cuba,972.928.9243x9802,752.205.4678x367,logancollier@sellers.com,2020-03-29,http://www.brown.com/
20-Apr-2021,Commission,00.00,"3,953.88","31,631.02",0ab648cc75eE10b,4072,Reginald,Guerra,"Briggs, Fuller and Zhang",Wrightfort,Heard Island and McDonald Islands,+1-908-298-7378,173-380-6717x1865,mackenzievalentine@hamilton-colon.biz,2021-05-08,http://www.hood.com/
20-Apr-2021,ATM,"2,358.70",00.00,"33,989.72",C94bE3EfEB2dD81,1535,Alice,Maldonado,"Francis, Alvarado and Montgomery",Prestonton,Netherlands,(414)909-5454,316.446.1681,harrisonguy@townsend-underwood.com,2021-11-22,http://david.com/
20-Apr-2021,RTGS,00.00,"4,248.72","29,741.00",acEC05AD6670da2,684,Jared,Gibbs,Whitaker PLC,Roblesland,Zambia,001-643-754-2204,928.714.6151x0939,benderangie@cooley.net,2021-11-24,http://www.harvey.com/
20-Apr-2021,NEFT,00.00,"3,304.56","26,436.44",54cbCa32b5EEe72,3293,Alec,Huffman,Valdez LLC,Wangbury,Vietnam,(290)169-8379x01911,168-309-9472,tmckenzie@garrison.net,2020-08-28,https://www.mooney.net/
20-Apr-2021,Purchase,"1,673.00",00.00,"28,109.44",de0650eEF2FcBb2,8711,Bonnie,French,Cross-Hall,North Patrick,Iran,001-344-605-5557x23199,195.435.6131x40695,arielbrowning@gutierrez-mccoy.com,2020-11-30,http://ellison.org/
20-Apr-2021,Tax,750.00,00.00,"28,859.44",Ad94D89c739CF3A,485,Krystal,James,Novak Group,Kristiborough,Serbia,010-055-4525x3849,(125)508-4414x54979,daryl93@pruitt-bass.com,2020-04-03,https://singh.info/
20-Apr-2021,Miscellaneous,109.00,00.00,"28,968.44",E9fD3f3b84EAD56,8895,Valerie,Duke,"Simpson, Bean and Hart",Marioberg,French Southern Territories,211.021.1981x32853,007.715.0372x78316,christine54@higgins.info,2022-01-17,http://day.net/
20-Apr-2021,Transfer,00.00,"2,896.84","26,071.60",BFeb7E4CD56e21F,950,Johnny,Chapman,Rivas Inc,East Jaredland,Jamaica,496-712-6734,752.927.2754,shelly22@holland-doyle.net,2020-02-22,http://www.dennis.info/
20-Apr-2021,Commission,00.00,"2,896.84","23,174.76",DE18C7FBFBAB6eC,8688,Benjamin,Simpson,Thompson-Long,South Ashleehaven,Northern Mariana Islands,001-850-122-1419,400-862-0066x4705,bergkyle@calderon-bean.com,2020-07-11,http://mcdaniel-howell.com/
20-Apr-2021,Debit Card,08.00,00.00,"23,182.76",AC8c81220eCdE45,7392,Meghan,Spence,"Mcbride, Barnes and Horton",Derrickside,Chile,(003)857-6952,068.655.2359x8834,ronaldacosta@lewis.com,2021-02-07,https://www.oneal.biz/
20-Apr-2021,Tax,62.96,00.00,"23,245.72",Ce126FdefebEdA6,8154,Kerry,Archer,Case and Sons,New Ericaberg,Greece,(170)852-5993x163,+1-626-628-1591,raymonddunlap@murray.net,2021-06-24,https://www.dodson.com/
20-Apr-2021,ATM,00.00,"3,874.29","19,371.43",3F9241ebD6bA4af,9429,Tammy,Ayers,Dillon-Wilcox,Mollyland,Iceland,001-793-724-1718,854.490.6605x8736,glassdana@bernard-barker.com,2021-11-01,http://www.house.com/
20-Apr-2021,Transfer,"34,131.44",00.00,"53,502.87",42eAF89915dD6C9,6004,Devin,Reynolds,Austin-Wilkins,Stoutmouth,Namibia,009.876.8912x29513,921-793-7636x0041,hooverdebbie@hess.com,2020-09-06,http://www.rogers.com/
20-Apr-2021,RTGS,00.00,"26,751.44","26,751.44",523Ff019C643aBf,7876,Kristina,Walsh,Doyle Group,Jadestad,Samoa,781-727-6092x78851,001-086-368-8257x12744,adrianlyons@lowe-greene.com,2021-07-31,https://woodard.com/
20-Apr-2021,Cash,00.00,"13,375.72","13,375.72",7FF0894e98eA30B,8228,Bridget,Carney,Nixon-Good,South Kristie,Samoa,001-794-735-3705x4205,(604)448-6251x6045,longdiane@steele.com,2021-05-14,https://www.solis-myers.info/
20-Apr-2021,RTGS,04.00,00.00,"13,379.72",1a5052EaEA363D8,2559,Brandi,Medina,"Vasquez, Glover and Buchanan",North Caitlinport,Honduras,(321)683-9665x0938,(131)422-0523,rsantana@baxter.com,2020-07-15,http://daugherty.info/
21-Apr-2021,Cash,00.00,"1,672.47","11,707.26",5A96D3EB2E947BF,881,Hailey,Spears,Wiggins-Farrell,North Marissa,Sao Tome and Principe,557-820-3498x34281,4829202579,tristan68@bates-norris.biz,2020-01-17,https://www.wells.com/
22-Apr-2021,ATM,"125,527.80",00.00,"137,235.06",e090f2CAF78D1fa,2497,Erica,Sloan,Rowland LLC,West Noahview,Botswana,+1-092-286-3619x944,001-666-132-2734x6100,hendrixshelby@gallagher-villanueva.com,2021-12-15,http://vargas.com/
22-Apr-2021,Commission,00.00,"45,745.02","91,490.04",add8585D174a0cB,1895,Joy,Crosby,Trevino-Mathews,South Charlestown,Isle of Man,564.723.7447,001-739-111-0380x9519,priscilla20@david.com,2020-12-07,https://www.cunningham-sanders.info/
22-Apr-2021,NEFT,"3,417.00",00.00,"94,907.04",E53eB2fcFdABc2d,5312,Mason,Simpson,Larsen-Mays,Port Nicholasshire,Albania,+1-988-016-7404x553,4412048270,bernardlynn@manning-perez.net,2021-03-11,http://www.ho-shepherd.info/
22-Apr-2021,Commission,00.00,"13,558.15","81,348.89",eDACCb9ecaA5E73,3383,Stefanie,Castillo,Owens Group,Hardingfort,Norway,232.529.8173,949.536.7015,eyork@velez-valentine.info,2020-11-05,http://shannon-summers.com/
22-Apr-2021,RTGS,392.00,00.00,"81,740.89",4DaAFFadFeEe2cd,829,Jacqueline,Beltran,Morales-Kidd,Port Anneborough,Burundi,825.269.7428x56605,+1-828-852-6150x451,ustafford@rush-barr.com,2020-11-23,http://www.page.com/
22-Apr-2021,Purchase,50.50,00.00,"81,791.39",34fbA4af1E690ef,4427,Maria,Riddle,"Rush, Sparks and Kennedy",Darrylbury,Maldives,194.943.5497,001-364-178-5014x9878,clarencerandolph@nunez.com,2020-05-24,http://hoover.org/
22-Apr-2021,Miscellaneous,00.00,"11,684.48","70,106.91",D25ADa97044DCCF,4620,Alan,Mcbride,Collier-Ewing,Theresaville,Cocos (Keeling) Islands,053-180-1561x7255,2079714005,kristopherleon@schneider.com,2021-11-29,http://www.compton.com/
22-Apr-2021,Commission,"50,365.60",00.00,"120,472.51",2360d3b5761E243,4340,Jamie,Mathis,Evans Group,Mosleybury,Norway,121.980.8697,(995)980-2503x48136,juanroy@leblanc-zhang.biz,2021-03-19,http://owens.com/
22-Apr-2021,Commission,00.00,"24,094.50","96,378.01",e6bFE30AEf105Ab,2587,Destiny,Krueger,Chan-Zimmerman,West Damonburgh,Japan,282-953-7933,188.273.3282x877,mlevine@harper.com,2020-02-04,http://www.campbell.com/
23-Apr-2021,NEFT,"2,494.00",00.00,"98,872.01",045CB24f1E7b657,9745,Dale,Hall,"Mccann, Leach and Winters",Port Bernardchester,Costa Rica,149-807-1413,180.696.2605,maysshari@murray.biz,2021-11-20,https://www.bailey-matthews.com/
23-Apr-2021,Interest,00.00,"98,872.01",00.00,BEDcbBf220Ecc7c,1830,Mason,Collier,Booker-Norton,East Leonardbury,Costa Rica,751-596-9083x204,001-005-006-0782x813,lovejade@maxwell-vargas.com,2020-01-22,https://mills-bryant.com/
23-Apr-2021,Interest,651.00,00.00,651.00,0AdA23e478AfDcd,9681,Colleen,Hurst,Meadows-Vang,Maddoxmouth,Gambia,001-079-510-0280x8988,(663)976-6268,serranoterri@lawson.info,2021-09-20,http://www.benjamin.com/
23-Apr-2021,Tax,00.00,00.00,651.00,395bC0f068bcbE3,8690,Helen,Foster,Williamson PLC,North Zoetown,Cayman Islands,1549836779,001-574-814-8059x644,tracy70@dalton.info,2021-05-30,https://www.mayer-rollins.net/
23-Apr-2021,RTGS,"2,517.78",00.00,"3,168.78",e9654eCb1eACe2D,4054,Sue,Saunders,Daniel-Schneider,Heidifort,Holy See (Vatican City State),001-538-022-7121x7957,(401)104-8736,qbray@nguyen-cervantes.com,2020-05-04,https://www.barrera.com/
23-Apr-2021,RTGS,00.00,"1,056.26","2,112.52",ED78De47E0Bd354,6302,Howard,Rangel,Snyder-Horn,Bowershaven,Gambia,827-538-5264x51861,768-050-5004,neilduffy@oliver.com,2021-04-19,https://fernandez.org/
23-Apr-2021,Cash,"3,887.00",00.00,"5,999.52",3a499E9cA2dA1CC,254,Isaiah,Howe,Cannon Inc,Weissshire,Brunei Darussalam,676.018.6293x4000,+1-368-694-6735x490,rachael63@cooley.com,2022-02-27,https://www.roberts.com/
24-Apr-2021,Interest,262.13,00.00,"6,261.65",5fcb4b2EAb8A38c,7874,Zoe,Cochran,Harrington Ltd,New Alexisburgh,Tuvalu,308.604.9871,669.993.2856x91657,leonardcalhoun@edwards.biz,2022-02-19,http://velasquez.com/
24-Apr-2021,Commission,67.50,00.00,"6,329.15",6FaeA4CAA0DaCcd,7538,Lydia,Burns,Callahan-Oliver,Lake Albert,Iraq,+1-645-938-0078,001-658-523-5740x81834,grahamstefanie@blevins.com,2020-07-25,http://www.graham-roth.com/
24-Apr-2021,Cheque,00.00,"1,054.86","5,274.29",fEC7be95D19Dff1,6116,Anthony,Rosario,"Casey, Chen and Cohen",Sanfordbury,Kuwait,+1-880-918-2856,970.717.1234,conniewu@erickson.org,2021-11-25,http://www.frost.biz/
24-Apr-2021,Interest,00.00,"2,637.15","2,637.14",9f898F07BC6E3F7,2721,Theresa,Garcia,"Rush, Kirby and Grimes",Wangbury,Kyrgyz Republic,(443)043-3295,442.274.6846x52589,xwang@mullins.com,2021-12-18,http://crosby.org/
24-Apr-2021,RTGS,00.00,"1,318.57","1,318.57",EFde36ceaEDAB6C,7163,Karen,Valentine,"Garza, Hines and Bright",Courtneyfort,Ireland,001-482-073-1230x67155,269-636-7578,farleygabrielle@bauer.com,2022-03-26,http://www.terry-dixon.info/
24-Apr-2021,Bill,28.00,00.00,"1,346.57",F1ccdb20b0b09cB,8280,Kaitlyn,Gould,Peck Group,Christineville,Palau,984.721.6157x4115,861.522.9000,hunter76@leon.com,2020-05-26,https://rodriguez-pham.com/
24-Apr-2021,Cheque,00.00,336.64,"1,009.93",572b3fD672ffAb5,8033,Ruben,Campbell,"Parsons, Howard and Hamilton",North Kristinabury,Comoros,+1-269-216-5764x5145,356.488.4590x9104,sbradford@burke-velez.net,2021-12-07,https://www.shelton.org/
24-Apr-2021,Miscellaneous,00.00,504.97,504.96,a5D5C99e386F35A,5543,Jeremiah,Castaneda,Roth Inc,North Katrina,Saudi Arabia,001-574-492-6274x26376,814.675.7519,miranda52@goodwin.net,2020-11-23,http://www.herrera.org/
24-Apr-2021,Commission,00.00,84.16,420.80,cF63cdB95700EC6,5660,Sue,Cabrera,"Contreras, Sanders and Wood",Fletcherside,Vietnam,382.627.3736x21873,(020)759-1358x19875,levimorton@kirby.com,2021-04-30,http://blake-hart.com/
24-Apr-2021,Cash,00.00,140.27,280.53,36e3BD707F9BD01,5982,Brett,Stout,Key Ltd,East Sylviamouth,Turks and Caicos Islands,726.688.6973x2863,001-335-196-4822x50535,daniel23@middleton.info,2022-01-19,https://www.ford-finley.com/
24-Apr-2021,Cheque,"4,820.71",00.00,"5,101.24",A3da9023cAFfF41,5187,Elizabeth,Schmitt,Romero-Walsh,West Judith,Mali,053-698-9506,(497)556-9032,jermaineleach@hester.info,2021-11-08,https://blake.com/
24-Apr-2021,ATM,00.00,"1,020.25","4,080.99",F8bBcdFa6A410bD,7964,Chelsea,Hurley,"Singleton, Willis and Livingston",East Tristanland,Thailand,663-760-0818x8067,+1-894-767-1928x86672,caroline92@morrison-duke.com,2022-02-18,http://osborn.com/
24-Apr-2021,RTGS,42.31,00.00,"4,123.30",eD5fa9E034B8a83,8910,Rose,Kaufman,Conley-Crawford,Barrychester,Mexico,001-956-518-9012,+1-589-534-1195x260,khughes@camacho-ross.com,2020-11-24,http://diaz-weaver.info/
24-Apr-2021,Purchase,00.00,"1,030.83","3,092.48",75e778b4fe40C0e,1873,Ellen,Jarvis,"Dillon, Taylor and Compton",North Elizabethstad,Paraguay,059-763-9074x2112,197.444.3482,vegajohnathan@hardin.com,2022-01-31,http://harvey.com/
24-Apr-2021,Debit Card,"11,507.00",00.00,"14,599.48",9EaA8Bc67cfeDA2,6872,Francis,Cain,Owen PLC,Savageside,Macao,257-046-7681,001-222-135-7105x895,maddenlatoya@dyer-krueger.com,2020-09-01,http://www.sherman-curry.com/
24-Apr-2021,NEFT,00.00,"7,299.74","7,299.74",FD6a3C5052c10D7,7086,Denise,Ramsey,Baker-Young,Nataliechester,French Guiana,+1-078-262-9641,201-434-8511x58626,marcturner@harper-sampson.com,2022-05-02,http://paul.com/
24-Apr-2021,Cash,00.00,912.47,"6,387.27",b63Ef87D0E2A8DC,8614,Ariana,Shah,"Morse, Alexander and Carroll",Phamstad,Poland,(205)697-7037,001-208-628-8461x173,lindsey36@reilly.com,2020-07-15,https://www.riley-salas.com/
24-Apr-2021,IMPS,"2,817.00",00.00,"9,204.27",eDcDfF5e8Cf8d3D,7415,Sharon,Snow,Parker-Bonilla,Carneyshire,Kazakhstan,(634)638-2635,607-841-0573x30737,wilkinsontasha@schneider-thomas.com,2021-03-24,https://meza.com/
24-Apr-2021,Tax,00.00,"1,150.53","8,053.74",14FdbB2f76B1bFb,5533,Jocelyn,Mcguire,Reid-Gomez,South Jeremy,Brazil,(272)329-9482x2911,727.864.5945,dhayden@ortiz.com,2020-05-14,http://good.info/
24-Apr-2021,Interest,"228,753.19",00.00,"236,806.93",ea5FEBad94BDF31,6586,Drew,Bonilla,Owens PLC,Graceview,Lebanon,(840)775-9739x4361,758-461-5228x23538,duffymiguel@blanchard-hebert.net,2021-01-06,http://howard.com/
24-Apr-2021,Cash,"1,481.11",00.00,"238,288.04",B954CfaA1C41133,3213,Kristine,Zavala,Lucero LLC,Jakechester,Saint Lucia,+1-298-543-1899,(156)363-4700x59566,ltanner@mcdowell.com,2020-04-14,https://www.richards.info/
24-Apr-2021,Cheque,"2,075.00",00.00,"240,363.04",dE1Be6D9c110A1B,9084,Phyllis,Olsen,Stewart LLC,South Andrea,Thailand,+1-461-084-6696,(116)473-2469,sandynorris@juarez-blevins.com,2021-12-21,https://kane.com/
24-Apr-2021,Cash,00.00,"30,045.38","210,317.66",b9f56Efa955e49E,4903,Christopher,Foley,Herring-Copeland,East Alisonland,Czech Republic,182.454.8285,(264)912-5955x6203,bettywilcox@kramer.org,2021-01-27,http://curtis.net/
24-Apr-2021,Bill,00.00,"30,045.38","180,272.28",be4f53D0ed6aa57,2301,Cameron,Le,Collins-Obrien,Lake Sherritown,San Marino,(667)691-9385,780.923.4808x0592,herbertphelps@reid.com,2020-11-16,https://lester.com/
24-Apr-2021,Commission,"125,687.50",00.00,"305,959.78",BE07beFa2Beb91a,6341,Bruce,Zimmerman,Mcintyre PLC,East Peggy,Ukraine,+1-469-371-3427x7610,888.173.4359,matthewbuckley@briggs.biz,2021-08-11,http://www.vincent.com/
24-Apr-2021,Transfer,157.00,00.00,"306,116.78",d5D381A204e861e,9336,Clinton,Mccarthy,"Mcconnell, Pugh and Powell",West Ruben,Macao,(491)608-1759,(545)110-8682x7165,michealcooper@mendoza-conley.com,2022-01-08,http://www.potter.com/
24-Apr-2021,NEFT,"14,650.90",00.00,"320,767.68",Bc7b6f45aAEA6af,537,Caitlin,Bartlett,Patterson-Woodward,Solomonside,Samoa,697.869.8903,001-738-677-6694,ahodge@madden.info,2020-12-25,https://jackson-english.com/
24-Apr-2021,Miscellaneous,00.00,"40,095.96","280,671.72",Ad3475Ab9D57a21,9580,Blake,Cuevas,Tran-Ross,North Gabrielamouth,Northern Mariana Islands,997-016-2288x8233,500-431-2197x56505,beverlyhull@sims.info,2020-03-10,http://bradshaw.com/
24-Apr-2021,RTGS,00.00,"93,557.24","187,114.48",26b77e7CBf59856,5006,Connie,Porter,Benjamin-Galloway,Curtisfurt,Barbados,499.382.3292x88532,(449)116-4209,yolandapaul@durham.com,2020-03-21,http://www.combs.org/
24-Apr-2021,IMPS,00.00,"31,185.75","155,928.73",9fb821FAC0BC4a9,2628,Paige,James,Norton Inc,North Victor,Angola,139-540-9443,559-588-4466x91092,summer43@ball.com,2022-05-05,http://mccann.com/
24-Apr-2021,Tax,00.00,"31,185.75","124,742.98",6D3F6307C003B26,9934,Cheyenne,Rangel,Kennedy-Craig,Zoeburgh,Bermuda,781.048.9530,(584)884-6361x163,reesejeff@murillo.com,2020-07-30,https://www.huber-lowe.com/
24-Apr-2021,NEFT,"86,547.30",00.00,"211,290.28",d5879ba7DfE7cE2,4365,Anne,Quinn,"Silva, Watts and Pitts",West Lynn,Finland,001-701-644-2601x20012,799.253.9286x2490,orichardson@mayer.biz,2021-12-15,http://barnes-hendricks.com/
24-Apr-2021,Interest,"1,407.32",00.00,"212,697.60",f18bab4Fc7D0C1E,9103,Connor,Reilly,Franco LLC,Ellisonchester,Puerto Rico,472.884.3868x0922,(626)436-9075x4483,banksclayton@tran.com,2021-01-15,http://ramirez.org/
24-Apr-2021,ATM,00.00,"70,899.20","141,798.40",f0b0e0bD51d9fBF,694,Mikayla,Meyers,"Dodson, Stark and Kemp",Claireborough,Mexico,+1-254-998-7082x70063,4548877696,contrerasalice@higgins.biz,2020-02-06,https://www.atkins-pearson.com/
24-Apr-2021,NEFT,"1,724,223.80",00.00,"1,866,022.20",cDC00ef95bDbB1D,8205,Cassandra,Donaldson,"Mcgee, Hood and Barker",Chenchester,Bangladesh,+1-184-974-6353x07004,+1-664-269-9329x64680,georgefitzgerald@orr.net,2021-02-04,http://castaneda.net/
24-Apr-2021,Transfer,00.00,"311,003.70","1,555,018.50",2f4976cc8F8Cf7D,35,Shawn,Cruz,Daniel and Sons,Cardenasport,Svalbard & Jan Mayen Islands,309-608-9907,(615)894-4814x344,nlane@kane-pennington.com,2022-05-03,https://www.tran.net/
24-Apr-2021,Reversal,00.00,"259,169.75","1,295,848.75",43598E87ECeC4de,3577,Hailey,Green,"Ray, Eaton and Ponce",West Joshua,Western Sahara,(157)961-0439,001-686-068-9940x836,kimlang@meyers-vincent.biz,2020-06-23,https://cowan.biz/
24-Apr-2021,Tax,21.40,00.00,"1,295,870.15",7EF2D48BB07438C,5658,Benjamin,Cortez,"Yu, Hodges and Vaughn",North Victor,Antarctica (the territory South of 60 deg S),232.585.0830x497,+1-290-297-6278x6425,shaun72@daniel-bowman.com,2020-02-11,https://keith.com/
24-Apr-2021,Debit Card,"1,835.22",00.00,"1,297,705.37",026bDfe4Ccae53E,2665,Billy,Oconnor,"Kelly, Weaver and Jensen",Josephside,Heard Island and McDonald Islands,(967)356-8037x685,186-503-9016x920,vmoreno@mahoney.com,2020-12-04,https://clark-oneal.com/
24-Apr-2021,Cheque,"1,705.00",00.00,"1,299,410.37",4e672dC1b89757F,2995,Darius,Khan,Baxter-Patterson,North Jennyburgh,Monaco,(184)895-3535x492,001-494-887-2358,dyermegan@liu.org,2020-09-26,https://ellison-colon.biz/
24-Apr-2021,NEFT,"65,025.00",00.00,"1,364,435.37",fA2Ac4C6a1e9cEd,9529,Terri,Knapp,Peterson-Hoffman,Pattonmouth,San Marino,(000)575-1644,001-919-710-8180,bradymora@esparza-gill.net,2020-01-02,http://www.pena.info/
24-Apr-2021,Miscellaneous,272.08,00.00,"1,364,707.45",7A1e14FeD822df4,7372,Cathy,Mckee,Bryan LLC,New Anita,Lebanon,838.329.9665x637,+1-392-448-7867x93569,ogould@brown.com,2020-06-04,http://www.keller.com/
25-Apr-2021,RTGS,271.14,00.00,"1,364,978.59",3cBafb5f05ff27A,3515,April,Everett,"Estes, Odom and Sellers",Lake Claytonshire,Italy,001-108-085-2305,001-729-816-4001x683,marvindelacruz@preston-rocha.com,2021-12-15,http://www.elliott.info/
25-Apr-2021,ATM,00.00,"1,364,978.59",00.00,87317F5Aa68EE3d,4136,Jacqueline,Peters,"Jensen, Walker and Mcguire",Woodstown,Hungary,231-048-8784x47938,+1-112-243-6589x702,larsonbilly@vang.info,2022-01-03,http://humphrey.net/
25-Apr-2021,ATM,"3,417.00",00.00,"3,417.00",C0bB49b13054Cc9,5652,Fernando,Fitzpatrick,Zimmerman Inc,Beanburgh,Qatar,3952038506,001-162-189-1956x90984,margaretblake@shepard.net,2022-05-28,http://hampton.com/
25-Apr-2021,Interest,00.00,427.13,"2,989.88",b0DfF8eAADaA2Be,7251,Ann,Mcclure,"Whitehead, Duke and Graham",Lyonsland,Estonia,198-730-3631,001-398-311-4514,jaclynsnow@olsen.biz,2022-03-21,http://clay.com/
25-Apr-2021,Cheque,00.00,"2,989.88",00.00,B57341aCDf23155,459,Ellen,Mayo,Cross-Hendricks,Dariusborough,Sweden,(266)427-2657x375,3245655755,michaelclinton@gross.com,2021-11-13,https://tate.com/
25-Apr-2021,Commission,"61,464.81",00.00,"61,464.81",bC2bD22Bc0A41A9,4226,Tony,Bates,"Burgess, Dunlap and Browning",North Shane,Tajikistan,656-126-7518x99527,627-840-3651x83939,jamesyvette@raymond.org,2021-10-15,http://www.rangel-charles.net/
25-Apr-2021,RTGS,00.00,"15,366.20","46,098.61",30B69Cc6Ac1af3f,4964,Nicole,Luna,"Daugherty, Morris and Hamilton",Livingstonland,Chad,9284645368,001-466-528-1699x590,macdonaldjustin@bird.com,2020-08-25,http://randolph.com/
25-Apr-2021,IMPS,00.00,"15,366.20","30,732.41",A38f5b4c6E7e358,108,Rachael,Forbes,Lester Group,South Richardbury,Macedonia,(824)584-3607x21067,557-679-6530,veronicablankenship@pace.com,2020-03-02,http://osborne.com/
25-Apr-2021,Reversal,"16,991.18",00.00,"47,723.59",dbE33A72dd94FC4,6201,Sara,Peters,Petty LLC,Rangelhaven,Saint Lucia,634.417.5688x4983,584-123-1121,troywall@bonilla.com,2020-08-12,http://www.hess.com/
25-Apr-2021,Cheque,00.00,"23,861.80","23,861.80",151c881FAd91AB2,8679,Alexander,Beltran,"Vang, Skinner and Fletcher",Lake Reginald,Slovakia (Slovak Republic),5378749671,(772)403-5979x823,marcuscrane@holmes-valencia.com,2020-01-15,https://schmidt-perkins.com/
25-Apr-2021,Cash,00.00,"2,651.31","21,210.49",908aCB2ACee5B20,2989,Tammie,Bowers,"Melton, Petty and Archer",North Mackenzietown,Martinique,423-743-0682x9685,(385)963-4728x4571,wyatt84@dougherty-hays.info,2021-07-21,http://www.hendricks-martin.com/
25-Apr-2021,Cash,"8,782.20",00.00,"29,992.69",2FbF0B8b0DACC6E,1965,Maxwell,Bass,Powers Ltd,New Anntown,Bahrain,990.436.5915,661.796.2851x82808,melissatownsend@calhoun-prince.biz,2021-06-17,https://www.morris-hartman.info/
25-Apr-2021,NEFT,00.00,"2,999.27","26,993.42",Fd4Df2BBDD6c0Ac,6598,Kristine,Hughes,Montgomery-Kirk,South Erica,New Caledonia,(468)209-9454x9145,(544)968-1588,juarezkirsten@morrison.com,2020-07-20,https://mahoney.com/
25-Apr-2021,Interest,"818,844.00",00.00,"845,837.42",a92c4aAF687AAb4,5832,Bernard,Frederick,Collins-Olson,Jeffreymouth,Iran,(229)535-9121x2245,900-080-6672,jensenalec@mcdaniel.com,2021-05-11,https://jensen-peterson.com/
26-Apr-2021,Commission,"3,993.00",00.00,"849,830.42",AeF4fdf6fF512af,3082,Ralph,Tran,Lynn Inc,Chaneyville,Ireland,869-596-9829,+1-038-545-0127x72054,mcintyrecaitlyn@russell.com,2020-10-08,http://www.yu.com/
26-Apr-2021,Miscellaneous,07.14,00.00,"849,837.56",A634Af2aBBD3dE4,3433,Calvin,Murphy,Cardenas and Sons,Timothyborough,Latvia,(292)171-3250,(146)921-2142x885,elijah44@lambert.com,2021-11-16,http://www.holloway.info/
26-Apr-2021,Interest,00.00,"84,983.76","764,853.80",5e2FC08bDF0aB5d,4771,Carly,Burns,"Melendez, Rodgers and Petty",Daltonland,Italy,167.830.2362x669,001-554-167-1434,helen45@sims-ewing.com,2020-01-13,https://vincent.com/
26-Apr-2021,Cash,03.00,00.00,"764,856.80",73544cfD85a37a8,3042,Amber,Lowe,Knox Inc,South Alejandra,Australia,258-580-2604,(646)485-0171,kpotts@guerrero.com,2021-05-13,https://gamble.com/
26-Apr-2021,Cash,"17,502.00",00.00,"782,358.80",c76Ee68BAC6eA3E,6647,Tara,Trujillo,Medina and Sons,Port Destiny,Mauritania,129.571.7116,632-750-1918x20812,bethanymarquez@vega.com,2021-01-11,http://vazquez.com/
26-Apr-2021,Tax,00.00,"260,786.27","521,572.53",aBbddcDd5B1e57E,1267,Mia,Shah,"Ochoa, Beard and Guerrero",North Warrenport,Madagascar,967-579-4549x1491,001-300-617-7306x56607,efrey@campbell-ritter.org,2021-03-24,http://www.harper.biz/
26-Apr-2021,RTGS,"29,531.10",00.00,"551,103.63",8b4bdbEe01deA5C,158,Veronica,Golden,"Wright, Contreras and Wagner",North Theresastad,Falkland Islands (Malvinas),(367)700-9543x932,+1-422-724-7575x684,gacosta@stephenson-tyler.biz,2020-03-31,http://www.best.com/
27-Apr-2021,ATM,00.00,"68,887.95","482,215.68",fb6F888A84f87b0,6717,Lee,Burch,"Cortez, Martin and Christensen",New Spencer,Jamaica,170.328.3670,1156698760,jarvisalvin@bean-garcia.com,2020-02-20,https://www.atkinson.org/
27-Apr-2021,Cheque,"1,721,146.00",00.00,"2,203,361.68",AcCbFad777D0711,8770,Nichole,Parrish,Patton PLC,Jeromehaven,Saint Barthelemy,8674945527,303.202.5737x55242,gabriellamcmahon@levy-fernandez.net,2022-03-18,http://www.pitts-sampson.org/
27-Apr-2021,RTGS,00.00,"2,203,361.68",00.00,0Baaeef2A4bAFCc,2064,Christine,Reynolds,Murphy-Hebert,Arellanoburgh,Lao People's Democratic Republic,(579)233-4974x66128,874-948-6778x56390,simonbradley@hodges.com,2020-11-07,http://www.morrison.info/
27-Apr-2021,Bill,198.65,00.00,198.65,C39aAd76abA1059,5846,Whitney,Griffin,Larsen-Lin,North Wyattstad,Zimbabwe,3333956926,298-610-2753x70511,bailey04@pennington.biz,2021-12-19,https://downs-delacruz.com/
27-Apr-2021,ATM,03.00,00.00,201.65,7284dE094D9E0AB,7480,Katherine,Gutierrez,Wallace LLC,Merrittfurt,Anguilla,001-637-206-1290x94155,132.822.1409,theresadominguez@travis-rich.biz,2021-11-09,https://www.mosley.net/
27-Apr-2021,Bill,00.00,67.22,134.43,DFEeE37Cebae15B,5278,Sylvia,Mcmillan,Duran LLC,Branchbury,Hungary,001-681-982-1756,666.364.4189,stewarteugene@gentry-horne.com,2020-05-20,https://www.quinn-frost.com/
27-Apr-2021,Miscellaneous,00.00,19.20,115.23,6B93cdFe9aFAD42,5199,Jay,Mack,Bauer and Sons,North Catherine,Western Sahara,385.425.1951,024-637-7610x784,petersshari@peterson-stout.info,2022-05-08,http://phillips-frye.com/
27-Apr-2021,Miscellaneous,00.00,11.52,103.71,0Feb0fef25bAEe1,1466,Dave,Medina,Palmer-Vincent,Hannahland,Timor-Leste,(394)981-2686,(553)689-3266x8728,jhorn@quinn-sosa.biz,2021-02-22,https://www.conrad.biz/
27-Apr-2021,Reversal,"812,488.50",00.00,"812,592.21",Ee2c1D4eE3bA381,7665,Carmen,Mullins,"Moreno, Valencia and Ellis",Hughesport,Austria,001-053-714-6157,879-397-1976x38047,autumn02@gillespie.net,2020-09-24,https://mcintyre.info/
27-Apr-2021,Debit Card,00.00,"101,574.03","711,018.18",FD89FDe55A82eaB,891,Cassidy,Gibson,Pearson-Watkins,Rileystad,Ethiopia,648.930.7549,608-784-6194,lawrence67@french.com,2021-06-03,http://thompson.biz/
27-Apr-2021,Reversal,01.00,00.00,"711,019.18",D7fCB4AeCb40E54,1325,Rickey,Downs,Snyder PLC,East Judy,Singapore,+1-762-161-9193x264,+1-574-184-3311x73975,cristian03@vasquez.com,2022-05-09,https://schroeder-bray.biz/
27-Apr-2021,NEFT,00.00,"142,203.84","568,815.34",EfCc34C16E7DBEB,9440,Kurt,Acosta,"Osborn, Crane and Riley",North Dean,Micronesia,941-656-7452x9187,012-330-1018,masonlogan@holmes.com,2020-12-03,http://callahan.info/
27-Apr-2021,Commission,"2,795.30",00.00,"571,610.64",bcCfbcB4d7E6e6c,5429,Bonnie,Arias,Brandt-Floyd,Bergerfurt,Iraq,(419)557-9424x1562,3159354157,bradymassey@edwards.org,2020-11-08,http://www.parker.net/
27-Apr-2021,Purchase,00.00,"114,322.13","457,288.51",d5D381A204e861e,9336,Clinton,Mccarthy,"Mcconnell, Pugh and Powell",West Ruben,Macao,(491)608-1759,(545)110-8682x7165,michealcooper@mendoza-conley.com,2022-01-08,http://www.potter.com/
27-Apr-2021,Reversal,00.00,"114,322.13","342,966.38",cbFD3bF79C2eC99,8887,Johnny,Reyes,"Wiley, Richardson and Schultz",Ericton,Romania,001-605-049-6190,+1-204-362-2429,reneemcmahon@gray-anthony.com,2021-01-22,https://hardy.com/
27-Apr-2021,Transfer,"936,145.00",00.00,"1,279,111.38",F231DF54939Fa4C,97,Marvin,Buchanan,Lowe-Mathis,Sheriville,Cuba,058-381-7608,+1-912-237-4307x878,ocole@sanders-lowery.net,2020-04-22,http://www.price.com/
27-Apr-2021,Interest,05.50,00.00,"1,279,116.88",A6DBe3b2c59edcF,6179,Jillian,Owen,"Elliott, Hester and Duran",Donmouth,Equatorial Guinea,715.305.9624x2348,1953439854,snownatalie@spencer.biz,2022-01-18,https://www.torres.com/
28-Apr-2021,Debit Card,00.00,"127,911.69","1,151,205.19",0eCE6Bb48eef0fA,5449,Jacob,Chapman,Keith Inc,South Gail,British Indian Ocean Territory (Chagos Archipelago),+1-346-094-5139x23120,001-690-924-3120x012,nicolas50@trevino.org,2021-04-29,https://stout.com/
28-Apr-2021,RTGS,"3,477.00",00.00,"1,154,682.19",4DaAFFadFeEe2cd,829,Jacqueline,Beltran,Morales-Kidd,Port Anneborough,Burundi,825.269.7428x56605,+1-828-852-6150x451,ustafford@rush-barr.com,2020-11-23,http://www.page.com/
28-Apr-2021,Bill,00.00,"1,154,682.19",00.00,Da00c81eFbe77Ed,7525,Kristie,Adkins,"Fuentes, Ritter and Salas",Leahchester,Cote d'Ivoire,001-845-179-3700x90030,+1-408-319-1444,howard93@giles-clayton.net,2020-10-10,https://dudley.com/
29-Apr-2021,Tax,"179,001.50",00.00,"179,001.50",23a1CeD8A626af7,1578,Traci,Cooper,Mcneil-Rose,Karinahaven,Norway,587-562-4038,+1-131-774-0910x143,gloverjeffery@hart.com,2020-12-31,http://www.jordan.com/
30-Apr-2021,Cheque,00.00,"19,889.06","159,112.44",Cd59F2dFBAd382f,5402,Latasha,Mason,Lamb PLC,Hornmouth,Korea,946-294-6443x3594,326-479-0224,jeanette88@walters.com,2021-12-22,http://www.poole.com/
30-Apr-2021,ATM,"3,372.69",00.00,"162,485.13",7fAa8D9Ef4765b7,4884,Mikayla,Myers,Prince Inc,Hollandfurt,Canada,757.100.3585x811,5894232573,genefarley@santos.com,2020-07-09,http://www.bonilla.com/
30-Apr-2021,NEFT,"3,950.80",00.00,"166,435.93",e2b607f76FC4bEb,5508,Brittany,Holden,"Haas, Li and Bond",Lake Cassie,Ireland,627-049-2595,659-068-7342,katelynhorne@gross.com,2021-05-25,http://long-hayden.info/
30-Apr-2021,Miscellaneous,00.00,"55,478.64","110,957.29",4C8E6AA7Ced5BAF,38,Vanessa,Hansen,Watkins-Romero,Kerryburgh,Netherlands,+1-134-667-1175x8813,+1-928-497-1358x88633,jasmineaustin@whitehead.info,2020-01-14,https://www.graves.info/
30-Apr-2021,Tax,"1,422,572.25",00.00,"1,533,529.54",0cb0ceC431291Ef,6863,Adam,Rose,Hunt-Acosta,Lake Lydiabury,French Southern Territories,835.884.1985x2582,+1-353-856-7100,kylie90@berger.info,2021-05-20,https://www.velez-nielsen.org/
30-Apr-2021,Tax,00.90,00.00,"1,533,530.44",1Ce2be60037801a,9943,Kenneth,Lewis,"Kirby, Hill and Eaton",Oliviaborough,Philippines,115-344-6682x307,556-988-4476,lmelton@kim-cox.net,2021-01-01,https://skinner.com/
30-Apr-2021,Transfer,"1,676.50",00.00,"1,535,206.94",96fef84eee0E6eB,7969,Jessica,Diaz,Williamson-Woodward,Douglasport,Greenland,520-446-7020x164,715.269.6649x94159,nluna@gilmore.com,2021-12-06,http://hart.com/
30-Apr-2021,Interest,00.00,"191,900.87","1,343,306.07",b2AcD3fF071C6cb,5472,Mercedes,Hammond,Mullen and Sons,Normanborough,Antarctica (the territory South of 60 deg S),001-142-185-2595,(767)898-5137x7028,galvanandrea@hester-rojas.org,2022-03-21,https://pearson.com/
30-Apr-2021,NEFT,05.00,00.00,"1,343,311.07",C94bE3EfEB2dD81,1535,Alice,Maldonado,"Francis, Alvarado and Montgomery",Prestonton,Netherlands,(414)909-5454,316.446.1681,harrisonguy@townsend-underwood.com,2021-11-22,http://david.com/
30-Apr-2021,ATM,00.00,"268,662.21","1,074,648.86",7527E3bA330Bf6B,7078,Gerald,Fleming,"Martinez, Walker and Gould",Newtonport,Tanzania,001-886-190-8548x335,3742051003,meganmacias@doyle.net,2021-11-03,http://www.gill-hancock.com/
30-Apr-2021,Bill,21.00,00.00,"1,074,669.86",bcE70d90B1a37af,6393,Alexa,Bowman,Stephens-Wells,Oliverborough,Mauritania,2252663424,9381382559,waynechoi@morgan-vasquez.org,2021-07-02,http://www.glass.com/
30-Apr-2021,Reversal,"1,944,906.50",00.00,"3,019,576.36",6b77bdcCA49b46A,7710,Jodi,Vega,"Pope, Mccormick and Potts",West Ethan,Singapore,080-665-9736x9961,(658)660-1176,moodybrent@todd-blair.net,2021-11-30,http://kaufman.com/
30-Apr-2021,Cash,00.00,"431,368.05","2,588,208.31",6ba0BC5c67eCDD0,196,Amanda,Harper,"Trevino, Lam and Brewer",Lake Kylie,Chad,331-372-4188,287.106.6090x069,fieldskelly@blackburn.biz,2020-03-22,http://macias-duffy.com/
30-Apr-2021,NEFT,00.00,"2,588,208.31",00.00,6bbd8ebF4A96Ad4,5188,Brett,Bender,Bishop-Hickman,South Judithside,Somalia,+1-281-150-8213x99443,(399)480-4960x192,bernard69@barnes.com,2021-11-12,https://armstrong.com/
30-Apr-2021,Miscellaneous,694.00,00.00,694.00,ed185ddD0DCc66A,4992,Sierra,Diaz,Mcpherson Inc,East Darrenland,Hungary,+1-803-501-3477x8101,400.009.3515,charlotte76@booker.com,2021-11-17,http://www.braun-mccullough.info/
30-Apr-2021,Miscellaneous,00.00,231.33,462.67,40e731Bf9cF4FaC,2940,Colin,Schaefer,Booker-Ashley,East Cheyennetown,Zambia,+1-659-510-6647x16403,1804988697,marie75@hensley.com,2020-02-26,https://www.travis-ellison.net/
30-Apr-2021,Cash,00.00,51.41,411.26,7C4dC4b1bDeFfbc,6639,Katrina,Barrera,"Parrish, Fitzgerald and Gibson",Sydneyshire,Vanuatu,713.169.9384x19216,566.420.8629,elizabeth14@zimmerman.com,2022-04-05,http://www.sandoval.com/
30-Apr-2021,Cheque,00.00,205.63,205.63,368aB1fdA3d02dd,5760,Kathryn,Bonilla,Bray-Cline,Port Susanside,Netherlands Antilles,101.681.5669x98634,001-244-699-1422x3382,plopez@noble.com,2021-10-31,https://villegas.com/
01-May-2021,NEFT,00.00,29.38,176.25,eB6f6648A7A0BD1,546,Carrie,Nielsen,"Ingram, Brady and Simpson",Rebekahmouth,South Georgia and the South Sandwich Islands,0676998498,001-775-546-6228,pkelly@lindsey-barr.info,2020-07-17,https://flynn.org/
01-May-2021,Debit Card,00.00,19.58,156.67,EFD8ceDDDDBEDD0,2631,Gary,Shea,"Kline, Nolan and Mills",Vickifort,Marshall Islands,(874)120-0145x3395,884-695-6687,brycestevenson@hanson.com,2020-10-08,http://www.scott.com/
01-May-2021,Debit Card,"220,839.03",00.00,"220,995.70",Afdc83D38C9a06e,3678,Judy,Santiago,Beard Inc,Jermainebury,Puerto Rico,905.486.6039x85738,893.563.6297x0244,dariusolsen@oneal-holloway.biz,2022-01-03,https://kelley.com/
01-May-2021,Debit Card,02.00,00.00,"220,997.70",cfBf858FAA0EabD,468,Ruben,Berger,Yu-Schneider,Bradfort,Iran,001-923-163-7766x93504,+1-165-863-5878x828,ivanroman@hamilton.org,2020-06-12,https://lowe.net/
01-May-2021,Debit Card,00.00,"36,832.95","184,164.75",e4D9C5bcfA4b0E3,8118,Joel,Conley,Richards-Saunders,East Aimee,Saint Lucia,982.423.5836x695,179.824.6309,ninaortega@guzman.com,2020-06-11,https://www.thornton.com/
01-May-2021,Bill,00.00,"92,082.38","92,082.38",6947B862e29A8FE,4591,Pam,Berger,Cervantes LLC,North Jonathan,Netherlands,001-701-406-4460x669,+1-922-454-7008x517,courtney60@dawson-reed.net,2020-02-10,https://www.blake.com/
01-May-2021,Debit Card,00.00,"30,694.13","61,388.25",1f270C64Ffc08ab,2647,Johnny,Strickland,Collins PLC,Glennshire,Albania,+1-183-463-2732,+1-958-796-7553x8125,nortonclifford@newman-santos.biz,2020-08-05,http://www.fletcher.net/
01-May-2021,Purchase,06.80,00.00,"61,395.05",2D4d0f51Fa6f0cc,2674,Adam,Underwood,Shelton Group,New Janeport,Guadeloupe,(859)774-3762x505,001-270-874-0024,marvindean@davenport.com,2020-05-10,http://www.nunez-navarro.com/
01-May-2021,Purchase,00.00,"30,697.53","30,697.52",c0F56ea6411D6B7,469,Faith,Flores,Smith LLC,South Marcus,Guernsey,+1-890-354-6542x581,+1-107-204-6659x94816,eric18@avery.com,2020-01-12,https://www.powers.net/
01-May-2021,Commission,00.00,"10,232.51","20,465.01",B6C8723eBc92D35,3417,Daryl,Guerra,Gallegos Inc,Paulaview,Rwanda,516.356.0800,224.197.5640x6148,sharon91@walker.biz,2021-11-25,http://costa.org/
01-May-2021,NEFT,"1,074.60",00.00,"21,539.61",af9E08B0dDe8216,5800,Frederick,Bullock,Orozco-Hebert,Jefferytown,Djibouti,001-835-668-1766x550,001-834-882-8713x507,blankenshipdonna@beck-barron.com,2020-03-07,http://meadows.org/
01-May-2021,Bill,00.00,"10,769.81","10,769.80",0CeCccbeb526Ede,8022,Ray,Mccann,Solis-Ayala,Nicholsborough,Slovakia (Slovak Republic),001-075-145-1194x761,+1-347-069-6061x60234,lance41@moyer.com,2020-06-03,https://www.berg-davies.com/
01-May-2021,Tax,00.00,"1,076.98","9,692.82",E4d9b13346B5Bf6,8719,Krystal,Villa,Luna-Hunter,Burchport,Mongolia,285.281.0977x991,(833)073-0805,vickihoward@hardin.com,2020-06-26,https://wong-cole.com/
01-May-2021,NEFT,287.90,00.00,"9,980.72",bD3af85B4c44B14,1590,Jeremiah,Solomon,Pace-Choi,Mauricehaven,Eritrea,356-274-1357x88110,201.578.5240,alecbennett@mcgrath.biz,2022-03-18,http://www.owen-sawyer.com/
01-May-2021,ATM,00.00,"2,495.18","7,485.54",bBee657D390d6EE,3437,Carlos,Mcpherson,Stout-Pope,Port Cory,Gambia,001-692-913-9636,4331963297,zchristensen@crawford.info,2021-05-17,https://navarro.com/
01-May-2021,IMPS,00.00,748.55,"6,736.99",Cc69A154c8EDAa3,5247,Regina,Richmond,Frazier-Peters,Averyville,Dominica,+1-653-583-4993x0746,667.682.3769x671,harpermarvin@browning.com,2020-03-30,https://boyle-sanders.com/
01-May-2021,Debit Card,250.60,00.00,"6,987.59",68e933358B2Daf6,5823,Corey,Fry,Rowe-Hanson,Catherinefort,Faroe Islands,001-896-651-6477x44130,(475)925-4284,wallssamuel@hansen.info,2021-10-06,https://www.klein-colon.com/
01-May-2021,Miscellaneous,00.00,698.76,"6,288.83",7223FBcF9bAA4F0,9264,Cassandra,Duarte,"Daugherty, Nguyen and Mullen",Port Terrichester,Turkey,+1-081-909-1649x7767,305-645-7562x1953,hardylarry@wall-watts.biz,2021-10-06,https://www.sellers-browning.com/
01-May-2021,Debit Card,02.72,00.00,"6,291.55",a9dCa7ac9Ce2Ab2,987,Marvin,Fitzgerald,Matthews-Buckley,Stacytown,Martinique,+1-227-729-5055x928,(699)160-4397x611,eperez@thomas-montoya.com,2021-12-22,http://mays-saunders.com/
01-May-2021,Cheque,371.52,00.00,"6,663.07",4262Dcdc013a0c2,6788,Jackson,Rodgers,"Hurst, Patterson and Cooper",Johnsonchester,Nicaragua,(258)559-7396,+1-866-068-0718x945,sbranch@welch-santana.net,2020-05-13,http://brandt-andrade.biz/
01-May-2021,Interest,29.50,00.00,"6,692.57",E34b6c1c3923f7D,4889,Julie,Powell,Murray-Dyer,Lake Alan,Netherlands,001-620-567-7957x068,(913)109-1497,poolelindsey@kirby.biz,2021-09-26,https://frazier-pope.com/
01-May-2021,Interest,00.00,956.08,"5,736.49",28AaBDDbb69FE3D,4882,Latasha,Shannon,Melendez-Roberson,Cristianhaven,Cocos (Keeling) Islands,001-864-327-8012x8512,(029)676-7544x527,fgriffin@wade-ballard.net,2021-12-26,http://mendez.info/
01-May-2021,Commission,00.00,"1,912.16","3,824.33",ee09DDAa55bB8E4,9116,Cory,Davies,Lawson-Weaver,Carpenterhaven,Egypt,+1-010-450-2575x6933,001-360-993-6222,masseyruth@hogan.com,2020-11-23,https://www.baird.com/
01-May-2021,Tax,57.00,00.00,"3,881.33",28Ef45dAAF11b7D,8720,Jenny,Webster,Palmer Ltd,Yodermouth,Belgium,012.346.8978x032,2421094775,eyork@hanson-york.net,2020-11-22,https://black.com/
01-May-2021,Reversal,"15,723.80",00.00,"19,605.13",94cceEcfd1Bdde8,1196,Jodi,Ortiz,Mckinney PLC,Spearsburgh,South Africa,9669074928,(608)679-0041x8415,pedro68@reese-gonzalez.net,2020-01-01,http://www.mcmahon-bowers.net/
01-May-2021,Transfer,00.00,"2,800.73","16,804.40",dAFf1fC8CcFe956,7357,Jenna,Mccall,David-Schmitt,Baileyburgh,Ethiopia,514.944.7179x907,+1-921-344-9287x047,sgray@stanton-peters.com,2021-01-14,http://lowery.com/
01-May-2021,Cash,"1,492,074.20",00.00,"1,508,878.60",aF2F7d88788cc7E,8605,Daniel,Neal,"Merritt, Little and Potts",Leefort,Albania,2395655515,+1-893-727-8174x7692,derek31@parrish.biz,2021-03-14,http://gilmore.net/
01-May-2021,IMPS,"482,108.00",00.00,"1,990,986.60",861c02a9302a09D,3645,Lindsey,Frazier,"Hodge, Rush and Singleton",East Karina,Jersey,+1-159-446-6984x9015,(632)731-9287x181,baileystevenson@herrera.biz,2021-05-24,https://joseph-maynard.biz/
01-May-2021,Miscellaneous,00.00,"398,197.32","1,592,789.28",83d9accaD6AFBF9,55,Jeremy,Guerra,Gamble Group,South Jeremiahberg,Nauru,001-343-604-8248x84492,142.473.8437x8627,lfaulkner@villanueva.com,2022-05-12,https://giles-newton.com/
01-May-2021,Cheque,62.18,00.00,"1,592,851.46",dea3eFB3b564FEe,8238,Dean,Dyer,Ryan PLC,Chenfurt,Barbados,(093)320-7714,6264712740,marc69@duran.org,2020-04-19,https://johnston-wong.info/
01-May-2021,Cheque,00.00,"530,950.49","1,061,900.97",bF566C66eaD2E8c,1040,Gloria,Paul,Lyons Group,Sanchezton,Bhutan,671.189.1871,+1-676-843-1920x97280,icisneros@finley.com,2022-04-11,https://holloway.com/
01-May-2021,Reversal,34.29,00.00,"1,061,935.26",Ea5c0e13f25520D,7348,Glen,Herrera,"Clements, Morrison and Wright",East Sydneymouth,Malawi,189-066-6270x893,(555)039-3934x9581,jackhale@lyons.com,2021-12-05,http://christensen.info/
01-May-2021,Reversal,95.90,00.00,"1,062,031.16",e43CeeA0Da7ea3a,8098,Sarah,Sandoval,"Higgins, Rice and Eaton",Jacobsonbury,Mongolia,411-978-1815,+1-193-469-9770x1433,staffordkristen@hardin.biz,2021-05-15,http://www.wilson-ward.com/
02-May-2021,Bill,30.60,00.00,"1,062,061.76",16e30af2efbd892,5559,Neil,Castro,Perry LLC,Kimborough,Hungary,+1-838-474-6768x6751,789.948.2000x10108,inorris@crane.com,2020-10-03,https://www.floyd.com/
02-May-2021,Debit Card,16.90,00.00,"1,062,078.66",c1d0D052f1DB157,4254,Jane,Dougherty,"Gross, Maxwell and Maldonado",Ethanberg,Macao,(236)699-9758x64133,576.345.7437x171,spencergavin@bell.net,2021-05-26,http://www.butler.com/
02-May-2021,IMPS,00.00,"1,062,078.66",00.00,Fd1aC693903c1f6,2213,Hailey,Graves,Munoz-Porter,East Isabella,Jersey,+1-556-142-6704x4473,668.483.5515,fisherchristian@delgado.net,2020-06-06,http://guzman.com/
02-May-2021,Miscellaneous,"185,138.00",00.00,"185,138.00",D87D3D0fcBc316E,3494,Levi,Ayala,"Byrd, Patton and Hunt",Connorside,Saint Helena,583.895.8012x043,001-170-631-5575,alyssa63@cooley.org,2020-01-03,https://www.oneill.biz/
02-May-2021,RTGS,00.00,"92,569.00","92,569.00",dD66836c1066a8f,4246,Marc,Rasmussen,Kent-Pineda,Odonnellstad,Myanmar,+1-127-059-9660x326,929.270.7677x2890,alexsharp@bonilla-carpenter.org,2021-08-22,http://www.cox.biz/
02-May-2021,Commission,468.00,00.00,"93,037.00",98f69acbfD2cfeE,828,Jill,Price,"Farmer, Mccormick and Stokes",Port Brookeview,Egypt,(437)042-6205x5517,001-549-418-6190,mollyfaulkner@nielsen.biz,2021-06-08,https://marsh-pollard.com/
02-May-2021,Purchase,00.00,"9,303.70","83,733.30",78EF2aaEfA71DdD,2929,Cory,Mcintyre,Coleman-Steele,Gracemouth,Brunei Darussalam,001-504-152-3758x45756,001-757-118-4165x545,cameronbrenda@ortega.biz,2020-04-07,http://hodges.com/
02-May-2021,Bill,00.00,"8,373.33","75,359.97",8ea7D0beCDdA164,4034,Robin,Moran,Hart Inc,West Pamela,Somalia,001-136-309-9206,(216)696-8450x52224,ibarralaura@le.com,2020-02-02,https://www.wise.org/
02-May-2021,Interest,00.00,"8,373.33","66,986.64",a02Dc59adEdd6e7,748,Dwayne,Kim,"Norton, Moore and Mcbride",Johnside,Costa Rica,531-731-8611x6135,3906769010,maciasjoe@cohen.org,2020-09-03,http://www.palmer.com/
02-May-2021,RTGS,00.00,"33,493.32","33,493.32",FB82DDa596361fC,8426,Bobby,Knight,Wu Ltd,Janeburgh,Iraq,+1-253-684-3839x6032,331-780-2576,itownsend@terry-case.org,2020-11-03,https://www.oneill.com/
02-May-2021,IMPS,00.00,"3,721.48","29,771.84",BE53ED44B2B4Dd3,3155,Margaret,Dillon,"Sherman, Olsen and Bennett",Caitlinberg,Lao People's Democratic Republic,830.202.4364x007,386-750-3778x66094,wharding@dickerson.com,2020-11-29,http://holden.com/
02-May-2021,Interest,462.54,00.00,"30,234.38",c811AA9e7356884,1596,Ryan,Baldwin,Cortez Inc,Landryside,Tuvalu,486.680.9465x023,6973275695,stacie98@newman.com,2021-12-30,http://duarte.com/
02-May-2021,Bill,"600,553.50",00.00,"630,787.88",eD9BaB908ba2a3b,5485,Daryl,Jacobson,"Sullivan, Rhodes and Walls",Andersonmouth,Anguilla,074-906-2040x7211,554-652-2500x36897,vanessa53@spears.org,2021-11-05,https://www.gay.com/
02-May-2021,Bill,"1,857,689.25",00.00,"2,488,477.13",a1A4334f7eA2712,2983,Victor,Dennis,"Medina, Bradford and Medina",Lake Daltonborough,Somalia,454-383-6920,(364)073-1028x351,wkirby@cortez.com,2020-01-01,https://coleman.com/
02-May-2021,RTGS,00.00,"622,119.28","1,866,357.85",7Ca6e4780EaDFDb,8774,Phillip,Russell,Washington-Ball,Calebview,Vanuatu,001-890-679-1683x863,(514)616-1176,carriemeyer@fletcher.com,2022-01-14,https://mcmillan.com/
02-May-2021,Tax,"78,777.00",00.00,"1,945,134.85",1B40A2cf45E6af2,6887,Clifford,Atkinson,Khan Ltd,West Audrey,Tanzania,578.766.3997x453,+1-514-164-3868x6259,garzaricky@ortega.com,2022-01-23,http://www.good.com/
02-May-2021,Purchase,00.00,"648,378.28","1,296,756.57",4C1EA7207626bf3,4418,Antonio,Peterson,Crane-Gardner,Jeanneside,Uganda,+1-228-079-7986x740,441-004-9428x65399,nichole14@marquez-herring.com,2021-03-04,http://forbes.com/
02-May-2021,Reversal,"185,923.50",00.00,"1,482,680.07",F7fE6E0FbE700A6,1140,Rebecca,Erickson,"Spencer, Good and Abbott",North Herbert,Reunion,501-271-7883,+1-951-535-1512x400,danielhiggins@noble.info,2020-12-06,http://watkins.org/
02-May-2021,Commission,"1,941.60",00.00,"1,484,621.67",C3fa29b91d47A67,1427,Valerie,Kemp,Estes Group,Lucerostad,Uzbekistan,001-893-151-4295x693,9612282978,edward22@duran.net,2021-02-16,https://hendrix.com/
02-May-2021,Interest,"3,649.60",00.00,"1,488,271.27",4efbCcDAD9F2a7c,4017,Brenda,Lam,"Kelly, Callahan and Ewing",South Jadeborough,Egypt,(598)071-6527x5131,(334)705-6719x383,kempshelia@hamilton.com,2022-04-23,https://www.burton-mendoza.com/
02-May-2021,ATM,00.00,"248,045.21","1,240,226.06",Fd1aC693903c1f6,2213,Hailey,Graves,Munoz-Porter,East Isabella,Jersey,+1-556-142-6704x4473,668.483.5515,fisherchristian@delgado.net,2020-06-06,http://guzman.com/
02-May-2021,Interest,00.00,"413,408.69","826,817.37",6bF0C36DF0E9CdE,2019,Christine,Morrison,Weber-Giles,Isabellafort,Moldova,154.321.9140x451,695-246-1201x0155,willie82@benson.org,2020-04-20,https://sanders.com/
02-May-2021,Reversal,00.00,"275,605.79","551,211.58",eAD9fF7cad2c49d,2187,Austin,Knox,Mcbride-Donaldson,New Chloe,Romania,+1-660-444-1591x303,+1-015-071-0031x1222,anaray@morales-fuentes.info,2020-03-17,http://bates-torres.com/
03-May-2021,Miscellaneous,00.00,"275,605.79","275,605.79",6817CCe5488bbee,7226,Nathaniel,Sloan,Wang-Spencer,North Sandra,Ethiopia,001-524-670-3579x564,001-913-268-5077x851,brent21@koch.org,2020-11-20,http://www.herring.com/
03-May-2021,Cash,00.00,"39,372.26","236,233.53",5edfddEba6d297e,8074,Aimee,James,Ho LLC,Gwendolynstad,Angola,+1-627-076-1124x4754,771.353.8012x687,alexandra14@mitchell-hernandez.com,2020-11-26,https://www.wyatt-preston.net/
03-May-2021,Transfer,05.00,00.00,"236,238.53",32C2Fce9Ef8FDb3,7839,Kurt,Fox,Klein-May,Reynoldsborough,Trinidad and Tobago,447.926.0390x91071,001-050-309-3124x2640,mdorsey@shea-dyer.com,2021-08-21,http://bush.org/
03-May-2021,RTGS,12.30,00.00,"236,250.83",C9966eCAbd5F1AC,2278,Kristen,Sanders,Rowland-Grant,Choistad,Paraguay,+1-405-353-1742x608,001-951-879-5674,davidmorris@tran.biz,2020-05-16,https://arroyo.com/
03-May-2021,IMPS,00.00,"47,250.17","189,000.66",E80a2C0b1dcEBDa,3927,Beverly,Morton,Guerrero-Morrow,West Peggybury,Algeria,298-789-8903x60076,535-130-6363x04970,rjames@guerrero.com,2020-11-22,http://henderson.com/
03-May-2021,NEFT,00.00,"47,250.17","141,750.50",Abc372398aA47C7,5158,Cameron,Turner,"Mann, Woodard and Beltran",Leroymouth,Seychelles,688.701.6652x7737,219-552-6759,cesarschmidt@kelley-ford.com,2022-03-07,https://www.vaughn.org/
03-May-2021,Cash,97.00,00.00,"141,847.50",C8Aa24e3B9E8B0d,2509,Sherry,Kim,"Martinez, Moyer and Downs",South Tamishire,Netherlands Antilles,7149656013,847.889.2372,dbarnett@weiss.com,2020-05-08,http://www.cunningham.com/
03-May-2021,Cheque,05.00,00.00,"141,852.50",eA89dC7B08DA83B,5201,Kent,Washington,Carr and Sons,North Latoya,Poland,659.331.7232x239,+1-854-949-2936,alexanderjohn@donovan-shelton.com,2022-04-11,https://www.kerr.com/
03-May-2021,Purchase,"1,731.00",00.00,"143,583.50",Ec605237b17E03A,4452,Omar,Kelly,"Brock, Rosales and Todd",Billyshire,Wallis and Futuna,+1-857-942-2853,+1-393-101-7370x4723,mercadokatrina@weiss.org,2022-02-05,https://www.duarte-garrett.net/
03-May-2021,Cheque,49.00,00.00,"143,632.50",4EBfE088fbCe23C,3030,Shawna,Everett,Flynn PLC,Jamesside,Maldives,487-099-2999,1139256770,hesseric@burke-grant.info,2020-04-27,https://www.gutierrez-jones.com/
03-May-2021,Reversal,00.00,"17,954.06","125,678.44",68a17341d8242d4,6218,Anna,Rice,Faulkner-Boyer,Billymouth,Madagascar,(442)960-3423x8782,001-790-654-0861,brentedwards@riley-craig.com,2022-02-06,http://www.bullock.com/
03-May-2021,IMPS,"805,770.00",00.00,"931,448.44",4fA018fb372a8EF,2355,Ryan,Bradford,Bennett-Mcfarland,Lake Yvette,Macao,001-998-883-6818x3196,+1-063-013-0220x82289,haneysonia@petersen.info,2021-03-27,https://www.benitez-chavez.com/
03-May-2021,NEFT,"159,444.72",00.00,"1,090,893.16",C3fa29b91d47A67,1427,Valerie,Kemp,Estes Group,Lucerostad,Uzbekistan,001-893-151-4295x693,9612282978,edward22@duran.net,2021-02-16,https://hendrix.com/
03-May-2021,Debit Card,00.00,"181,815.53","909,077.63",B68A57F8e4aB45F,8168,Haley,Carey,Martin LLC,South Tonyaberg,Hong Kong,001-711-145-7984x46705,+1-918-288-1717x5534,foxernest@barnes.biz,2021-04-01,http://www.roman.org/
03-May-2021,ATM,19.00,00.00,"909,096.63",C1f37CdCc6486dE,3632,Yesenia,Gonzales,Martinez PLC,Morrisview,Australia,760.973.4470x8469,(825)596-5404,solomondeanna@simon.com,2022-05-10,https://www.wilkerson-hobbs.com/
03-May-2021,Bill,00.00,"227,274.16","681,822.47",C34cFCea4b150b7,7896,Lucas,Merritt,Clements-Melton,Francismouth,Sierra Leone,711-552-1308x3280,+1-032-510-6254x83328,mcintoshnicole@todd-spears.org,2022-01-07,https://chen.com/
03-May-2021,Reversal,"151,779.10",00.00,"833,601.57",599cC0d087A5796,9389,Chelsea,Stephenson,"Berg, Allen and Middleton",South Russell,Oman,219.542.2387x564,0042011218,moondarren@carrillo.com,2020-10-31,https://www.mora-wallace.org/
03-May-2021,IMPS,00.00,"83,360.16","750,241.41",6Da2EBA63dC00FD,3735,Tyrone,Kent,Henderson-Clay,Joeport,Albania,001-656-379-3803x830,001-613-636-9737x429,elaine65@hebert.com,2020-01-05,https://potter.org/
03-May-2021,Bill,"72,649.80",00.00,"822,891.21",EAbCB93DA3C8BC4,1954,Daisy,Hernandez,Roth LLC,Sotoville,Jordan,(950)713-4305x2847,(840)206-1897,eduardo76@mason.com,2020-02-29,http://www.wu.info/
04-May-2021,Purchase,"23,510.00",00.00,"846,401.21",DB45D49E814D477,2774,Toni,Dickerson,"Ewing, Jones and Odom",Angelahaven,Nepal,001-056-065-5963,2234923575,nolanmisty@massey.com,2022-04-30,https://www.ward.com/
04-May-2021,Tax,01.60,00.00,"846,402.81",6e124FCa60cC2c7,2070,Geoffrey,Thompson,Anderson LLC,New Beverlyfort,French Southern Territories,444.140.4853,735.845.5188,zchristensen@carson.com,2021-06-04,http://www.lowery.info/
04-May-2021,Cash,00.00,"846,402.81",00.00,b9Ce9c92FdFb2eA,6764,Sean,Faulkner,"Young, Swanson and Aguilar",North Darrenville,Algeria,515-733-4945x347,001-536-418-8455,navarroemily@briggs-mcguire.com,2020-12-08,https://james.com/
04-May-2021,Transfer,02.42,00.00,02.42,CF5af9aAc15d6Fd,1055,Caitlyn,Love,"Duarte, Duncan and Werner",Brettfurt,Barbados,+1-541-574-1524,001-559-872-7923x53789,henryjordan@gregory.org,2021-10-19,http://www.jimenez-tyler.com/
04-May-2021,Cash,00.00,00.30,02.12,043Fe33e7aedBE1,3269,Maurice,Barnett,Mack-Mckinney,Port Beverlyport,United Kingdom,001-363-872-0027x8029,369-721-8946x25691,zcastro@camacho.info,2020-02-18,http://www.larson.com/
04-May-2021,Bill,00.00,01.06,01.06,87E8bcaa763C106,6400,Cathy,Johnston,"Kane, Mercer and Mccall",Lake Shelleyside,Turkmenistan,991-190-3160x31545,585-904-4791,carly75@cordova.com,2021-03-19,https://ortiz.com/
04-May-2021,RTGS,"229,888.00",00.00,"229,889.06",Ec5Db1e82E09edB,5780,Dominique,Brewer,Hutchinson-Buchanan,North Jim,Liechtenstein,296-935-5166,517-289-8836,gbowers@black.com,2020-08-31,http://prince.com/
04-May-2021,Tax,"17,586.82",00.00,"247,475.88",bceC523b019f382,4803,Jamie,Maldonado,Sloan-Hartman,Peckhaven,Cyprus,(421)816-8528x970,+1-779-785-9300,glennholmes@washington.org,2022-05-24,http://www.arellano-mccarty.com/
04-May-2021,Tax,451.00,00.00,"247,926.88",9e0D2B59C3f5EcD,8798,Hayden,Weeks,Berger LLC,Katieton,Nepal,+1-036-657-4722x0770,422.206.3424x74151,brittney86@jacobson-suarez.biz,2021-04-07,https://jackson.net/
04-May-2021,Tax,03.60,00.00,"247,930.48",7BB5a237b72a048,3517,Chloe,Nielsen,Esparza-Pena,Vaughanbury,Mauritius,594-683-0828x21114,001-652-794-5116x6369,rickey48@burns.com,2022-03-10,http://hall.biz/
04-May-2021,Commission,00.00,"247,930.48",00.00,b5A44D3f02995E4,6384,Cynthia,Howard,"Villarreal, Conway and Mcintosh",West Leslie,Poland,662.422.3607x885,561.221.7326x77980,melvin61@curry-benton.com,2020-11-13,https://www.baker.com/
04-May-2021,Commission,14.00,00.00,14.00,2D0594c3bBe028B,7158,Abigail,Cannon,"Wheeler, Roy and Dillon",East Julie,Cape Verde,998-838-1558x1043,001-208-865-0866,kbarnes@mccarty.com,2020-01-26,http://www.hanson.com/
04-May-2021,Bill,00.00,02.80,11.20,8bFE9aaDFdbfB59,5542,Jesus,Chaney,"Odonnell, Knight and Wu",South Mathewside,Guernsey,(304)133-2020x2431,883.746.2369,kaylee52@sloan-huang.info,2021-12-24,http://www.bennett-roy.com/
04-May-2021,Purchase,00.00,01.12,10.08,aF0F700fBF7dc6f,8894,Jeanette,Dodson,"Short, Faulkner and Black",Roweville,Nauru,(634)091-1993x3329,+1-556-984-9534x3077,mcconnellalexis@bautista.com,2020-09-17,https://www.riggs.com/
04-May-2021,Reversal,00.00,01.44,08.64,d0Ca394F8A5bf8c,4417,Kristy,Salas,Owen Group,South Marchaven,Tunisia,(458)666-2004x550,(125)744-9881,chrishays@fisher-yates.com,2022-01-27,https://www.dudley.com/
04-May-2021,Commission,755.00,00.00,763.64,8C959eC7E6Ee2F8,1580,Shirley,Cuevas,Stewart-Crawford,North Jocelynton,Tuvalu,334.474.1950x1963,637-518-1723,laura75@lawson.org,2022-02-27,http://www.benson-black.com/
04-May-2021,RTGS,"2,990.50",00.00,"3,754.14",5B65b13dcDeBFa4,579,Jermaine,Pittman,"Calderon, Bradford and Caldwell",Caitlinland,Turkey,(826)772-7605x725,966.816.3434x2156,gcobb@mcclure-weber.com,2022-03-14,https://benjamin-dudley.com/
04-May-2021,Reversal,"1,730,231.75",00.00,"1,733,985.89",9Ce9eCAcAC9DfCB,4095,Shaun,Weaver,Mccullough and Sons,Stevensberg,Saint Kitts and Nevis,285.149.0810x59514,+1-540-231-1556x2720,austinsingleton@juarez-austin.com,2020-11-01,http://hardin.com/
04-May-2021,IMPS,00.80,00.00,"1,733,986.69",01C49B8CE7D9Af0,195,Kaitlyn,Collins,Golden Group,Howellborough,Guatemala,064.347.7410,001-544-643-3875x1257,luis12@buck.com,2020-11-06,http://flynn-cameron.info/
04-May-2021,Transfer,00.00,"433,496.67","1,300,490.02",DeDDD3e5e9D3a66,5555,Madison,Davila,Mcintosh-Buckley,Marquezfort,Azerbaijan,001-119-248-4493x277,+1-238-476-2411x59499,roystuart@garza.com,2021-12-31,https://stuart-galloway.com/
04-May-2021,Cash,"205,015.00",00.00,"1,505,505.02",DBFb7dA141Eeaf7,3497,Annette,Ali,"Nguyen, Skinner and Morgan",New Harold,Bouvet Island (Bouvetoya),7341735791,995.975.6312x3160,alfredsantos@henson.info,2022-05-20,https://www.patterson-solis.info/
04-May-2021,Miscellaneous,00.00,"1,505,505.02",00.00,Aa45dE7769DfEa6,1836,Aaron,Horn,Callahan Inc,Sydneyport,Timor-Leste,(846)730-1820,(446)611-2429,ckemp@travis.info,2022-01-06,http://khan-arias.info/
04-May-2021,ATM,"112,869.06",00.00,"112,869.06",aFD75E96E9a3d4e,1139,Grant,Patrick,Shepherd-Sherman,Carlyside,Uzbekistan,173-554-4085x7863,988.429.6615,aberg@sawyer-kim.biz,2020-08-29,https://www.hester.com/
04-May-2021,Miscellaneous,"27,936.00",00.00,"140,805.06",3AB3f26EeD1C3CC,8549,Jillian,Waller,"Lambert, Mccarty and Mullins",Sheltonton,Jordan,2933733641,+1-024-172-6492x6346,gholloway@mcfarland.com,2020-07-26,https://bray-cross.info/
04-May-2021,Commission,00.00,"14,080.51","126,724.55",5ee4c65a392e6C3,3227,Devon,Estes,"Copeland, Zimmerman and Ramsey",Timstad,Liechtenstein,063-552-3683x133,(832)090-2093,waltergardner@lawrence.biz,2021-11-20,https://holmes-maynard.info/
04-May-2021,Transfer,00.00,"126,724.55",00.00,F9F76CCdBa6247f,1564,Brittney,Martinez,Morgan-Juarez,Port Shari,Georgia,399.317.8454x730,+1-689-701-1818x14280,nelsongilbert@mcmillan-jones.com,2020-06-17,https://leonard.com/
04-May-2021,Cash,470.75,00.00,470.75,dDB35CFf9bEF1aB,4605,Ethan,Pena,"Blanchard, Cross and Klein",Lake Kentton,Zambia,+1-012-411-3656x93059,001-871-207-5402x880,xcallahan@thomas.com,2020-07-31,http://richard.com/
04-May-2021,Debit Card,00.00,235.38,235.38,F551BAbe8F4ACcd,7059,Gregory,Mcbride,Joseph Inc,Meghanburgh,Saint Lucia,(321)894-9871x0621,304.266.9175,williamsonyvette@hayes-simpson.com,2020-03-06,https://www.kane.com/
04-May-2021,Purchase,00.00,26.15,209.23,4d41c0F3D0f7Ea0,4997,Paige,Greene,Padilla PLC,Port Frederickbury,Israel,(146)941-9706,058.822.7544,abarajas@bright-yates.com,2020-01-01,http://www.roach.net/
04-May-2021,Cheque,06.56,00.00,215.79,2608baDBDaa8D3A,9709,Jody,Meza,Mays-Henson,Lake Catherinemouth,Australia,(791)053-3577x286,987-103-5082,pachecobrent@house.com,2022-04-18,https://www.holder-burgess.com/
04-May-2021,IMPS,"1,136,766.50",00.00,"1,136,982.29",354E5025f9FBCEd,1244,Joanne,Daniel,Bryan-Dennis,New Ivanton,Panama,393.291.9907,564-308-2142x3166,rhunter@macdonald.org,2020-05-13,https://vasquez.net/
04-May-2021,IMPS,03.50,00.00,"1,136,985.79",2af69e0bDDcC35d,8724,Alice,Conley,Hull-Dixon,Randallfort,French Southern Territories,995.404.7330,748-072-0206x39203,kcooper@pacheco-hale.com,2020-09-29,https://www.hendricks.com/
04-May-2021,Miscellaneous,"150,475.00",00.00,"1,287,460.79",aE072dc97b13f9F,4839,Caitlin,Todd,Beard-Smith,Carlyhaven,American Samoa,(766)550-3988,0852449439,danielle89@norton.biz,2021-08-12,https://foster.com/
04-May-2021,Debit Card,00.00,"128,746.08","1,158,714.71",Ff4AFa8FDAA3c7F,1618,Geoffrey,Fuentes,"Moon, Simpson and Chan",Muellerberg,Congo,+1-907-827-0439x24328,(381)278-7277x389,buckleysandra@schultz.info,2021-12-21,http://www.christian.com/
04-May-2021,Cash,00.00,"231,742.94","926,971.77",A3872DfDeE7c365,6969,Dustin,Vega,Lutz-Mcconnell,East Lisafort,Cook Islands,754-525-9152x2253,978.609.6081,alyssa93@caldwell-burch.com,2021-12-03,https://frost-garrison.com/
04-May-2021,Cheque,"87,417.00",00.00,"1,014,388.77",46FFb5Bf67A6EcE,365,Cynthia,Bryan,Pollard-Mcknight,Gordonchester,New Zealand,994.105.5820,784.491.2221,zhubbard@reilly-mccall.net,2020-05-05,https://www.valentine.com/
04-May-2021,Reversal,"4,032.00",00.00,"1,018,420.77",Cd59F2dFBAd382f,5402,Latasha,Mason,Lamb PLC,Hornmouth,Korea,946-294-6443x3594,326-479-0224,jeanette88@walters.com,2021-12-22,http://www.poole.com/
04-May-2021,Tax,"3,199.00",00.00,"1,021,619.77",ebc09AA8FA8FaB0,1381,Bianca,Lawson,"Owens, Bernard and Day",Marilynland,Saint Barthelemy,+1-354-626-7409x047,001-058-396-4956x817,calvinmata@richard-greene.com,2020-07-29,https://galloway.net/
05-May-2021,RTGS,"1,259,604.50",00.00,"2,281,224.27",8bcfEc9e49CD708,7961,Billy,Everett,Weber Ltd,East Dustinmouth,French Guiana,001-604-266-9430x6237,+1-607-259-9851x64726,brownmichelle@zuniga-cross.com,2020-01-20,http://www.estrada.com/
05-May-2021,IMPS,00.00,"380,204.05","1,901,020.22",DFcFcA6a4C8f4Ef,7186,Andre,Benitez,Jenkins and Sons,Arthurton,Gambia,057.819.2015x6701,3829629415,matthewhowell@dodson-fitzpatrick.com,2022-04-30,http://haas.biz/
05-May-2021,RTGS,"100,633.75",00.00,"2,001,653.97",Bca2d5CeeF19eaa,6103,Jessica,Giles,Donaldson PLC,Katieton,Latvia,145.495.3899x313,001-055-930-1041x3084,buckleyjames@gallagher-scott.biz,2021-06-29,https://www.scott.net/
05-May-2021,Cash,"233,897.22",00.00,"2,235,551.19",9f8a8EFd7d551cc,7373,Christie,Townsend,Ryan-Underwood,Snyderview,Russian Federation,350-687-1416x49706,+1-568-213-6329,huffjacqueline@cross.net,2022-03-13,http://www.patton-wilkins.com/
05-May-2021,NEFT,00.00,"2,235,551.19",00.00,4975BF68A04B6eb,1420,Samuel,Steele,Ryan Inc,Christianstad,Nauru,886.951.6541x15376,(681)287-6246x847,clineclifford@cooke.com,2020-03-04,http://good.com/
05-May-2021,Commission,"6,573.90",00.00,"6,573.90",94fd798dC0d7D55,7775,Dominique,Ferrell,"Roberts, Moss and Crosby",Marisamouth,Faroe Islands,842-950-3087x051,(391)829-3509,wardcharlene@becker-cortez.com,2021-12-29,http://www.henry.biz/
05-May-2021,RTGS,10.20,00.00,"6,584.10",Ff6b1e9297D9aEA,4666,Jacob,Irwin,"Patton, Dorsey and Davenport",Kennedybury,Dominican Republic,693-852-2729x71569,001-357-723-9905,hlozano@dorsey.org,2020-02-12,https://mills.net/
05-May-2021,Purchase,00.00,823.01,"5,761.09",c0FFadBbdDdbe6D,2749,Earl,Merritt,Harris-Mann,Madisonmouth,Indonesia,(153)393-8586,321.809.1115x0525,robbinscharles@ashley.com,2021-03-16,http://garcia.info/
05-May-2021,Cheque,00.00,"1,152.22","4,608.87",cA9Ffb8B1Db54dE,5300,Maureen,Singh,Spears Group,Hermanberg,Spain,+1-530-934-2008,333.270.7085,brandy28@foster.net,2020-10-03,https://www.mccall.com/
05-May-2021,Tax,"4,553.00",00.00,"9,161.87",0C75aBDa4b34Eec,5604,Jacob,Bruce,Burch-Estrada,Tonyburgh,Honduras,4164559869,+1-440-988-3588x9500,tmorris@donaldson.net,2021-05-03,https://www.gonzales.com/
05-May-2021,Miscellaneous,"155,448.50",00.00,"164,610.37",2b94E0a823C2FeF,206,Jose,Morse,Ford-Dixon,West Brendan,Chad,849-351-2710x10812,001-684-502-1388,woodsdevin@maldonado.org,2020-05-17,https://www.wheeler-wong.com/
05-May-2021,Cash,"7,463.00",00.00,"172,073.37",c7f6d3f7BeA0Ef3,581,Ellen,Quinn,Horton-Ware,Jamesside,Gambia,098.318.5155x15845,2138261062,annette75@cohen.net,2021-08-13,http://www.wade-scott.net/
05-May-2021,Transfer,"3,991.00",00.00,"176,064.37",e23bEc546a56CA9,8864,Jacqueline,Burton,"Schultz, Swanson and Patel",South Davetown,Brunei Darussalam,6329386752,(272)135-1095,wmoon@brennan.com,2022-02-02,https://www.richards-floyd.com/
05-May-2021,Interest,00.00,"35,212.87","140,851.50",CbB3a58ffAF1E1F,689,Jody,Thomas,Tran-Bray,Marcoshire,Fiji,+1-387-268-5336x2290,(379)634-8241x856,savannahlee@cabrera-kaiser.biz,2020-01-08,https://spence.net/
05-May-2021,Tax,00.00,"17,606.44","123,245.06",388eBDdDC8E6b18,8494,Samantha,Howell,Andrade-Ware,Gordonbury,Gambia,670.266.7549x1617,(887)627-7197x2403,cantrellkirsten@sanford.com,2020-12-09,http://www.cordova.com/
05-May-2021,Reversal,07.00,00.00,"123,252.06",E1aa570E0F2cc5a,7777,Sharon,Conway,"Webb, Norman and Hartman",Singletonbury,Nauru,001-696-779-6740x68656,2116634114,daughertykelly@tran.com,2022-05-09,http://reyes.biz/
05-May-2021,Interest,"484,224.50",00.00,"607,476.56",b516df3a7b70b9C,1360,Clinton,Macias,Barker PLC,Tonystad,United States of America,233-829-5526x50301,983.339.5259x22425,qashley@schmitt.biz,2021-10-29,http://www.hampton.com/
05-May-2021,NEFT,14.00,00.00,"607,490.56",a62Cc9baE159fB1,5644,Marisa,Berger,Weiss LLC,Lake Juan,Singapore,+1-042-511-2228x9911,+1-568-685-3611,carolynsantiago@crawford.com,2020-11-18,https://olson.com/
05-May-2021,Purchase,00.00,"86,784.37","520,706.19",4B9B8D49fAf7cae,261,Kristi,Chen,Obrien LLC,East Alyssaville,Japan,+1-549-824-0031x02701,723-705-9698,woodscollin@vargas.com,2020-06-20,http://www.mueller.net/
05-May-2021,Reversal,00.00,"74,386.60","446,319.59",eaAD7232B7B357f,2867,Duane,Chandler,Beard-Poole,Jensenburgh,New Caledonia,799-095-7056x392,525-927-4722x85794,micheal31@ali.com,2021-03-25,http://www.snyder-short.com/
05-May-2021,Reversal,00.00,"223,159.80","223,159.80",c0ed39AAE9183BB,7857,Natasha,Dunlap,Perez-Sellers,North Wesley,Latvia,(848)258-5771x9153,8602389213,pgrant@briggs.com,2021-04-21,https://www.lewis.com/
05-May-2021,Cash,00.00,"223,159.80",00.00,F551BAbe8F4ACcd,7059,Gregory,Mcbride,Joseph Inc,Meghanburgh,Saint Lucia,(321)894-9871x0621,304.266.9175,williamsonyvette@hayes-simpson.com,2020-03-06,https://www.kane.com/
05-May-2021,Debit Card,"502,117.00",00.00,"502,117.00",cca2E284AcF90d9,7503,Chelsea,Mcguire,"Shah, Mcpherson and Shaw",Dylanhaven,Morocco,001-780-078-8637x7339,692-642-8262x6092,zcaldwell@reeves-sheppard.com,2020-11-30,https://www.english-flowers.net/
05-May-2021,Transfer,26.28,00.00,"502,143.28",8744bE6af573DfE,1057,Summer,Parker,"Ruiz, Underwood and Guerra",Xavierland,Guatemala,(927)415-6001,+1-610-646-1606x4610,arielhuynh@townsend.com,2022-01-04,https://warren-reed.com/
05-May-2021,RTGS,00.00,"167,381.09","334,762.19",a49dB142BeE2DBf,1647,Mary,Mcpherson,Schroeder-Lane,Rileyview,Sudan,+1-400-734-7602x0355,(890)293-5041x62266,saraduke@saunders.com,2021-02-24,http://gay.net/
05-May-2021,Cash,03.00,00.00,"334,765.19",FA07C464bDefdC2,9188,Sonya,Flores,Lawson-Yu,Copelandborough,Turks and Caicos Islands,498-441-1668x77741,865.911.4125,alectate@gamble.com,2021-06-23,http://perkins.com/
05-May-2021,NEFT,"4,284.80",00.00,"339,049.99",7FF0894e98eA30B,8228,Bridget,Carney,Nixon-Good,South Kristie,Samoa,001-794-735-3705x4205,(604)448-6251x6045,longdiane@steele.com,2021-05-14,https://www.solis-myers.info/
05-May-2021,Reversal,773.18,00.00,"339,823.17",56C4dDB1EB7c004,2449,Bob,Wilcox,Melton Ltd,North Katie,Sudan,829.002.2276x68795,(591)423-8553,dsimon@mays-harmon.com,2021-01-31,http://www.cummings.com/
05-May-2021,RTGS,"924,657.50",00.00,"1,264,480.67",080d64e37586bDA,2172,Madeline,Cortez,Walsh-Bass,Lake Joanna,Vanuatu,155.703.5825x06726,+1-422-720-2893x72069,kristiegarza@english.com,2021-01-20,https://malone.com/
05-May-2021,Bill,"23,878.00",00.00,"1,288,358.67",84A596feF90a58a,4345,Steve,Lozano,Woods PLC,Ballstad,Ireland,440-629-1549,001-422-450-0505,yschneider@silva.com,2020-02-26,https://www.nichols.com/
05-May-2021,Bill,00.00,"161,044.83","1,127,313.84",9A52c5D19F0DDaf,5428,William,Glenn,Robertson-Strickland,Coreyton,Antigua and Barbuda,(841)976-6248,6847345101,jacquelinehogan@sanders.com,2022-03-28,https://hawkins.com/
06-May-2021,Bill,00.00,"112,731.38","1,014,582.46",EBEd3f98C1E1cFa,6917,Bob,Meyer,"Beck, Horne and Oneill",New Annette,Zambia,+1-520-081-3843,9210233722,uho@bryan-zuniga.com,2020-05-25,https://benjamin-webb.org/
06-May-2021,IMPS,00.00,"507,291.23","507,291.23",e8C814720B065b3,5040,Jon,Bradshaw,Mathis-Houston,Alexisstad,Zambia,001-543-454-8025x287,(462)648-9874,zhouse@carter-vaughn.biz,2020-09-16,http://www.kline-buchanan.biz/
06-May-2021,Purchase,"148,284.50",00.00,"655,575.73",AACa6B7562DA780,5642,Stacie,Gibbs,Mcfarland Inc,Buckville,Gibraltar,001-989-335-8076x824,(466)917-6492,meagan71@gutierrez.org,2021-07-22,https://joseph-gordon.com/
06-May-2021,Commission,186.00,00.00,"655,761.73",2EbCB40dc139bd5,800,Daisy,Boyd,"Aguilar, Russell and Chan",New Kerry,Uruguay,525-632-8904,046.350.8557x6944,nunezkristi@yoder-chang.com,2022-02-16,http://pittman.org/
06-May-2021,Bill,61.61,00.00,"655,823.34",0c7cE200C288D83,2174,Sarah,Combs,Mills-Davila,North Teresaburgh,Hungary,309-811-9174x03152,(005)640-0371,riverscarmen@wyatt.com,2020-01-27,http://foley.com/
06-May-2021,RTGS,00.00,"327,911.67","327,911.67",3011adBC97dC143,2338,Angie,Shepherd,Cowan-Bray,Shepardview,Guam,+1-042-073-9603x491,+1-724-276-5178x01645,avilacarolyn@aguirre.com,2020-08-22,http://www.spence-briggs.com/
06-May-2021,RTGS,00.00,"81,977.92","245,933.75",fbDc5F2dEfEaf2A,6688,Steven,Tanner,Snow-Gray,East Tim,Nicaragua,(293)527-7253x73522,001-730-550-4013x05073,unielsen@roth-branch.info,2021-11-05,https://small.info/
06-May-2021,IMPS,"3,525.20",00.00,"249,458.95",d59AfC9b255Aa8b,1672,Adam,Garrison,Clayton Ltd,West Stacie,Bermuda,001-822-021-0681x78994,001-059-304-7143,yhardy@watts-hayes.info,2020-08-10,http://sawyer-booth.com/
06-May-2021,Bill,02.57,00.00,"249,461.52",E8F1FB33Eb5cAfd,4106,Tara,Wyatt,Woods Group,South Leroy,China,001-845-258-1736,(039)106-0839x9049,guerrerowanda@marks-campbell.org,2020-09-24,https://www.blackburn-fry.com/
06-May-2021,Commission,00.00,"31,182.69","218,278.83",A3CAfea45bCC3DE,3498,Preston,Gilbert,"Cordova, Fleming and Noble",Rossfort,Bahamas,998.420.3915,076-083-0059x546,josephdale@vincent.info,2022-01-09,http://www.sosa-lambert.com/
06-May-2021,ATM,122.42,00.00,"218,401.25",d7f810fBDEcED40,3925,Antonio,Arnold,"Gill, Coleman and Hull",Autumnton,Norfolk Island,105.397.7120x149,237.774.6868,yvance@oneal.com,2021-03-01,https://www.tucker-hall.org/
06-May-2021,Commission,"17,402.00",00.00,"235,803.25",9f3793d6cDae5fc,6638,Tyler,Reeves,"Leon, Ayers and Baldwin",Jerryview,Netherlands Antilles,(615)006-4199x002,1440428366,vernonturner@murphy-holt.com,2022-01-24,https://www.faulkner-austin.com/
06-May-2021,Bill,03.60,00.00,"235,806.85",A7734c4626ab39e,9784,Kristen,Clark,"Pierce, Dillon and Rubio",East Clayton,Trinidad and Tobago,191.482.5890x9523,(000)577-1550,drakealexis@yang.com,2021-02-23,http://knight.com/
06-May-2021,Cheque,00.00,"29,475.86","206,330.99",B6a7d1dC7c7Fc4A,1501,Oscar,Dorsey,Jennings Inc,Port Kellie,Kuwait,(119)524-0104x8633,024-317-7794,landrymakayla@moran.com,2020-08-17,https://www.cortez.biz/
06-May-2021,NEFT,"9,740.71",00.00,"216,071.70",bFb2a3Eac67Cfd8,2594,Cassie,Odom,Blevins-Ellis,West Clifford,Gabon,001-866-458-9254,567-880-9357x5681,vparks@hart-gillespie.info,2021-02-06,https://www.landry-perez.com/
06-May-2021,Bill,"703,623.00",00.00,"919,694.70",4d44BEDBE8C8bAe,6921,Patty,Ramirez,Quinn Group,Mcneilborough,Isle of Man,+1-937-639-7652x1822,+1-921-613-9222x84016,kristopherolsen@huynh.com,2020-10-23,https://www.cooper.org/
06-May-2021,Cheque,00.00,"153,282.45","766,412.25",Af1431b64FE4DBF,2527,Riley,Dawson,Melton-Pratt,Jesseland,Puerto Rico,0825578960,294-485-3943x0744,savannah09@trevino.com,2021-04-23,http://www.stokes.com/
06-May-2021,Purchase,00.00,"255,470.75","510,941.50",7bbb0fD595c6B7D,2727,Christina,Miller,Trevino-Novak,Port Tracieshire,Slovenia,001-224-361-6675,155-904-1270x05264,vhoffman@doyle-bowen.net,2020-05-18,http://www.melton.com/
06-May-2021,Purchase,"1,151.09",00.00,"512,092.59",C1B0285B3B8f99e,8896,Tara,Wade,Durham-Fernandez,Wisehaven,Cote d'Ivoire,+1-802-235-3552,(124)555-5289x94265,desireemorales@howell.com,2020-05-07,https://james.com/
06-May-2021,ATM,"12,306.00",00.00,"524,398.59",b556185278eeecC,8637,Gregory,Barron,Lowery and Sons,Langtown,Congo,+1-760-594-8142x3386,675-043-8639x57167,zamorawarren@lawson.info,2021-03-31,http://www.moreno.net/
06-May-2021,Bill,"11,256.00",00.00,"535,654.59",b57bAd8e401a1AF,7907,Terry,Hood,Hardin-Howe,Port Victorside,Somalia,(298)432-4841x57397,846.781.0482,savannah00@lane.biz,2020-07-19,https://lawrence.com/
06-May-2021,RTGS,"29,338.80",00.00,"564,993.39",Eaa1cBbf28eE6bA,9270,Bruce,Christian,Powell and Sons,Clarencehaven,Djibouti,001-816-400-9438x90252,(743)113-1712x5244,oscarperez@cunningham.com,2022-02-21,http://crosby.com/
06-May-2021,Tax,"261,242.00",00.00,"826,235.39",b9bb9B0f559A5F9,8361,Isaac,Boyd,"Novak, Park and Schmidt",Port Tristanshire,Mali,001-794-722-8276x543,429-557-1930,whitakerpatrick@esparza-nielsen.org,2022-04-23,https://www.mcintyre.org/
06-May-2021,Transfer,116.00,00.00,"826,351.39",3BbF8F60ffD27fB,8460,Emma,Fuller,Coleman-Blackburn,West Marilynview,Saint Kitts and Nevis,926.006.7581x92361,363-359-6503x65634,combstamara@wilkinson.biz,2021-09-12,https://www.weaver.biz/
06-May-2021,Cash,00.00,"826,351.39",00.00,cBe96261ea2d5a8,3796,Andre,Sheppard,"Bullock, Proctor and Pittman",Billberg,Samoa,001-319-237-5481x76269,378.162.4411x676,deanna46@fuller.com,2022-01-31,http://boyd.com/
06-May-2021,RTGS,"29,108.70",00.00,"29,108.70",9B4E2D2Ba39466A,4846,Kari,Stevens,Payne-Young,West Sherryfort,Bangladesh,001-978-748-3767x431,089.391.8277,huntvicki@moran-huang.net,2021-08-10,https://www.walter-hogan.com/
06-May-2021,Tax,"27,136.35",00.00,"56,245.05",D6C7b821E9BB7b6,552,Ryan,Schultz,Compton PLC,Geoffreyburgh,Finland,710.466.9878,396-757-7850,maysmandy@roberts.net,2021-02-18,https://www.burnett.com/
06-May-2021,IMPS,01.10,00.00,"56,246.15",DEf3f7De3Ca3Eb8,5492,Victoria,Grimes,Stevenson Ltd,Zimmermanmouth,Chile,001-320-745-1787x2420,281.419.5720,lindalindsey@vang.com,2021-11-06,https://schwartz.com/
06-May-2021,Tax,00.00,"9,374.36","46,871.79",ba2E28951F277dd,130,Kimberly,Gregory,"Ortiz, Cohen and Cross",Jennifermouth,Singapore,+1-088-229-1601x4905,727.071.3692x5483,lacey04@cross.com,2021-10-28,http://www.nguyen-curry.com/
06-May-2021,ATM,42.00,00.00,"46,913.79",Bc9E69ac9CBBDe3,9098,Ricardo,Kent,"Henderson, Franco and Espinoza",East Annebury,Albania,001-226-579-8250,919.158.5333x86876,fisherchristy@conner.com,2020-03-11,http://greer.info/
06-May-2021,Cash,00.00,"15,637.93","31,275.86",c298C3cF7cA2FDD,1073,Frederick,Levy,Mclaughlin PLC,Jeromeborough,United States Virgin Islands,647-387-7923,001-783-604-7317x21588,tinagates@lozano.com,2021-03-24,https://evans-hendrix.com/
06-May-2021,Cash,424.28,00.00,"31,700.14",ad2d9e0D7C5e3D9,1797,Monique,Ramsey,Tyler Ltd,Port Bridgetstad,Taiwan,+1-153-603-3967x23618,3952990473,beltrancandice@estrada.com,2021-08-16,http://www.mercado.com/
06-May-2021,NEFT,208.00,00.00,"31,908.14",4c706C2a7e5eC96,3518,Lisa,Roberts,"Ramsey, Nicholson and Acevedo",West Krystalhaven,Western Sahara,723-876-7992x29877,(858)871-7739x0417,briana60@thornton.com,2020-12-17,https://sanford.com/
07-May-2021,Interest,00.00,"7,977.04","23,931.10",CD9CFBb7D42f172,5695,Bryan,Hood,"Brewer, Gould and Brewer",Terrancemouth,Trinidad and Tobago,358-535-8467x62670,(085)287-6392,igarrison@carpenter.com,2020-12-31,https://wilkinson.com/
07-May-2021,Transfer,"8,754.00",00.00,"32,685.10",C90dfe2E88e36c1,1252,Norma,Valenzuela,Mcfarland PLC,Port Clintonmouth,Ukraine,966-161-8867,888.335.2002x5228,hornjavier@hanson.com,2021-10-25,http://www.hart-whitehead.info/
07-May-2021,Purchase,00.00,"3,631.68","29,053.42",3a46B8Fd3b6aAfC,7657,Stephen,Lara,"Rosales, Summers and Diaz",East Theresamouth,Palau,+1-500-291-7522x264,(417)506-3142x9540,welchdale@henry-kim.com,2021-04-08,http://www.leach-blackburn.biz/
07-May-2021,Transfer,00.00,"5,810.68","23,242.74",cca2E284AcF90d9,7503,Chelsea,Mcguire,"Shah, Mcpherson and Shaw",Dylanhaven,Morocco,001-780-078-8637x7339,692-642-8262x6092,zcaldwell@reeves-sheppard.com,2020-11-30,https://www.english-flowers.net/
08-May-2021,Cheque,00.00,"7,747.58","15,495.16",cec5D53082Ba76C,297,Alyssa,Woodard,Horne-Guerrero,North Jamesside,Panama,+1-371-916-6695x29105,001-344-303-0348,wbuckley@randall.com,2021-10-08,https://chaney.biz/
08-May-2021,Purchase,00.30,00.00,"15,495.46",8E2BA74A98E2f32,7868,Dave,Peck,"Pearson, Garner and Good",West Patriciaton,Micronesia,001-382-859-5941,+1-545-115-9203x38194,dyersandy@baird-odonnell.com,2021-01-30,https://mcneil-webb.com/
08-May-2021,Reversal,00.00,"2,213.64","13,281.82",aaEAbf6C5EC23C2,1811,Gloria,Anthony,Pierce Inc,Soniafort,Barbados,001-209-995-5970x830,601-551-6979x23749,samanthamccall@conley.com,2021-11-09,http://www.reyes.net/
08-May-2021,RTGS,"1,392.70",00.00,"14,674.52",BC2Cb7beCea1c4C,6309,Crystal,Ibarra,"Wade, Coleman and Mercado",Bernardtown,Slovenia,240.482.4361x046,001-028-571-0488x72435,mitchellstuart@manning.org,2021-01-20,http://pierce-young.com/
08-May-2021,Interest,204.20,00.00,"14,878.72",bF4aF7fd5848ECD,2931,Tracy,Lutz,"Gilbert, Chaney and Lucas",Sloanchester,Netherlands,001-319-113-3230,034-119-3146x1862,alison42@mitchell.com,2022-02-13,https://ochoa.com/
08-May-2021,IMPS,"7,694.00",00.00,"22,572.72",17570F9C8DEFf10,4251,Henry,Bradshaw,Ward-Fleming,New Vernonview,Western Sahara,+1-701-837-8006x62643,695.641.5556x727,zavalakirsten@chase.com,2020-03-21,http://www.burch.com/
08-May-2021,Tax,"617,332.00",00.00,"639,904.72",93Dc2FA13F8bab3,149,Casey,Miles,Church-Boyle,Jocelynbury,Italy,(219)384-5940,8480138604,elizabethcopeland@morris-moss.info,2021-09-17,http://bautista.com/
08-May-2021,ATM,00.00,"213,301.57","426,603.15",eec4a2FDAF1acac,6471,Toni,Harrison,"Daugherty, Morris and Cline",Ellisbury,Turkmenistan,+1-259-717-4441x553,+1-210-604-9989,leonfox@haas.com,2021-12-07,https://higgins.com/
08-May-2021,ATM,05.53,00.00,"426,608.68",0bFc01dD78EFa0c,3576,Lance,Collins,Hoover-Moyer,Garzaview,Somalia,001-342-389-5332x6437,(982)425-5098x510,wyatt10@ingram-robles.com,2021-12-19,https://hutchinson.com/
08-May-2021,RTGS,00.00,"60,944.10","365,664.58",ebed34126980Cb7,7339,Frank,Bruce,Nolan-Gallegos,East Kiarahaven,Chile,622.949.5024,713-104-0496x891,johnathan64@bradshaw-nelson.com,2020-02-03,http://quinn-may.info/
08-May-2021,Reversal,"152,780.00",00.00,"518,444.58",EBb3BABAAEdFCeD,4613,Randall,Butler,Contreras Group,Karaborough,Malta,+1-318-333-4453x444,(851)721-5087x050,kelleymatthew@rose.info,2021-01-30,https://www.johnston.biz/
08-May-2021,NEFT,00.00,"51,844.46","466,600.12",14abfB44C5F38DC,3776,Kenneth,Li,Ball LLC,New Clifford,Azerbaijan,001-627-749-7814x8640,+1-695-037-5618x756,isabella25@williamson.net,2020-07-03,http://harding.com/
08-May-2021,NEFT,00.00,"155,533.37","311,066.75",eD1a22e3e4A2fd1,3998,Danny,Roy,"Gallegos, Nichols and Potter",Krystalchester,Fiji,290-528-8242x37712,(355)130-8488x7295,xchen@doyle.com,2021-08-03,http://www.crosby.com/
08-May-2021,Purchase,"1,295,560.20",00.00,"1,606,626.95",4AD96Fc4557BbfA,5784,Frederick,Humphrey,"Hodges, Pope and Myers",Barberside,Saint Pierre and Miquelon,(115)296-5403x9592,+1-737-539-1217x2942,rickey24@caldwell.com,2020-10-24,http://www.willis.biz/
08-May-2021,Tax,00.00,"160,662.70","1,445,964.26",3D8aab00f29d9f0,8565,Rickey,Forbes,Michael-Woodward,Brandtport,Holy See (Vatican City State),430-967-1944x594,946-142-8257,marydavenport@blevins.org,2022-04-18,https://www.orozco-zimmerman.com/
08-May-2021,Miscellaneous,"200,544.70",00.00,"1,646,508.96",DbCdEc4b7aa13e3,7174,Deborah,Bush,Webb LLC,Sweeneychester,Falkland Islands (Malvinas),(716)311-5808,(940)279-7031x73044,gstafford@kline-shepard.com,2020-12-26,http://leon.com/
08-May-2021,Commission,"254,977.40",00.00,"1,901,486.36",8A0bF0cdCD3D5Cf,1123,Pedro,Navarro,Downs Ltd,Port Stanleyland,Sudan,(604)820-0623x253,+1-014-806-0105,shieldsmicheal@cameron.com,2020-09-26,https://www.fields-jones.com/
08-May-2021,Interest,00.00,"316,914.39","1,584,571.97",e15D55C13FAdf5a,5078,Jackie,Wall,Byrd Group,Lake Rose,United States Virgin Islands,+1-252-797-2835,001-119-054-9746,cervantesraven@wallace.com,2020-05-26,https://molina-case.net/
08-May-2021,Miscellaneous,00.00,"264,095.33","1,320,476.64",5fDf2DA29aeaE9b,6889,Julia,Gutierrez,Daniels PLC,West Darrell,Chile,001-495-059-6297,016-551-5111x1936,isabelvelasquez@cunningham.com,2021-12-03,https://rosario-wagner.biz/
08-May-2021,Transfer,05.00,00.00,"1,320,481.64",2F68A4eC5abEDba,7631,Angela,Crawford,Bray-Wells,Chloemouth,Benin,(303)873-3384x0115,+1-224-099-9940x3117,ymarquez@santiago-mayer.com,2021-05-28,http://www.fowler.com/
08-May-2021,Cheque,00.00,"660,240.82","660,240.82",3e0Ae2c4Ba86f6C,4015,Jaclyn,Powell,Forbes-Riddle,Donaldland,Uzbekistan,748-972-7140x8984,(470)673-4372,mary13@gillespie.com,2021-05-14,http://bender-savage.org/
08-May-2021,Commission,283.00,00.00,"660,523.82",D51b40267112fB9,2163,Shaun,Beard,"Carpenter, Reid and Thornton",North Megan,Korea,+1-905-612-0020x639,651-541-2714x76210,alvin02@allison-barker.com,2020-08-15,https://mckenzie-horne.com/
08-May-2021,Interest,"11,300.00",00.00,"671,823.82",35434E2dAfeFfD8,5896,Alex,Hines,Armstrong PLC,Marilynberg,Switzerland,(089)947-8072x9892,141.739.8003,gabrielarivera@lucas-alvarado.com,2020-07-18,https://herrera.com/
08-May-2021,NEFT,00.00,"67,182.38","604,641.44",Cfae4c9BA4B6cE4,5244,Brenda,Snow,Pena and Sons,Lake Nichole,Seychelles,+1-122-890-3560x082,+1-391-160-0651x25965,tromero@odonnell.com,2021-05-03,http://short.info/
09-May-2021,Cash,441.66,00.00,"605,083.10",7Dd9A7e1dbfdBaE,1676,Tom,Galloway,Gill-Mccarthy,Lake Austinstad,Sao Tome and Principe,772-260-6045,114.545.8698x26374,christopher86@suarez-boyle.com,2020-02-09,http://www.figueroa-oneal.com/
09-May-2021,Debit Card,39.20,00.00,"605,122.30",0e5d94FC6778978,1853,Suzanne,Terry,Richmond PLC,South Elainetown,Angola,818.794.0389x82537,6719858432,sherry54@pitts-greer.com,2022-02-04,http://glenn-levine.com/
09-May-2021,Miscellaneous,"3,857.10",00.00,"608,979.40",7f6D17B7e6D2E0C,8817,Zachary,Rhodes,"Mata, Rubio and Buckley",Port Alanburgh,Turks and Caicos Islands,(166)952-8334x8466,328-319-0110x6034,ipeterson@zimmerman-castaneda.com,2021-10-16,http://www.lara.com/
09-May-2021,NEFT,00.00,"67,664.38","541,315.02",5cFFde2c204F3dc,5627,Eileen,Meza,Mullen LLC,Zunigamouth,Grenada,878-972-3110x9952,001-891-826-5756x5881,blackaudrey@nash.org,2021-06-29,https://www.callahan.biz/
09-May-2021,RTGS,418.09,00.00,"541,733.11",E8d513c581d99Ce,472,Amber,Andrade,Mueller LLC,East Kayla,Bolivia,001-139-457-7156,001-714-719-8135x8601,watsonandres@clarke.com,2020-02-17,http://rasmussen-davenport.com/
09-May-2021,Bill,00.00,"108,346.62","433,386.49",b0Ed3bb9ACbfCC0,2941,Lindsay,Hendricks,Wiggins-Shea,East Annette,Haiti,(378)228-2412x81618,618.652.4679x8151,collincase@santos.info,2021-05-02,http://www.bright.com/
09-May-2021,Cash,34.00,00.00,"433,420.49",84E08Bcb69D0CF0,4386,Stephen,Tucker,Christian Ltd,North Kent,Jersey,001-964-055-1729,408-325-3039x797,umoreno@wilkerson.com,2022-03-28,http://www.shepherd.org/
09-May-2021,RTGS,00.00,"43,342.05","390,078.44",3c8D0CbDaD16ecA,8143,Julia,Stone,Solis Group,North Tasha,Netherlands Antilles,(777)954-3562x282,001-446-852-9763x120,chelsey56@cisneros.biz,2022-02-14,http://mcclain.com/
09-May-2021,Reversal,"4,041.90",00.00,"394,120.34",73BE2CC9f75d6fA,4650,Ashlee,Mullins,"Wells, Hudson and Zamora",Suarezborough,Eritrea,+1-744-275-1867,+1-080-808-8605x5676,lberg@bell.biz,2021-12-24,https://www.hampton-wise.com/
09-May-2021,Commission,47.00,00.00,"394,167.34",D969608d1E23cFC,9863,Lee,Glass,Boone-Lutz,West Judith,Norfolk Island,589.891.7260,5408259593,andradeglen@stephens.com,2021-09-02,https://www.aguilar.com/
09-May-2021,Miscellaneous,00.00,"131,389.11","262,778.23",A6f77F0De5a6cCB,8376,Cathy,Esparza,Massey and Sons,West Becky,Iceland,(912)501-4734,487-514-7748,audrey61@harper-salinas.biz,2021-04-19,https://harvey.info/
09-May-2021,Miscellaneous,00.00,"43,796.37","218,981.86",31fD3fD08F5947f,652,Ronnie,Burton,Manning-Clarke,Lake Jo,Indonesia,001-541-532-9393x7314,3353807045,misty35@oconnell.com,2020-06-06,https://www.cortez.com/
09-May-2021,Interest,142.85,00.00,"219,124.71",e60f2f0CDFce5CB,2634,Joy,Prince,Potter Ltd,Sheenaberg,Qatar,(649)402-0169,799-284-7002,mejiamia@bridges.com,2020-09-06,http://chaney-hess.com/
09-May-2021,Tax,00.00,"24,347.19","194,777.52",a0Bcd6Bc84eb834,9947,Maria,Mercer,Leblanc-Beard,North Vincenthaven,Marshall Islands,+1-042-805-8353x68690,663.910.1919,kdougherty@alexander.com,2022-04-18,http://www.bartlett.com/
09-May-2021,Cash,00.00,"27,825.36","166,952.16",7A44c27C64Cd3e1,7423,Dale,Rios,Bryan-Wright,Bethburgh,Portugal,242.583.7862x19676,(919)776-1718x8623,karina57@ballard-cowan.com,2021-11-14,https://day.com/
09-May-2021,Transfer,00.00,"41,738.04","125,214.12",5778EEEd2d6f23c,2382,Shelby,Thornton,Mckay Ltd,Lake Zoe,Mauritius,(450)574-4151x9756,8155180567,judithmcgee@farmer.info,2021-08-03,https://sweeney-bender.info/
09-May-2021,ATM,07.00,00.00,"125,221.12",a69b9F07194EeCD,2993,Shelia,Barrett,Stanley-Allison,Port Antoniotown,Belgium,954-465-1896,(410)937-0441x6133,danstone@casey-lewis.com,2020-09-09,http://melendez-bowman.org/
09-May-2021,Transfer,"60,875.66",00.00,"186,096.78",7fD6b78E5647793,3708,Sophia,Parker,"Johnston, Moss and Chase",North Valeriemouth,Estonia,423.574.3684x703,001-678-159-8315,annettebailey@sanders.com,2022-04-19,https://contreras.com/
09-May-2021,IMPS,"1,020.11",00.00,"187,116.89",4e1fcAbF5bFC0ac,4052,Jared,Mckinney,"Gallegos, Munoz and Rivas",Port Kendraville,Kenya,001-976-663-3920,137.700.3011x128,logantaylor@villa.org,2021-01-01,https://www.moss.com/
09-May-2021,NEFT,00.00,"23,389.61","163,727.28",2F93cB2Fe98c5CC,2824,Jackie,Larsen,"Zhang, Wiley and Reeves",Brettfurt,Sweden,715-018-8464,493.903.8174x313,leroy10@riggs.biz,2020-07-28,https://www.wang.com/
09-May-2021,Tax,07.40,00.00,"163,734.68",777ECEe5Bdd83cc,6262,Marc,White,Dillon and Sons,West Fred,Korea,+1-477-355-4936x36844,006-050-8989,phodges@drake.info,2021-08-25,https://beard.info/
09-May-2021,Reversal,00.00,"20,466.84","143,267.84",ef700A2A68A0eD9,8407,Dalton,Good,Conrad-Greene,Estradaberg,Palestinian Territory,5134527179,4480381740,gina37@dorsey.net,2020-12-26,http://reeves-horton.net/
09-May-2021,Tax,00.00,"143,267.84",00.00,d4C587ADAce0B96,9856,Keith,Lester,Fields and Sons,West Robertahaven,Luxembourg,214-263-2194x959,0954162452,choileah@barrera.com,2021-08-13,http://villanueva.info/
09-May-2021,Tax,05.53,00.00,05.53,e15D55C13FAdf5a,5078,Jackie,Wall,Byrd Group,Lake Rose,United States Virgin Islands,+1-252-797-2835,001-119-054-9746,cervantesraven@wallace.com,2020-05-26,https://molina-case.net/
09-May-2021,Tax,00.00,02.77,02.76,98bF938AbFa3Aab,3655,Candace,Gilmore,Esparza Ltd,Terryberg,Wallis and Futuna,2610336041,+1-001-883-0834x2378,elliottmichaela@jones.com,2021-06-03,http://www.delacruz.com/
09-May-2021,IMPS,38.27,00.00,41.03,599cC0d087A5796,9389,Chelsea,Stephenson,"Berg, Allen and Middleton",South Russell,Oman,219.542.2387x564,0042011218,moondarren@carrillo.com,2020-10-31,https://www.mora-wallace.org/
09-May-2021,Interest,00.00,41.03,00.00,1CE0aBbAcA592Cb,4824,Samuel,Navarro,Hodges LLC,Port Nathanielmouth,Bermuda,+1-155-791-1611x37992,(864)967-7206,aguirremelissa@pena.info,2021-12-15,http://www.mcdonald-ford.com/
09-May-2021,Purchase,395.60,00.00,395.60,eEE595E2C3D448e,6869,Ethan,Grimes,"Zhang, Carlson and Collier",New Madison,Hong Kong,(495)499-9824x646,913.404.5985x61726,larataylor@oconnell.org,2022-01-02,http://chambers.biz/
09-May-2021,Debit Card,434.12,00.00,829.72,9F5bbaD5E34FEDf,8242,Kent,Dunn,Owens PLC,South Ashley,Sweden,(432)031-6122x4698,001-052-277-4129x83391,ricardolevy@fuentes.info,2021-06-21,https://www.pierce-shea.com/
09-May-2021,Purchase,02.38,00.00,832.10,3Af7F72CDC1f11C,1134,Heidi,Young,Perez PLC,Lake Eddiebury,United Arab Emirates,568-937-7673x03705,(675)270-0852x09884,judith27@peterson-powers.com,2020-05-14,https://www.contreras-elliott.com/
10-May-2021,Cash,257.10,00.00,"1,089.20",a9F099dfc417cCB,5173,Carl,Dickerson,Gay-Wagner,Phillipschester,Uruguay,001-357-020-6365,(581)935-3323,grace16@english.com,2022-01-18,http://moody-key.info/
10-May-2021,Cash,"2,088,867.75",00.00,"2,089,956.95",FBc4C641B1aa62F,7558,Henry,Ray,Atkins PLC,New Joan,Romania,(695)983-6339,+1-126-120-6006,elizabethtanner@walker.org,2022-05-03,https://www.weiss.org/
10-May-2021,Reversal,52.00,00.00,"2,090,008.95",f2d510Aded02a29,9155,Michaela,Finley,Dorsey Inc,Port Aimee,Guam,001-836-114-5033x2565,773.387.3701x62743,zhoffman@blake.biz,2020-12-01,https://arellano.info/
10-May-2021,Bill,38.40,00.00,"2,090,047.35",fCe7Ef600b7ab06,4189,Arthur,Hartman,Long PLC,Jacksonfurt,Lebanon,(896)579-6572x13914,684-604-1497x35637,dunnjohnny@pearson.com,2021-01-30,http://fitzgerald.info/
10-May-2021,Transfer,00.00,"232,227.48","1,857,819.87",74ff44FDA78e9FE,2379,Rickey,Bradshaw,Turner-Bell,North Jaclyn,Vietnam,001-616-754-8104x119,122.066.2993x46914,philip59@watson-rocha.com,2020-05-28,https://leblanc.com/
10-May-2021,Cash,00.00,"928,909.94","928,909.94",bFBB7FFC70dF0De,4325,Garrett,Rosario,Sims PLC,Lake Chelsey,Haiti,832.823.9270x8547,001-460-490-3222,gcastillo@cherry.com,2021-04-10,https://hernandez-poole.biz/
10-May-2021,NEFT,"105,782.56",00.00,"1,034,692.50",a3AdE5d1fD0ebbb,8212,Wesley,Hebert,Nguyen-Mcgrath,Carolhaven,Namibia,764-200-9500,(303)383-9420,aford@gilbert-mcclain.biz,2021-06-07,http://www.velez.com/
10-May-2021,Transfer,00.00,"129,336.56","905,355.94",e065eBDEc7deF3d,3682,Clinton,Patterson,"Lloyd, Pierce and Valdez",Villanuevaville,Sri Lanka,520.223.3796x03827,861-567-0266,fitzgeraldmitchell@pennington-mcguire.info,2020-11-25,https://villanueva.org/
10-May-2021,Debit Card,00.00,"100,595.10","804,760.84",1f9B6Bc6fcC41bc,2160,Ivan,Gardner,Kennedy-Dalton,Karinamouth,Australia,261.770.3981x49432,(700)151-3217,holmesdakota@compton-rogers.com,2022-01-15,https://www.frazier.com/
10-May-2021,Bill,"14,854.70",00.00,"819,615.54",500aec857FFc945,5980,Stephen,Riley,Shepard Ltd,Port Katrina,Niue,+1-511-202-6207,925.348.2300,qbarr@landry.biz,2020-09-07,https://www.humphrey.com/
10-May-2021,Purchase,00.00,"409,807.77","409,807.77",6dc7EFb1dAe7FFe,9710,Harry,Harrell,Morales and Sons,New Beth,South Georgia and the South Sandwich Islands,001-915-276-9165x3636,001-218-858-7497x4051,hinesgwendolyn@combs.org,2021-01-30,http://www.villanueva-duncan.net/
10-May-2021,Miscellaneous,00.00,"136,602.59","273,205.18",b7CC9cA6676F4Ac,109,Jasmine,Ryan,"Fritz, Haynes and Burgess",Victoriaburgh,Poland,499.825.4529x5083,+1-043-610-8679x8549,swarren@buck-roach.com,2020-06-24,https://frederick.com/
10-May-2021,ATM,00.00,"91,068.39","182,136.79",b2AcD3fF071C6cb,5472,Mercedes,Hammond,Mullen and Sons,Normanborough,Antarctica (the territory South of 60 deg S),001-142-185-2595,(767)898-5137x7028,galvanandrea@hester-rojas.org,2022-03-21,https://pearson.com/
10-May-2021,Commission,00.00,"22,767.10","159,369.69",b094EEd228bAD85,3715,Micheal,Miranda,Compton LLC,Port Rickymouth,Turks and Caicos Islands,010-598-4440x80897,0240387775,isaac79@levy.com,2021-09-18,http://www.molina.com/
10-May-2021,Purchase,03.59,00.00,"159,373.28",4cdE1c880EF03Cd,6962,Angela,Thompson,Levine PLC,Lake Peter,Equatorial Guinea,(979)524-6033x295,729.847.7763x452,zoe67@arellano-stokes.com,2021-04-24,http://webb.info/
10-May-2021,Transfer,00.00,"15,937.33","143,435.95",fB94F534E2daBa9,9094,Herbert,Douglas,Durham-Todd,Valerieville,British Indian Ocean Territory (Chagos Archipelago),036-689-1544x980,+1-349-078-8510x85905,mitchell97@dennis.com,2020-11-27,https://villarreal.com/
10-May-2021,Tax,"77,732.00",00.00,"221,167.95",7C8b54b0bEC3A0d,8454,Kristine,Cabrera,Davis Inc,New Gracefort,Andorra,005.358.5484,(888)445-7752x784,wulatasha@dodson-ingram.com,2020-01-08,https://www.brandt.com/
10-May-2021,Interest,00.00,"36,861.33","184,306.62",ED8eCEc7C236d2f,5616,Roberto,Robertson,Whitney LLC,North Caitlin,Angola,001-264-235-1187x81651,+1-100-045-8840x2196,pachecojenna@adkins.biz,2020-11-23,http://bennett.com/
10-May-2021,Commission,"2,813.00",00.00,"187,119.62",9ACDAbEa46b9cBB,339,Carmen,Walsh,"Johnston, Love and Garrett",Audreymouth,Bermuda,662.852.8673x238,217-498-5903,bradleysophia@burnett.com,2020-05-11,https://www.barajas.com/
10-May-2021,Bill,00.00,"20,791.07","166,328.55",CbBa29a3331f6FA,9707,Gabriella,Hayes,"Erickson, Richard and Hughes",Port Sylvia,Estonia,413.972.1346,002.271.8559,udavies@gallegos.biz,2021-11-10,http://rollins-murray.org/
10-May-2021,Interest,"22,081.88",00.00,"188,410.43",4F7AaD80D78Fe78,7873,Tracie,Sampson,Oconnell-Morse,Wileyfurt,Slovenia,789.936.6553,001-269-103-1458,beanmathew@mccormick.com,2020-05-29,http://www.simon.com/
10-May-2021,Commission,"188,396.34",00.00,"376,806.77",C290F3617E6ff3b,7056,Jeffrey,Peck,"Alvarez, Rice and Abbott",Yorkburgh,Guinea-Bissau,(297)034-3016x625,001-975-280-2924x1655,elizabeth32@rose-bullock.com,2020-12-18,http://chapman.com/
10-May-2021,Purchase,00.72,00.00,"376,807.49",FfDfEcc5FFFdA95,6781,Kenneth,Craig,"Wall, Walter and Page",Port Joel,Morocco,001-089-129-6082x036,+1-547-924-6453x2022,melanie55@kelley.biz,2020-07-05,https://www.escobar.com/
10-May-2021,RTGS,00.00,"62,801.25","314,006.24",e815681eb913Ef5,7332,Shelia,Terry,Briggs Inc,Deckertown,Mauritius,115-529-4046x804,4903074483,herrerajerry@yang.com,2020-03-22,http://washington.com/
10-May-2021,Reversal,990.30,00.00,"314,996.54",42eBBea2a40a4d2,3102,Karina,Hendricks,Pennington LLC,New Anna,Panama,7311959252,(995)275-2720x15149,chavezricky@rivas.com,2021-07-31,http://sims-booth.net/
10-May-2021,RTGS,00.00,"34,999.62","279,996.92",cfab783A5Acb581,698,Clifford,Pittman,"Griffin, Horn and Lin",West Rachael,Vanuatu,(478)680-5605,001-270-411-9104x5202,chase45@woodward.org,2022-04-05,http://www.freeman.net/
10-May-2021,Reversal,00.00,"279,996.92",00.00,0d36A1739B6B148,5915,Sophia,Archer,"Andersen, Bradshaw and Coleman",Williamland,Saint Lucia,+1-110-399-0304x6469,0417597298,anewton@burke.info,2020-11-27,https://hooper-moody.com/
10-May-2021,ATM,404.00,00.00,404.00,a96B128FaD715C7,7851,Jon,Bernard,Gibson PLC,Krystalfort,Jamaica,+1-111-717-4729,001-618-040-4772x96965,iferrell@castaneda.com,2021-09-04,http://www.ibarra.net/
10-May-2021,Debit Card,"10,787.00",00.00,"11,191.00",fbDc5F2dEfEaf2A,6688,Steven,Tanner,Snow-Gray,East Tim,Nicaragua,(293)527-7253x73522,001-730-550-4013x05073,unielsen@roth-branch.info,2021-11-05,https://small.info/
10-May-2021,Commission,"1,053.80",00.00,"12,244.80",e5919db787AECFc,4398,Breanna,Frey,Pollard-Ruiz,Loweryport,Colombia,030.064.6850x599,545-447-1712,april52@martin.com,2020-09-25,http://woodard.com/
10-May-2021,NEFT,00.00,"1,749.26","10,495.54",DeB8cBA865935C8,8664,Mallory,Lloyd,Nixon-Hayes,Derrickborough,Austria,(728)095-5489,628.055.2246,rowen@warner.com,2020-03-21,http://griffin-hansen.biz/
10-May-2021,Tax,00.00,"1,166.17","9,329.37",8a4d8eFE2F552D8,2336,Raven,Peters,Pittman-Ford,Allenfort,Turks and Caicos Islands,001-460-635-8606x35366,+1-164-072-5820,houstonyolanda@aguirre.net,2021-01-17,https://lozano.info/
10-May-2021,Transfer,00.00,"2,332.34","6,997.03",529e2b7ba1586E2,2841,Bob,Mcbride,Estrada-Ho,East Joyce,French Polynesia,1299351014,(526)325-3839x1431,raymondpaige@khan.org,2020-07-08,http://www.massey.com/
10-May-2021,Reversal,00.00,"1,399.41","5,597.62",B9B1A231Ed1a0Cb,831,Jillian,Silva,Hines LLC,Connieborough,Mali,9363852488,(161)123-9238,jcombs@simpson.biz,2022-03-14,https://www.lozano.org/
10-May-2021,IMPS,"8,933.27",00.00,"14,530.89",A0ae6C4182FaDbA,6558,Mason,Little,"Krueger, Holt and Dawson",East Gordon,Andorra,606.819.3447x624,(645)180-8613x20901,elliottrose@lindsey.com,2021-01-19,https://torres.org/
10-May-2021,Purchase,"3,899.88",00.00,"18,430.77",8f5f473c94ac6b9,8458,Sean,Davenport,"Merritt, Maldonado and Haas",Savannahville,Wallis and Futuna,637-809-0621x97089,619-921-8316x1370,gbutler@kennedy-cook.com,2021-03-11,https://ramos-phelps.com/
10-May-2021,IMPS,00.00,"6,143.59","12,287.18",A2f0E2B21C50bDc,1209,Ivan,Beltran,"Vang, Sloan and Harper",North Tim,Sudan,(466)387-6327,+1-610-529-9510,shelly79@rivers-solis.com,2021-09-18,http://freeman-michael.com/
10-May-2021,RTGS,07.92,00.00,"12,295.10",A8c6cEDd0DadbD0,9780,Ebony,Price,"Torres, Clements and Barajas",New Mandyhaven,Iceland,095.917.9700,001-463-948-1097x07942,xstein@parrish-hunter.org,2020-09-18,http://watts-bender.net/
10-May-2021,Reversal,"1,743,372.00",00.00,"1,755,667.10",5fE4Fb23Ccee4BA,8405,Tom,Richard,Holden-Moody,New Oliviaburgh,Palestinian Territory,145.373.0443,001-140-867-8884x26696,wellsadrian@hatfield-hardy.biz,2021-05-08,http://hart.org/
10-May-2021,Miscellaneous,07.66,00.00,"1,755,674.76",ddEe60B8e39AF8d,369,Bill,Hardy,"Mason, Proctor and Freeman",North Jessechester,Fiji,135-097-2385,(754)344-9493,antonio01@schmidt.org,2021-11-19,https://reese.biz/
10-May-2021,Purchase,00.00,"292,612.46","1,463,062.30",FC86a4DE604F44a,2669,Jo,Steele,"Villarreal, Savage and Howe",Riversfort,Korea,001-453-663-2407x8692,(210)594-3594,krausenathan@holden-mason.net,2021-06-21,https://sanchez.com/
10-May-2021,NEFT,00.00,"243,843.72","1,219,218.58",Def85EffBeF0440,7277,Brady,Jenkins,Oconnor-Bowen,Kaiserstad,Thailand,(924)974-8863x4750,9163061906,rangelclaudia@lawrence.com,2020-01-29,http://www.robles-santana.com/
10-May-2021,Miscellaneous,"1,189,479.50",00.00,"2,408,698.08",Fe63CCc92DC0CfA,4134,Christy,Bond,"Mathews, Howard and Cabrera",Hensleyfort,Saint Lucia,(266)351-9916x1501,(526)407-0923x9561,shellywang@sexton.org,2022-04-21,https://www.hopkins-mcfarland.com/
11-May-2021,Interest,00.00,"602,174.52","1,806,523.56",fCA2DadDeA0FdDe,7944,Angie,Stanley,Lucero Ltd,Beckybury,Northern Mariana Islands,611-927-2651x693,+1-204-779-2090x4058,bobchambers@mendoza.com,2020-09-04,https://velazquez.com/
11-May-2021,Cash,"17,638.77",00.00,"1,824,162.33",e4bfFBecC356aB3,3871,Autumn,Andrews,"Morales, Lynch and Duarte",New Kellyton,Singapore,(671)768-1449x860,001-291-456-1297x0744,vburke@gibbs.com,2020-02-10,http://reynolds.info/
11-May-2021,Tax,"3,030.00",00.00,"1,827,192.33",5EDb197afE9965F,98,Paul,Moore,White-George,Marcoburgh,Brazil,(451)968-9182,+1-454-876-8759x02495,spencerbright@powell.biz,2021-12-10,https://wall-reid.com/
11-May-2021,Commission,00.00,"456,798.08","1,370,394.25",EF853Ef4Bb0D531,3375,Suzanne,Forbes,Hensley Ltd,Port Bradytown,France,078.506.4033x332,484.467.5598,simonsophia@mcdonald-ayers.net,2021-09-28,http://pena-clayton.org/
11-May-2021,Debit Card,00.00,"1,370,394.25",00.00,d39c0E1e69aa26f,6156,Howard,Adkins,Hutchinson-Mcclain,Lake Kayla,Bulgaria,001-023-751-4242x4482,+1-910-353-9187x2370,laurieosborn@andersen.com,2020-07-05,http://www.bryan-wiggins.com/
12-May-2021,ATM,"9,279.50",00.00,"9,279.50",e6cAD6A9B817fFA,276,Bianca,Daniel,"Fitzgerald, Gamble and Gill",Pacestad,Botswana,137.435.0489,001-579-069-6112,lawrencehansen@duke.com,2021-03-03,http://www.mueller.biz/
12-May-2021,Cheque,04.00,00.00,"9,283.50",C0a64b1b6ecFC1b,4945,Savannah,Garcia,Sosa Inc,Kendraton,Norway,007-066-9574x8716,655.061.2342x313,darin04@graves.info,2021-11-07,http://www.kent.biz/
12-May-2021,Interest,00.00,"1,856.70","7,426.80",55ccE335EaAD335,2307,Zoe,Walsh,Hughes-Steele,Lake Devin,United States of America,5425875834,+1-293-673-7840x39730,alex34@barajas.com,2021-11-08,http://ramos-chandler.org/
13-May-2021,Cheque,00.00,"3,713.40","3,713.40",31F497BFEdea708,2550,Caroline,Marshall,Pruitt Group,Nathanborough,Afghanistan,272-843-8202,9161091588,tuckerjohn@haley.com,2021-10-18,http://www.conley-hawkins.info/
13-May-2021,Interest,00.00,412.60,"3,300.80",07b84cc0992C54D,3238,Rebecca,Harvey,"Baxter, Navarro and Good",Sallyhaven,Yemen,332.163.1031,360-390-1490x245,steelecurtis@chase-hurley.biz,2020-09-01,https://www.davenport-gonzalez.com/
13-May-2021,Purchase,"1,220,474.75",00.00,"1,223,775.55",9E667AC7abfA2eE,4599,Edwin,Barrera,Stout-Shelton,Mccluremouth,India,666.626.7424x7912,(393)780-3445,curtisnicholson@yates-howard.biz,2020-10-09,http://www.vaughan.com/
13-May-2021,Bill,"123,175.10",00.00,"1,346,950.65",3DaDb9E6Af1afc8,7794,Dawn,Sharp,Ayers Ltd,West Darren,Benin,+1-872-478-4247x65823,929.102.4184x704,ohughes@herrera.com,2021-11-08,https://www.kim-norton.org/
13-May-2021,Transfer,"20,514.00",00.00,"1,367,464.65",364cEF4d6ac96dD,7422,Tonya,Greer,"Gilmore, Berg and Parrish",Cristinaland,Yemen,048.835.2415,974.654.5239x2142,braunholly@sherman-santiago.com,2022-03-26,http://shepard.net/
13-May-2021,Cheque,01.40,00.00,"1,367,466.05",9fb7A55B76aAaEd,1733,Anthony,Mendoza,"Moon, Benitez and Hanna",Mccoytown,Barbados,471.344.9899x828,(182)765-1091,brewerannette@costa-winters.com,2020-03-17,https://www.estes-chapman.com/
13-May-2021,Debit Card,03.77,00.00,"1,367,469.82",9c3B1a6E6FBD635,4066,Vickie,Erickson,Huber LLC,Vaughnville,Puerto Rico,(934)098-1299,+1-915-876-1124,kathrynortega@waller.org,2021-12-19,https://www.castaneda-kramer.com/
13-May-2021,Cheque,04.00,00.00,"1,367,473.82",f0Bbb8AB2Fe288C,8264,Sara,Li,"Higgins, Davis and Hansen",Tashastad,Maldives,389.107.2811x74611,+1-494-454-4203x14985,imarquez@parsons.com,2021-09-03,http://woodard-maxwell.org/
13-May-2021,Debit Card,00.00,"136,747.38","1,230,726.44",1e0a9de3Fc41f4d,1705,Mason,Huynh,"Floyd, Cox and Richard",Port Cameron,Saint Lucia,5894629364,001-449-146-4680x8839,lucas66@mora.com,2022-01-23,http://www.bryan-carson.com/
13-May-2021,Reversal,00.00,"410,242.15","820,484.29",cf8ae6f2F8fb7fE,8935,Cathy,Boyd,Coleman and Sons,Buckleyberg,Haiti,7445930888,001-174-248-2637x6291,teresavillanueva@clements-moon.com,2020-04-24,http://hebert.com/
13-May-2021,Purchase,54.00,00.00,"820,538.29",dAF59610D05C1Bc,4610,Karen,Peterson,Abbott-Cantrell,Dianastad,Niger,444.488.7688x3324,001-798-641-8626x8112,ernestwise@pollard.biz,2022-03-27,http://www.powell-cummings.net/
13-May-2021,IMPS,26.90,00.00,"820,565.19",9adB0599CaeCCDA,4598,Debra,Price,"Lester, Lucero and Alvarez",Lake Colin,Switzerland,001-942-146-6041,(575)263-2838,dominicsimon@villanueva.org,2021-03-10,http://www.rollins.com/
13-May-2021,Miscellaneous,00.00,"91,173.91","729,391.28",Fa094Bf730CdAe4,8712,Raven,Krause,Deleon Inc,South Dominique,Latvia,001-408-146-1021x55726,(756)222-4344,ellenweiss@hester.com,2021-08-19,http://www.douglas-willis.com/
13-May-2021,ATM,00.00,"104,198.75","625,192.53",33e0D2Ae0edf0Fd,2476,Nicole,Horn,Hahn-Garcia,Terrystad,Lesotho,218.694.4628,(002)357-2302,craigaustin@ayers-oneal.org,2020-05-17,https://www.delgado.biz/
13-May-2021,Cash,"5,335.00",00.00,"630,527.53",cfBfDCbDb52efAa,3820,Betty,Moody,Prince-Powell,Caseychester,Fiji,(940)834-5428x44477,(155)569-5841x169,doughertyroberto@davidson.com,2021-04-14,https://malone.com/
13-May-2021,RTGS,498.29,00.00,"631,025.82",8e49493Ebfc4C39,9181,Guy,Warner,"Cantu, Webster and Berger",Erinborough,Philippines,334.323.0900x9139,601-830-4315x054,fvalencia@nixon.biz,2020-09-27,http://www.reynolds.com/
13-May-2021,Interest,00.00,"126,205.16","504,820.66",415EefBAa7ef5E5,4777,Gwendolyn,Bruce,Curtis and Sons,Mcphersonport,India,956-065-2525,724.025.2910,brianho@todd.com,2022-02-13,https://www.flowers.biz/
13-May-2021,Interest,00.40,00.00,"504,821.06",2Fd3d1AFE2FbeE1,7249,Johnny,Gibbs,Mooney PLC,Mcdowellmouth,Sierra Leone,(922)213-0228x3570,001-203-981-3343x3179,careymargaret@logan.com,2021-01-31,https://www.marquez.info/
14-May-2021,Debit Card,00.00,"504,821.06",00.00,30fc7d3Bcb9DBFE,7445,David,Grimes,Avila-Horn,Lake Douglas,Togo,(810)454-3784,7929250218,calvin55@duffy.com,2022-03-26,http://fernandez-keith.com/
14-May-2021,Cheque,"3,481.20",00.00,"3,481.20",F87E67b330836fA,1180,Marcia,Solomon,Giles-Villarreal,Starkchester,Armenia,132.056.4203x5427,430.628.5245x8464,ubolton@avila.com,2021-08-03,http://www.todd.com/
14-May-2021,NEFT,00.00,"1,740.60","1,740.60",EBbC478FdAd2E4d,5142,Kirk,Howard,Nicholson-Rivera,Simsmouth,Syrian Arab Republic,028.551.2010,299-027-3350x0898,bassgeoffrey@todd-haynes.com,2021-09-24,https://cox-phelps.org/
14-May-2021,NEFT,00.00,348.12,"1,392.48",dA3669d0BaD459C,9377,Jade,Beasley,Stafford-Rosario,Bruceburgh,Venezuela,026-852-0074x943,+1-145-399-8308x6996,jprice@dunlap.biz,2021-03-06,https://arias-barry.org/
14-May-2021,Debit Card,06.74,00.00,"1,399.22",5F131a198B25fDD,318,Derek,Soto,"Everett, Moran and Stone",North Gregg,Ireland,248.205.0443,301-878-9007x00289,kyates@holder-coffey.org,2021-03-12,http://guerrero.com/
14-May-2021,Interest,00.00,155.47,"1,243.75",060FeA5fCa3c7f0,530,Nina,Wagner,Small PLC,Port Jesse,Tuvalu,9108772428,741.837.9622,ronnie77@branch.com,2020-06-02,http://everett.com/
14-May-2021,Miscellaneous,00.00,177.68,"1,066.07",368aB1fdA3d02dd,5760,Kathryn,Bonilla,Bray-Cline,Port Susanside,Netherlands Antilles,101.681.5669x98634,001-244-699-1422x3382,plopez@noble.com,2021-10-31,https://villegas.com/
14-May-2021,IMPS,"206,129.10",00.00,"207,195.17",F851BDCafa5dcb1,7695,Candace,Branch,Pennington-Fowler,West Deborahtown,Liechtenstein,084.029.1579x60052,001-025-737-5337x9923,gdiaz@pena.com,2021-02-16,http://www.snow.com/
14-May-2021,Cash,00.00,"103,597.59","103,597.58",EcdF6A25cAdbD64,7388,Mandy,Soto,Carey-Morgan,West Lori,Belgium,001-622-694-2181x120,354.830.4221,dwayne39@bell-stein.biz,2022-02-12,http://www.choi.net/
14-May-2021,IMPS,00.00,"14,799.65","88,797.93",3e751A7A3D70A2b,9692,Emma,Booth,Rivers-Moyer,Lake Tom,Oman,+1-801-357-4774,001-248-857-1395x4891,hlloyd@saunders.com,2021-06-16,https://shepard.com/
14-May-2021,Interest,00.00,"44,398.97","44,398.96",f29Fc9d15317DFd,4736,Jeremy,Mata,King and Sons,North Carolyntown,India,(840)874-8903x79646,(306)794-3966x677,munozbryan@phelps.org,2022-01-08,http://oneal.info/
14-May-2021,Reversal,04.80,00.00,"44,403.76",4956159AB4c07eb,4059,Jeffery,Joyce,Hernandez Group,Gregton,Liberia,001-024-797-3091x7265,397-726-0841x27878,ninavazquez@conway-durham.com,2020-09-13,http://www.kemp.com/
14-May-2021,Miscellaneous,242.19,00.00,"44,645.95",F2E6dB05ACb4e51,4080,Robyn,Randall,"Meadows, Kline and Buckley",East Jesse,Argentina,+1-855-938-4225,991-301-1432x66247,maria83@villanueva-cordova.com,2020-06-11,http://sutton.com/
14-May-2021,Commission,397.10,00.00,"45,043.05",F51A2F1cD722fDA,4671,Shari,Patrick,"Reynolds, Hebert and Wilkinson",Port Amber,Ukraine,001-670-627-4583x887,+1-944-333-1020,karinahuynh@pollard.biz,2020-02-28,https://michael-barber.biz/
14-May-2021,Debit Card,00.00,"4,504.31","40,538.75",e8fC8CC2f02B9aC,3074,Malik,Roth,Alvarado-Young,Dominguezbury,Tonga,+1-484-610-9650x3616,007-366-0489,michellehurst@navarro-barajas.info,2021-01-16,http://www.benjamin.com/
14-May-2021,Debit Card,00.00,"13,512.92","27,025.83",A8cD1D5aFc195Db,6966,Sheryl,Johns,Barber Inc,New Martinbury,Yemen,+1-821-978-7374x074,259.423.4919,christine16@houston.com,2020-10-08,https://vargas.org/
14-May-2021,IMPS,00.00,"13,512.92","13,512.92",1ADFe8Df3CEE0f4,4100,Bianca,Dalton,"Blanchard, Hawkins and Frye",West Lindsey,Rwanda,6811925239,556.340.1059x8902,robertroth@craig.info,2020-06-16,https://www.herrera.info/
14-May-2021,Tax,00.00,"1,501.44","12,011.48",6b6fe9A892930dE,3763,Anne,Morton,Foley Group,South Jonathanfort,Vanuatu,+1-778-203-6196x0422,5379833554,shanegallagher@armstrong.com,2020-05-11,http://fitzgerald.info/
14-May-2021,NEFT,"1,666,856.00",00.00,"1,678,867.48",d53ABB60D6CeafA,1303,Brady,Meyers,Bonilla LLC,Guerreroville,Sri Lanka,001-338-653-8914x59043,+1-953-565-1936x678,jeremiahirwin@pineda.com,2020-09-06,https://gillespie.com/
14-May-2021,Transfer,"20,617.16",00.00,"1,699,484.64",8Eb2A5Ca7deed8A,8953,Laura,Ingram,Duncan Ltd,Lake Sandyborough,Korea,+1-872-486-5978x77870,520-814-8250,sheryl29@hurley-kirby.com,2020-06-13,http://shannon.net/
14-May-2021,Cash,"4,095.70",00.00,"1,703,580.34",C03446cc839bFEe,7023,Melinda,Kelly,Dennis-Richardson,Bergview,Macao,001-134-209-1820x0690,(826)792-6625x2908,ypotter@hobbs.com,2021-12-15,http://www.cline-hall.com/
14-May-2021,Debit Card,"791,915.50",00.00,"2,495,495.84",a89F0cf6EEfd8f4,1799,Dominic,English,"Mcclain, Klein and Chaney",Estradaville,Lesotho,431-046-3807x07034,4515683636,ksimpson@rosales.com,2022-01-27,http://www.rodriguez-reyes.com/
14-May-2021,Reversal,"22,967.20",00.00,"2,518,463.04",5aDcF9C8dbAd83D,7515,Ashley,Tyler,Calhoun Inc,West Corey,Bangladesh,001-950-701-2057x47608,001-350-148-2596x493,paula93@hodges.biz,2020-07-11,https://christensen.com/
14-May-2021,Interest,00.00,"419,743.84","2,098,719.20",bEcb134FeCc4fD5,1548,Kenneth,Harris,Marks-Farmer,Port Brandy,Macedonia,774-937-5625x89638,408-223-4142x1543,blake59@jefferson.com,2022-01-10,https://www.marquez.net/
14-May-2021,Cash,00.00,"699,573.07","1,399,146.13",b95dbCA73Cc3dEe,4753,Katherine,Mccarthy,Logan-Mercado,Molinaville,Cape Verde,197.736.9589,188-493-1831,kerriwerner@nash-curry.com,2020-09-13,http://www.singleton.info/
14-May-2021,Transfer,00.00,"155,460.68","1,243,685.45",974B98de4D1eBE1,3640,Bernard,Riley,Cooper-Larson,Lake Jermaine,Iraq,+1-768-218-7625x150,+1-745-157-2902x818,leroy30@blake.info,2020-09-13,http://www.esparza.info/
14-May-2021,Cheque,00.00,"621,842.73","621,842.72",1bdeAeBc1c98D5F,4094,Alexandria,Herman,Mayo-Sharp,Ashleeville,Turkey,(597)173-9209,(064)364-6593x1034,daniel34@brewer.com,2020-03-03,https://phillips.com/
14-May-2021,Miscellaneous,"367,680.00",00.00,"989,522.72",8B79dF5b2C91Ef8,2868,Henry,Valdez,Scott PLC,Gregville,United Kingdom,(072)411-0588x6943,+1-240-576-5180,lbolton@andersen.net,2020-10-02,https://dudley.com/
14-May-2021,Interest,06.30,00.00,"989,529.02",9AD2bbe6aB814AF,8111,Nicolas,Hicks,"Shaffer, Haynes and Farley",Carmenfort,Italy,640-906-7355,001-862-198-1984,ubaldwin@sosa.com,2021-03-08,http://pierce.net/
14-May-2021,Debit Card,00.00,"141,361.29","848,167.73",A0d0Faa9cAa754C,5645,Bailey,Mckee,Oneal Inc,Lake Jeremiah,Albania,+1-942-770-8497x57825,569.848.2511,willismia@bradford.com,2021-04-13,http://www.bell.com/
14-May-2021,Reversal,00.00,"106,020.97","742,146.76",4Ad6e1bdCFDA8eF,7207,Cody,Grant,"Liu, Moody and Holden",South Calvinland,France,(987)951-7845x11831,(102)126-6688x819,dana13@serrano-bird.com,2020-08-11,http://www.dyer-aguirre.biz/
14-May-2021,Reversal,"3,412.80",00.00,"745,559.56",265C7aeFb7845Ce,6245,Margaret,Wilcox,Massey-Huff,Littleside,Chad,+1-915-667-7360,(227)046-6625x0536,davidblake@delgado.com,2021-05-25,https://trevino.info/
14-May-2021,NEFT,00.00,"248,519.85","497,039.71",b00a5AF2aBcfEdF,7511,Keith,King,"Turner, Huang and Kemp",Alejandrahaven,Northern Mariana Islands,193.825.1497x1650,785.133.6420x088,rbradshaw@edwards.com,2020-08-08,http://rubio.com/
14-May-2021,Bill,107.00,00.00,"497,146.71",e1bF4771028CB13,7047,Bryce,Lara,Carlson and Sons,Bonnieside,Cameroon,(871)437-5366,+1-528-045-7520x5148,gina58@wagner-gomez.com,2020-03-05,http://fox.com/
14-May-2021,Bill,"2,640.73",00.00,"499,787.44",cEa23AFD8fBEF3A,5679,Ross,Frazier,Lowe-Gallegos,Jarvisstad,Bahrain,123-927-3449,356-041-7600x329,shearodney@kirk-holden.com,2021-05-07,https://herrera.com/
14-May-2021,Debit Card,00.00,"249,893.72","249,893.72",addBFAA20bb2800,3296,Kurt,Fitzpatrick,"Schmitt, Wilkerson and Wilson",East Ralphland,Finland,671.575.5388x89273,1724751768,ogarner@stevens.biz,2021-12-03,https://osborne-church.com/
14-May-2021,Cheque,00.00,"35,699.10","214,194.62",e7d9ac4De34fE5E,4420,Sara,Archer,"Calderon, Cross and Estrada",Mckayside,Romania,226-502-1980,001-866-868-2113,anthony47@mcclain.com,2020-04-02,http://fowler-sanford.info/
14-May-2021,Tax,07.10,00.00,"214,201.72",37Cb3Ea3dcaD886,5928,Garrett,Valenzuela,Calderon and Sons,Port Madeline,Antigua and Barbuda,405.444.7509,226.067.5517x3522,albert40@haynes.org,2020-04-29,http://carroll.com/
14-May-2021,IMPS,00.00,"214,201.72",00.00,9D3D8D08178Eff6,4895,Gabriel,Graham,Miller Group,South Mandy,Paraguay,(359)891-8353,(917)349-6502,doughertynicholas@martin.com,2020-02-09,http://www.wilkinson.biz/
14-May-2021,Commission,392.00,00.00,392.00,E8DC7b8046431da,9352,Andrew,Cervantes,"Beltran, Huang and Morris",New Alfred,Haiti,001-101-587-5173x75712,388-348-4237,pcarey@carlson.com,2021-05-04,https://riggs-mejia.com/
14-May-2021,Tax,00.00,49.00,343.00,DA8bBeAEf08Ca22,1199,Donald,Powers,Willis-Clarke,East Devin,Senegal,(315)017-2011x553,6737668705,mckenziecristian@pollard.com,2020-09-29,http://sellers-robertson.biz/
14-May-2021,Reversal,"28,252.30",00.00,"28,595.30",bed9aF4B7e23556,4011,Nicolas,Mccormick,"Giles, Gibbs and Copeland",New Elizabethland,Korea,040.033.6490x7784,260.004.9265x69234,waltonstacey@porter.com,2021-12-16,https://glass.com/
14-May-2021,Bill,00.00,"3,177.26","25,418.04",28fedcB3cF4a7B0,9474,Jean,Allen,"Morrow, Chang and Lam",North Tamaraview,Sao Tome and Principe,124.938.0261,(277)169-9343x7804,alice66@larson.biz,2020-04-26,https://www.campbell.com/
14-May-2021,NEFT,"24,206.69",00.00,"49,624.73",dbfE3e0b7dcC3AE,5313,Kaylee,Sutton,Gillespie Group,West Karl,Benin,+1-952-405-2075,001-231-676-5723,veronica47@glass-stuart.com,2021-12-07,http://mullen.com/
14-May-2021,Miscellaneous,07.50,00.00,"49,632.23",98f69acbfD2cfeE,828,Jill,Price,"Farmer, Mccormick and Stokes",Port Brookeview,Egypt,(437)042-6205x5517,001-549-418-6190,mollyfaulkner@nielsen.biz,2021-06-08,https://marsh-pollard.com/
14-May-2021,Interest,32.00,00.00,"49,664.23",4a7c9a187DaA67f,935,Jose,Estrada,"Lam, Pierce and Thornton",Dorothystad,Guernsey,001-986-055-8091,999.442.9215x34977,eduardoewing@love-callahan.com,2021-03-25,https://wiggins.com/
14-May-2021,Purchase,08.00,00.00,"49,672.23",2c5eBF3da13Ee49,1655,Bob,Oconnell,Mills LLC,North Jordantown,Namibia,(517)321-9679x21611,552.734.8814x704,yreid@salazar.org,2020-05-14,http://www.rollins-mayo.com/
14-May-2021,Interest,"216,983.00",00.00,"266,655.23",6f7daBBB4E77Da5,3587,Sue,Thornton,Macias Ltd,Arianaville,Ghana,328-298-8567x677,3011670823,annette74@howell.com,2021-06-18,https://andrade-baird.net/
14-May-2021,Miscellaneous,"1,375.00",00.00,"268,030.23",8C755a6a73EBa00,4596,Vickie,Cabrera,Bailey and Sons,Port Marilyn,Djibouti,974-215-6764x5821,(107)001-0774,shahdominique@davila.org,2021-08-14,http://cummings-rangel.com/
14-May-2021,Cash,"229,693.10",00.00,"497,723.33",F0E4715A5EFFe79,8046,Tony,Sosa,Lane-Raymond,Davidberg,Denmark,001-518-908-4787x57097,(158)055-3997x5594,benjaminariana@farmer.com,2022-03-29,https://www.hooper-charles.com/
14-May-2021,Miscellaneous,06.00,00.00,"497,729.33",BBfD2d0dE8a7fe9,9079,Sylvia,Maynard,"Garrett, Giles and Townsend",Ellenburgh,United Arab Emirates,093-728-5767x4339,456-425-3027x0379,jackson92@mora.info,2020-11-29,https://www.riley.org/
14-May-2021,RTGS,00.00,"124,432.33","373,297.00",adc8CeDA7BD4A69,1691,Sandy,Stein,Jimenez Ltd,North Jack,Azerbaijan,2578911098,+1-078-045-0018x9559,tim19@daniel.net,2020-10-01,http://www.santos-patrick.com/
14-May-2021,Cheque,00.00,"74,659.40","298,637.60",ac0dE575ceFEcF9,6811,Brandon,Bonilla,"Haley, Marsh and Anderson",North Rogerfort,Liechtenstein,131-188-7387x494,893.815.7424x88218,dominic54@ochoa-harrington.com,2021-08-05,http://www.haas-villa.com/
14-May-2021,Tax,00.00,"99,545.87","199,091.73",eabdaE7F6D21A0B,9201,Janice,Dennis,Delacruz-Rivera,Coryfurt,Chile,+1-186-859-1157,722.423.7168,oscarwalls@luna.info,2020-11-14,https://cuevas.info/
14-May-2021,Cheque,00.00,"19,909.17","179,182.56",f7cD5c6a57e5ADF,6113,Joyce,Holt,Pierce and Sons,Ericborough,Madagascar,490-215-6670x0768,001-370-480-9473x242,tammy11@krueger.com,2021-11-09,http://www.richard-conway.org/
14-May-2021,Cash,00.00,"19,909.17","159,273.39",6b62f128fECfdFC,2048,Gregory,Greer,"Stanton, Foley and Freeman",North Tracey,Kuwait,001-508-010-4129x85155,857.070.1813,norriscolleen@jensen.biz,2022-01-14,http://wilkerson-hess.com/
14-May-2021,IMPS,"79,422.00",00.00,"238,695.39",bF4aF7fd5848ECD,2931,Tracy,Lutz,"Gilbert, Chaney and Lucas",Sloanchester,Netherlands,001-319-113-3230,034-119-3146x1862,alison42@mitchell.com,2022-02-13,https://ochoa.com/
14-May-2021,Debit Card,38.84,00.00,"238,734.23",a4Bca3efd46afD0,7006,Sally,Bowman,"Hensley, Warren and Wolf",Alyssaton,Palau,4088522344,2265543033,gibbsdarius@stanton.net,2020-12-27,https://www.brady-byrd.com/
15-May-2021,Commission,03.90,00.00,"238,738.13",31C64Dc03Bb4FEf,7221,Fred,Benjamin,"Bauer, Cowan and Beltran",Jimmyview,Korea,(074)120-2792x3249,001-477-927-8647x44886,hectoryoder@liu.com,2021-08-29,http://michael-avila.com/
15-May-2021,Commission,40.50,00.00,"238,778.63",dFbdDC22B87A9C1,4313,Jake,Simpson,"Rosales, Mccullough and Abbott",South Arielville,Venezuela,001-301-006-2406x86392,431-174-3435,salasriley@cordova-mcconnell.info,2020-07-12,http://www.mcmillan-rose.biz/
15-May-2021,Bill,00.00,"238,778.63",00.00,DaB6e166432CbF2,6029,Manuel,Rosales,Alvarez-Marshall,New Philip,Liberia,908-231-8124x3692,001-035-745-3117,shawcaleb@huber.net,2021-08-04,http://www.strong.com/
15-May-2021,Transfer,473.70,00.00,473.70,1c6A735B9fbCA0a,1330,Teresa,Boyd,Barajas Group,North Jerryberg,Guadeloupe,001-669-517-2589x2457,001-575-923-1260,pam59@wells.com,2021-01-31,http://proctor.com/
15-May-2021,Interest,00.00,67.67,406.03,E1CFDa0B6f985d2,4844,Jeffery,Barker,Clements Ltd,Darylland,New Caledonia,172.538.0452x5438,(996)005-2380,adriannixon@pena.com,2022-01-15,http://arellano.net/
15-May-2021,Purchase,"109,040.00",00.00,"109,446.03",C5051345aa41B9d,9883,Lonnie,Taylor,Ferguson LLC,Haroldfort,United States Minor Outlying Islands,1789380975,(747)646-6611x8094,victoriaperez@brewer.org,2020-03-07,http://www.floyd.com/
15-May-2021,RTGS,00.00,"54,723.02","54,723.02",F9E517CB088712f,1793,Alice,Hebert,"Floyd, Golden and Bass",South Renee,Costa Rica,298.634.5895,(214)300-1481,sharpperry@west.biz,2021-09-15,http://kemp-craig.biz/
15-May-2021,ATM,05.30,00.00,"54,728.32",FB857e7Ead761Cd,551,Hector,Sloan,Hoffman Group,West Joy,Croatia,001-748-784-1312x97719,050-795-0298x2325,lwhitehead@suarez.com,2020-04-29,http://www.owens.info/
15-May-2021,Commission,00.00,"13,682.08","41,046.24",9b2afcc8F309b28,233,Ashlee,Lamb,Simon-Short,Erinmouth,Lithuania,(279)680-4241,+1-571-875-5898,aserrano@webb.org,2021-03-02,http://gordon.org/
15-May-2021,Commission,00.00,"6,841.04","34,205.20",acEC05AD6670da2,684,Jared,Gibbs,Whitaker PLC,Roblesland,Zambia,001-643-754-2204,928.714.6151x0939,benderangie@cooley.net,2021-11-24,http://www.harvey.com/
15-May-2021,Tax,00.00,"34,205.20",00.00,fC50d4b8745aDfe,3457,Cathy,Gonzales,"Good, Swanson and Mcpherson",West Raymondland,South Africa,681-478-7063x004,541-439-9016x5259,troylowe@taylor.biz,2021-03-13,http://knight-hunt.org/
15-May-2021,Purchase,"10,553.70",00.00,"10,553.70",b2DDFd5Fb7aBAb3,3052,Ariana,Dudley,"Pierce, Blevins and Shea",Duarteland,United States Virgin Islands,001-516-072-2325x760,(600)411-8301x6922,haydentyler@kemp.com,2022-02-07,http://www.herring.com/
15-May-2021,Tax,00.00,"2,638.43","7,915.28",FBEBf1D6e9Bee98,4860,Antonio,Kirk,Gutierrez-Ferguson,West Erikfort,Panama,+1-708-514-8672x95048,001-891-340-1393x176,carmenstrong@landry.org,2021-02-26,http://www.rasmussen-love.com/
15-May-2021,Cash,"475,449.00",00.00,"483,364.28",eeB8832b6477dfB,1839,Darin,Clay,"Gordon, Stanton and Chapman",Anthonyborough,Sierra Leone,434-158-1526x08812,906-726-7936,jeffreydaniel@higgins.com,2021-04-07,http://www.bowers-walter.biz/
15-May-2021,IMPS,"843,260.80",00.00,"1,326,625.08",c7C71FF0b8EEdDf,1157,Edwin,Kerr,"Salazar, Evans and Mccullough",Tranmouth,American Samoa,+1-131-700-9716x77924,936-049-1533,blevinsjerome@peterson-padilla.com,2020-10-26,http://www.haynes-clements.com/
15-May-2021,Debit Card,00.00,"147,402.79","1,179,222.29",968eaaF635127C2,6259,Bruce,Vasquez,Mckinney-Odom,Dannyside,Swaziland,001-296-967-2533,396-032-5446,hcarrillo@rush-lozano.com,2022-05-27,https://vang.com/
15-May-2021,RTGS,07.40,00.00,"1,179,229.69",c7efF8eA329Ad60,4512,Veronica,Ochoa,Sherman Inc,Port Brandi,Libyan Arab Jamahiriya,001-615-714-4681x981,001-959-435-8584,ashlee09@knight.com,2020-11-27,https://www.howell.com/
15-May-2021,NEFT,00.00,"393,076.56","786,153.13",1cE2C6FDDBbaD50,4951,Melody,Huff,"Paul, Mckinney and Macdonald",West Rogerhaven,Morocco,742.901.7887,584-662-0098x4681,grhodes@salas.com,2021-06-08,http://www.jensen.com/
15-May-2021,Commission,"3,585.00",00.00,"789,738.13",E9fD3f3b84EAD56,8895,Valerie,Duke,"Simpson, Bean and Hart",Marioberg,French Southern Territories,211.021.1981x32853,007.715.0372x78316,christine54@higgins.info,2022-01-17,http://day.net/
15-May-2021,NEFT,00.00,"197,434.53","592,303.60",096BEAd75283FDC,7899,Katelyn,Fry,Gibson-Allison,Morseburgh,Ireland,+1-238-310-5770x52572,175.511.9068x746,fduncan@curry.com,2020-12-05,http://romero-buchanan.com/
15-May-2021,Cheque,27.20,00.00,"592,330.80",3b1C52B2Bc21beE,9483,Shelia,Hicks,Montoya Ltd,Port Cathyland,Egypt,2095106725,5077440560,autumn25@manning.com,2020-09-18,http://guerrero.com/
15-May-2021,ATM,00.00,"296,165.40","296,165.40",BAf0b23B79ABFD4,1550,Tammie,Parrish,Bradshaw-Ellis,New Jeff,Sierra Leone,462.665.3624,251.370.7478,gibsonderek@fields.info,2021-09-12,http://jacobs.com/
15-May-2021,Transfer,00.00,"148,082.70","148,082.70",5bC6960fD8ca2FF,6271,Harold,Chavez,Kirk-Winters,South Jeremy,Kazakhstan,7380099118,995-985-4774,dominicholloway@wilkinson.com,2021-01-19,http://flynn-wright.com/
15-May-2021,Purchase,"105,672.06",00.00,"253,754.76",Dbb482f69FB6F0D,3037,Diane,Giles,Taylor Ltd,Frankton,Bosnia and Herzegovina,531-424-1562,(314)116-8228x285,cooleysteve@hubbard-cuevas.biz,2021-03-13,http://brown.com/
15-May-2021,Commission,24.00,00.00,"253,778.76",4bCA062e7863a11,5575,Casey,Castaneda,Miranda-Cunningham,Veronicahaven,Slovenia,(081)198-8907x566,(503)026-3612x834,phyllis30@mcknight.com,2020-01-08,https://www.holder.com/
15-May-2021,Debit Card,00.00,"253,778.76",00.00,082Ee9dc4F8a2C3,9046,Jenny,Nichols,Wood Group,West Emilyburgh,Tunisia,3064300351,0584183756,vfranco@wade.com,2021-12-17,https://www.trujillo-huang.com/
15-May-2021,Reversal,75.10,00.00,75.10,6CcE34D2dFB40E2,9431,Ralph,Waller,Tyler Inc,Sweeneyview,Qatar,407-201-8952x231,(628)017-0588,zvelez@carr.com,2020-07-23,http://www.moreno.com/
15-May-2021,Purchase,480.00,00.00,555.10,CbBc4C1ed7Ae6F6,6772,Collin,Lester,Cameron Group,Dannyport,Jersey,001-754-730-6777x2479,+1-326-332-9874x468,angelingram@snow.org,2022-05-20,http://andrade.com/
15-May-2021,Bill,00.00,138.78,416.33,Bf7cA8C3A47EdDe,7411,Christy,Dalton,Diaz Group,Lake Angelaview,Saint Vincent and the Grenadines,(065)391-0121x4428,2607822974,zclarke@clements.net,2020-02-08,https://www.dodson-woodward.org/
15-May-2021,Tax,00.00,208.17,208.16,10Ed67eBb0edBD2,2589,Ryan,Figueroa,Lang-Whitehead,West Evanbury,Zambia,091-153-8961x028,444-839-5196x646,sampsontodd@rose-mooney.org,2022-04-15,https://www.roberson.com/
15-May-2021,Reversal,00.00,29.74,178.42,5b2987DADEDCEcc,6376,Gabrielle,Stewart,"Lawrence, Case and Stone",New Markland,Mozambique,7857465578,+1-323-593-5733x474,sherryhubbard@lyons-bruce.com,2020-11-30,http://www.navarro.com/
15-May-2021,IMPS,00.00,29.74,148.68,7cF3fA9AdFcde2c,6760,Allison,Atkinson,Adkins Ltd,East Terriland,Christmas Island,(958)827-1468x209,(456)003-6382x6288,brandon82@hernandez.com,2020-08-18,http://acosta.com/
15-May-2021,Transfer,"1,219,646.20",00.00,"1,219,794.88",929685f77ecba7c,2481,Jenna,Maldonado,"Sandoval, Orozco and Hines",East Wyatt,Mozambique,0989799734,(474)377-8546x7640,dmckenzie@wood.com,2020-04-06,http://www.barr.com/
15-May-2021,Bill,51.00,00.00,"1,219,845.88",025143EB93d38DB,946,Kaylee,Brown,Cisneros-Castro,South Valeriemouth,Bahrain,234-954-9658,588.647.2134x26745,zgordon@jarvis.org,2022-03-05,https://copeland.info/
15-May-2021,Interest,00.00,"135,538.43","1,084,307.45",908aCB2ACee5B20,2989,Tammie,Bowers,"Melton, Petty and Archer",North Mackenzietown,Martinique,423-743-0682x9685,(385)963-4728x4571,wyatt84@dougherty-hays.info,2021-07-21,http://www.hendricks-martin.com/
15-May-2021,Reversal,29.42,00.00,"1,084,336.87",5bbB2caA615b33c,2250,Earl,Oconnor,Krueger and Sons,Port Donald,Iraq,001-048-723-5763x010,(676)301-3438x84807,arielschroeder@heath.com,2021-11-29,https://pennington-miller.com/
15-May-2021,Cheque,00.00,"1,084,336.87",00.00,89adEe03fBdCe2b,5039,Kelly,Romero,Vega-Hayes,North Shannonside,Zimbabwe,+1-872-424-0701,001-491-901-1829x0683,snyderblake@jackson.biz,2021-10-16,https://farmer-lowe.com/
15-May-2021,Purchase,"2,222.70",00.00,"2,222.70",5Da583a3aA4aCBA,2348,Timothy,Lowery,Simpson-King,Cookland,Canada,001-075-643-4986x728,072.214.8315,ellen38@rush.com,2021-03-05,https://www.avila.com/
16-May-2021,Bill,00.00,317.53,"1,905.17",6bE41F7aC3AEcDa,8064,Holly,Avery,"Moyer, Donaldson and Vincent",Dukefurt,Antarctica (the territory South of 60 deg S),(918)569-3321x4425,609.956.9824x1465,pbass@li.com,2021-07-15,http://franklin.org/
16-May-2021,Tax,"31,150.00",00.00,"33,055.17",56CBAE374fF1Fe2,6434,Derek,Navarro,"Benitez, Kim and Harvey",East Eileenview,United Kingdom,001-961-776-3313x384,(679)572-7705x9537,tpham@downs.com,2020-08-21,http://bullock.net/
16-May-2021,Purchase,00.00,"33,055.17",00.00,f597c947aBAA2F9,7424,Hunter,Hinton,"Galloway, Hancock and Davila",Tapiaton,Taiwan,+1-596-344-7702x7655,430.404.9490,owensbethany@mercer-browning.net,2021-02-19,http://www.barber.net/
16-May-2021,ATM,150.60,00.00,150.60,8df0bc36DdEd85B,5657,Brianna,Garza,Oneal-Cohen,Burnsland,Fiji,(138)958-9282x703,+1-782-139-6618x1151,uhurley@graham.com,2021-03-03,https://www.higgins.org/
16-May-2021,Commission,00.00,50.20,100.40,f8bbb7D9Fa1dA73,2792,Angelica,Adams,Watson Ltd,West Darylburgh,Ecuador,001-926-923-2649,157-018-7616x288,kimberly94@valdez.com,2020-10-12,https://gordon.com/
16-May-2021,Cheque,00.00,10.04,90.36,8ea1450e01bb7D9,6684,Don,Blackburn,Dean-Love,Brandtburgh,Macedonia,+1-695-056-7858,323.638.5423,dmercado@byrd.biz,2022-01-25,https://www.burke-esparza.com/
16-May-2021,Bill,00.00,90.36,00.00,539C67dE0EAF5f3,1679,Eduardo,Singleton,Fox-Guerrero,West Bryanfurt,Chile,(922)548-4683x6622,040-627-0820,caitlyn50@house.com,2021-08-18,http://www.giles.com/
16-May-2021,Transfer,"30,116.30",00.00,"30,116.30",6C4519BbDaDFf0c,2682,Ebony,Kane,Fitzpatrick Inc,South Anthonyburgh,Haiti,(777)868-8026x251,001-990-162-3614x971,nolanneil@adams-newton.com,2021-02-28,https://www.mccormick.com/
16-May-2021,Cheque,00.00,"3,764.54","26,351.76",FbdB4CF8A3D2396,6817,Leslie,Pitts,"Green, Brennan and Coleman",Mariohaven,Tunisia,+1-877-729-1574x52997,001-920-518-7888,kdavidson@baird-schwartz.com,2020-06-12,https://kelley-gill.com/
16-May-2021,Transfer,29.00,00.00,"26,380.76",F4EfCa5f30A68ea,8568,Jon,Sawyer,"Mcdaniel, Wolfe and Davies",East Jillside,India,796-609-4150,318.508.5635,tina66@campos-haney.net,2021-11-29,http://reed.info/
16-May-2021,Cheque,02.23,00.00,"26,382.99",de56A3cDCeb803A,9520,Tabitha,Best,Esparza-Hood,Reynoldston,Papua New Guinea,001-457-948-3344,(684)950-1017x231,kingchris@lewis-cordova.biz,2022-05-01,https://www.madden.info/
16-May-2021,Bill,00.00,"3,297.87","23,085.12",8CeaB2697903D9A,6036,Shaun,Alvarado,Villegas and Sons,Geoffreytown,Mayotte,001-449-923-2348x61639,9935465464,lindsayholt@durham-turner.com,2021-07-28,https://www.gonzales.com/
16-May-2021,Cash,00.00,"3,297.87","19,787.25",ABA6f356ebfeAcE,8851,Cathy,Marquez,Reed Ltd,West Connor,Malawi,001-032-736-3590x45349,800-949-3297x81634,paigeward@orozco-francis.com,2021-10-23,http://www.hudson-santiago.com/
16-May-2021,Debit Card,00.00,"19,787.25",00.00,fAc3e7CE2EbceFf,9892,Stephen,Case,"Church, Figueroa and Allen",Rojasville,Cambodia,828-880-9498,(126)657-7691,neilberger@pena-oconnor.org,2021-12-10,https://hancock.org/
16-May-2021,Cash,49.90,00.00,49.90,Dc2B423fc6C8cE7,8089,Rick,Quinn,Fitzpatrick-Lin,Jaymouth,South Georgia and the South Sandwich Islands,9218247163,(429)946-6606x03484,levygary@johnston.com,2020-02-19,https://www.kent-sloan.net/
16-May-2021,IMPS,00.00,49.90,00.00,adda0c4d56eEd0F,286,Kari,Morton,Michael-Sparks,West Greg,Malta,608.128.5858x862,887-141-3625x6271,jaredchase@solis.net,2020-06-27,http://www.mccann.biz/
16-May-2021,Cash,01.00,00.00,01.00,1Eb9FF517FB7eb0,4525,Ivan,Buck,"Pacheco, Carney and Bolton",Colemanside,Serbia,610-388-7384x86233,(208)175-4458x91180,roger06@bullock.com,2021-11-22,https://moran.com/
16-May-2021,Miscellaneous,00.00,00.50,00.50,9B4E2D2Ba39466A,4846,Kari,Stevens,Payne-Young,West Sherryfort,Bangladesh,001-978-748-3767x431,089.391.8277,huntvicki@moran-huang.net,2021-08-10,https://www.walter-hogan.com/
16-May-2021,Bill,00.00,00.17,00.33,f93Da7ABcFf12A5,8172,Samuel,Landry,"Mccormick, Lynch and Herman",Johnstontown,Peru,001-258-006-6179x54396,(158)225-0230x167,xavier88@weiss-newman.com,2021-12-28,http://bryan.biz/
16-May-2021,Commission,"2,275.41",00.00,"2,275.74",eAf3CAFB8b901e9,1437,Ivan,Richard,"Goodman, Byrd and Kelley",Brianbury,United States Minor Outlying Islands,589-709-3105x981,(420)477-4657,strongmicheal@padilla.com,2021-07-23,http://www.bartlett.net/
16-May-2021,RTGS,00.00,252.86,"2,022.88",bA829972bFc6fc9,2345,Lisa,Hines,"Gonzales, Woods and Allen",Lynnshire,Botswana,(602)498-0740,+1-998-036-6127,marshmonica@madden-charles.info,2021-07-19,https://petersen.info/
16-May-2021,RTGS,00.00,"1,011.44","1,011.44",c0ed39AAE9183BB,7857,Natasha,Dunlap,Perez-Sellers,North Wesley,Latvia,(848)258-5771x9153,8602389213,pgrant@briggs.com,2021-04-21,https://www.lewis.com/
16-May-2021,ATM,"1,351,827.00",00.00,"1,352,838.44",d1f6f0B7A48DA89,9398,Roberto,Morse,Vargas-Brown,Norrisborough,Mauritania,5207953813,(007)527-8078x4004,gilbert06@walter.com,2020-09-11,http://hamilton-dean.com/
16-May-2021,NEFT,"252,031.60",00.00,"1,604,870.04",aC3E4d6Ceedca2b,5581,Brenda,Ford,Madden-Livingston,West Raymondmouth,Chad,004-455-0074x784,(930)341-7583,villareginald@taylor.com,2020-02-14,https://boyle.com/
16-May-2021,Miscellaneous,"41,924.09",00.00,"1,646,794.13",5000DEbADEF5F2A,7608,Colton,King,Hoffman-Christensen,Tuckerside,Belarus,+1-245-997-6803x0904,+1-388-951-4260x56589,jbryant@kirk-schmitt.net,2020-07-12,http://mckenzie.net/
16-May-2021,Cash,208.00,00.00,"1,647,002.13",dEbC9Df2BD9675b,282,Desiree,Hopkins,Cruz Inc,Port Phyllisfort,New Caledonia,+1-305-534-9091x92888,001-379-050-0774x53329,pittmansamuel@proctor-gamble.biz,2020-05-27,http://www.edwards-strickland.com/
16-May-2021,NEFT,818.40,00.00,"1,647,820.53",E0297C7fF0cF7Bb,9360,Ashlee,Conrad,"Peterson, Ingram and Thornton",Port Kara,Rwanda,+1-324-706-6932,9937236417,kbraun@brewer.org,2020-12-15,https://www.marks.biz/
16-May-2021,Cheque,00.00,"329,564.11","1,318,256.42",F448FeACfB4f68c,3062,Patrick,Sandoval,Flowers-Lawson,Ethanside,Ecuador,829.705.4630x22545,929.969.7148x399,rhonda73@peterson.biz,2021-11-30,https://garza.com/
16-May-2021,Miscellaneous,51.52,00.00,"1,318,307.94",bAafe856dACBDfA,4086,Frank,Waller,Dudley PLC,South Kristenland,Thailand,8913234157,001-161-221-1305x84614,jody12@armstrong.org,2020-06-02,https://www.george.org/
16-May-2021,RTGS,00.00,"439,435.98","878,871.96",6B9EafEfBB4Bc3F,5058,Clifford,Huerta,"Shannon, Bauer and Chapman",Bradleychester,Georgia,+1-303-592-7312x829,9994159714,rosecaldwell@ball.com,2022-01-19,https://www.beasley.com/
16-May-2021,Tax,00.00,"175,774.39","703,097.57",B7dcD9aFE0FeA41,2062,Kiara,Charles,Long and Sons,Richardfort,Nauru,944.256.0846,(492)273-1599x40679,stephanieedwards@doyle-doyle.org,2020-01-31,http://cowan.org/
16-May-2021,Purchase,00.00,"70,309.76","632,787.81",4244D72Ab6a5c2D,988,Lynn,Booth,Morton-Petty,Geraldtown,Peru,(111)338-4918,3474514709,david48@everett.info,2021-08-29,http://kirk-zhang.com/
16-May-2021,Cash,"736,998.75",00.00,"1,369,786.56",18783Aae33dC6d5,7758,Gilbert,Pace,Hess-Wong,Port Cindy,Niger,+1-584-342-9474x441,(358)257-4130,christie21@jarvis-kirby.com,2020-12-17,https://stein.com/
16-May-2021,Tax,"27,279.07",00.00,"1,397,065.63",944dF00cbD511f6,6074,Guy,Nunez,Graves Inc,Conwayview,Indonesia,001-308-209-5784x774,+1-425-870-0427x191,rgallegos@cain-brooks.net,2020-01-19,https://bolton.net/
16-May-2021,Purchase,"770,364.20",00.00,"2,167,429.83",2360d3b5761E243,4340,Jamie,Mathis,Evans Group,Mosleybury,Norway,121.980.8697,(995)980-2503x48136,juanroy@leblanc-zhang.biz,2021-03-19,http://owens.com/
16-May-2021,Reversal,"6,388.97",00.00,"2,173,818.80",1FF8c39d5cEAC08,8933,Frank,Navarro,Guerra-Holland,Lake Joyce,Uruguay,001-874-168-4505,+1-727-172-1438x927,janice95@bonilla.info,2020-02-05,http://adams-harris.com/
16-May-2021,Debit Card,00.00,"310,545.54","1,863,273.26",e1b5eCa0a12CBAE,2590,Claire,Crosby,Morrow-Baird,Lake Karen,Tajikistan,001-098-251-6810x2990,(519)779-6999x99029,nmoyer@wiggins.com,2020-01-18,https://huff-donaldson.info/
16-May-2021,Transfer,31.88,00.00,"1,863,305.14",4126aEFff163e5c,2236,Elaine,Sparks,Cruz Group,South Alectown,Guernsey,001-219-201-4395x00010,896-082-1038x857,candace32@jensen-bullock.com,2020-12-27,http://rogers.net/
16-May-2021,Miscellaneous,00.00,"931,652.57","931,652.57",EFccAEF5E8cE89d,8328,Rickey,Riley,"Diaz, Pace and Wilcox",Adamsfurt,France,+1-397-487-2507x983,801.561.8222x081,kennethcummings@yoder.com,2020-11-08,http://www.arellano.org/
16-May-2021,NEFT,"1,243,369.00",00.00,"2,175,021.57",fFd6116411d77eF,1635,Ricardo,Kirk,"Underwood, Mendoza and Stephenson",Mccannville,New Zealand,+1-499-734-2552x685,(826)656-4958,jimenezbrad@mcgee.com,2020-08-26,https://www.frye.com/
16-May-2021,Bill,"2,233.09",00.00,"2,177,254.66",1c4C0d0BD6ed5c7,1549,Haley,Hendrix,Hogan-Bass,East Cory,French Guiana,+1-389-414-8203,357-981-4453x86295,orocha@hines.org,2021-10-13,https://richmond-johns.org/
16-May-2021,Cheque,00.00,"725,751.55","1,451,503.11",0A8CDa9FF9DeCEd,3445,Franklin,Hale,"Patton, Walters and Perry",North Darrellport,Gabon,(013)297-9332x3515,+1-013-365-2630x92686,huangjillian@mathis.com,2022-01-17,http://hardin.info/
16-May-2021,ATM,28.10,00.00,"1,451,531.21",A5cc2AaDE3A92fb,5266,Kari,Levine,"Dickerson, Cook and Kelley",East Tom,Turkey,337.642.2902,+1-678-594-8521x06366,erinshannon@vance-kaiser.com,2022-01-29,https://www.burnett-cohen.info/
16-May-2021,Miscellaneous,441.00,00.00,"1,451,972.21",bF3E6c1B3ACfbcb,5427,Kerry,Montes,Newton Ltd,East Mindyport,Oman,001-567-460-6343x910,512-984-3600x0583,stanleyhudson@spence.net,2020-12-13,https://www.beard.org/
16-May-2021,RTGS,00.00,"145,197.22","1,306,774.99",9622EB52Fc3FEbe,2041,Sue,Rodgers,Salinas-Barnes,East Max,Ukraine,001-598-830-7844x42547,+1-603-318-1786x1851,cooksierra@maxwell.net,2020-08-18,https://kerr.info/
16-May-2021,Debit Card,00.00,"261,355.00","1,045,419.99",4f3fDAdCAd0C8e1,3240,Juan,Velasquez,"Cortez, Chen and Meadows",Port Ian,Brazil,+1-165-542-8946x920,057-046-3869x306,clayton13@alvarez.info,2020-10-11,http://www.salas-simmons.net/
16-May-2021,Cash,00.00,"1,045,419.99",00.00,40b6054b6AF1f65,5868,Joseph,Hughes,Wiggins Ltd,Kevinstad,Myanmar,+1-017-852-9854x7783,053-701-5277,lynnhodges@madden.info,2020-06-11,http://logan.info/
16-May-2021,Reversal,"2,634.56",00.00,"2,634.56",65EbC9707a2E4a1,2208,Rick,Mayer,Pierce-Perez,Lake Lynn,Maldives,001-563-077-9293,(566)395-7994x3935,harringtonmarisa@proctor.com,2021-09-20,http://www.sharp-singleton.com/
16-May-2021,Interest,00.00,292.73,"2,341.83",578B08Ff2feeE0e,5281,Brent,Sandoval,"Lowery, Bray and Adkins",Nicoleshire,Cape Verde,423.451.4105,563.848.0492x898,mcdonaldherbert@griffith-castillo.biz,2022-02-13,http://www.murray.com/
16-May-2021,NEFT,54.68,00.00,"2,396.51",BB1c9c1C5ADCc31,9054,Autumn,Oconnor,Holden and Sons,Port Bettyhaven,Mauritius,030.225.3531x74091,321.666.5487,ashley14@frye-meza.com,2020-01-18,http://cooke.com/
16-May-2021,Cheque,"78,641.03",00.00,"81,037.54",c2dc80E576C25F1,1007,Caleb,Davenport,Bowman-Cruz,South Mackenzie,Yemen,9293535586,5350736043,gabrielle64@winters.org,2021-12-21,http://www.fischer-higgins.net/
16-May-2021,NEFT,00.00,"13,506.26","67,531.28",Ab81AbCD48C3ebd,7968,Adam,Thompson,Obrien Ltd,Grantchester,Cuba,001-273-434-5500,097.697.9900x56715,max16@kim.com,2020-01-30,http://larsen.com/
16-May-2021,Interest,00.00,"16,882.82","50,648.46",F91a3190ff778F1,8150,Frances,Ray,Boyd LLC,Chambersshire,Vietnam,502.519.6316x597,(384)443-7156x5635,adrianamarks@mahoney.com,2020-11-01,http://mckinney.com/
16-May-2021,Debit Card,00.00,"6,331.06","44,317.40",aC1570cC6FD5429,853,Joel,Lin,"Hinton, Roth and Rosales",Port Deanberg,Switzerland,001-667-565-4569x424,+1-572-428-2628,kerryobrien@wood.org,2020-06-29,http://www.fry.com/
16-May-2021,Purchase,00.00,"6,331.06","37,986.34",A9bDA2C696C8C1C,1790,Vernon,Gilmore,"Wagner, Briggs and Watts",Port Kaitlinburgh,Malawi,583.153.2719x071,256-050-8318x197,sara83@tran-dorsey.info,2021-04-19,http://www.gould.com/
16-May-2021,Miscellaneous,00.00,"18,993.17","18,993.17",b2DafC2bD849F4b,8130,Marissa,Roberts,"Rivera, Cabrera and Meyer",Shawnburgh,Senegal,+1-984-442-0921x7473,102-340-8844,ebonymathis@small.net,2020-11-18,http://www.fuentes.com/
17-May-2021,ATM,00.00,"3,798.63","15,194.54",2b94E0a823C2FeF,206,Jose,Morse,Ford-Dixon,West Brendan,Chad,849-351-2710x10812,001-684-502-1388,woodsdevin@maldonado.org,2020-05-17,https://www.wheeler-wong.com/
17-May-2021,ATM,00.00,"1,519.45","13,675.09",0c481c7F94a67FC,4327,Candice,Atkinson,Gillespie Group,New Alex,Ghana,435.283.7163x97137,(573)708-3164,durhamrickey@parrish.org,2020-12-26,http://andersen-salazar.info/
17-May-2021,Cash,00.00,"13,675.09",00.00,92aE6a04aA7A906,3762,Marilyn,Blair,Henson-Russell,Moranberg,Mali,+1-174-172-2391,6095577652,kaitlynsimmons@krause.com,2020-09-24,https://long-castillo.com/
17-May-2021,Transfer,855.80,00.00,855.80,FEAb644523069F3,7555,Jaclyn,Lin,Sexton-Valenzuela,West Sharimouth,Uruguay,001-759-920-2951x31287,743-643-5850,freid@sherman.info,2021-11-10,http://keller-tate.com/
17-May-2021,Transfer,00.00,122.26,733.54,4a0bA74e04c8a50,7957,Claudia,Kirk,"Parker, Pacheco and Jenkins",Housemouth,Liberia,123.402.0858,130-327-8681x22519,ctrevino@roach.com,2021-02-27,https://foley.biz/
17-May-2021,Purchase,"14,165.52",00.00,"14,899.06",56C4dDB1EB7c004,2449,Bob,Wilcox,Melton Ltd,North Katie,Sudan,829.002.2276x68795,(591)423-8553,dsimon@mays-harmon.com,2021-01-31,http://www.cummings.com/
17-May-2021,ATM,00.00,"1,862.38","13,036.68",757c5420e96dd59,6046,Loretta,Stewart,"Sheppard, Mccormick and Cortez",Port Austin,French Southern Territories,001-424-076-7760x0918,(503)926-1142,dana89@gregory-little.biz,2022-04-22,http://frederick-mckay.com/
17-May-2021,NEFT,219.07,00.00,"13,255.75",2fCeD13B76f0A61,3306,Dwayne,Castro,Dean-Booth,Lake Stacyfurt,Sao Tome and Principe,(539)548-3488x5246,755-525-4328x1642,ravenbriggs@farmer.com,2021-02-26,https://www.farmer.com/
17-May-2021,Purchase,01.10,00.00,"13,256.85",fEB05baEc5ba41d,27,Emily,Calderon,Todd-Acosta,Lake Sallyport,Cameroon,038.443.6100,618.908.5890,shelley82@jarvis.com,2021-06-17,http://www.larsen.org/
17-May-2021,Transfer,"14,467.60",00.00,"27,724.45",6b50Fd669Ee0eA1,6934,Gabriel,Booth,"Cabrera, Francis and Parrish",East Alejandrofort,Georgia,938.813.4909x42394,001-431-415-6104x136,sonyalyons@branch.org,2020-01-05,https://www.moses.com/
17-May-2021,Tax,97.74,00.00,"27,822.19",B47fFCC5Ab3Af5a,4733,Hector,Benton,Harding Inc,Port Cheryl,Burkina Faso,+1-392-192-3013x3379,+1-449-598-4729x14208,sharon69@reese.com,2021-08-15,http://mckenzie.com/
17-May-2021,Interest,"4,028.00",00.00,"31,850.19",c00E78BA78Ade7A,6223,Angela,Schneider,Madden PLC,Vasquezfort,Armenia,521-209-3743,652.119.4974x69809,harrellcaroline@cortez-espinoza.com,2020-10-31,https://www.jenkins.info/
17-May-2021,RTGS,00.00,"7,962.55","23,887.64",8C6dD4cdEf857A6,9937,Warren,Acevedo,"Williams, Madden and Harrison",Paigefurt,Comoros,(101)737-2884x4231,(084)193-9213,rsmith@donovan-jackson.com,2020-09-07,http://www.lam.net/
18-May-2021,Debit Card,00.00,"2,985.96","20,901.68",Fcc3a8A9b5B4DCe,9866,Angel,Barr,"Lambert, Lam and Kline",Port Kathleenshire,Iraq,060-090-7378,253-864-0712x3537,rossbradley@morrison-gallagher.org,2021-12-13,https://www.mack.com/
18-May-2021,RTGS,00.00,"6,967.23","13,934.45",318C871DC39180F,7149,Kristina,Andrade,Mooney-Braun,South Brandi,Bahamas,001-476-620-0143x943,001-784-479-5295x4030,englishstephanie@cole.info,2020-02-14,http://mercer.org/
18-May-2021,Cheque,"32,707.00",00.00,"46,641.45",79CfcfF6dc68B88,4908,Penny,Olsen,Weaver PLC,East Kristietown,Congo,333.869.4532,122.940.2743x80871,eproctor@abbott.com,2021-02-19,http://campos-mcintosh.com/
18-May-2021,Interest,295.50,00.00,"46,936.95",eb8194eBCd83BAb,393,Becky,Allison,Nunez-White,Juliaberg,Netherlands Antilles,001-471-208-3345x956,485.286.2126x9443,longcindy@wheeler.com,2021-05-24,https://kennedy.org/
18-May-2021,Debit Card,00.00,"23,468.48","23,468.48",Bc7b6f45aAEA6af,537,Caitlin,Bartlett,Patterson-Woodward,Solomonside,Samoa,697.869.8903,001-738-677-6694,ahodge@madden.info,2020-12-25,https://jackson-english.com/
18-May-2021,Purchase,00.00,"7,822.83","15,645.65",01f7Cb51B4aa8bE,7331,Shawna,Winters,Matthews Group,Barkershire,Australia,001-870-372-3317,645.438.8705x8457,fskinner@boyer.info,2021-12-17,https://www.kidd.com/
18-May-2021,Debit Card,00.00,00.00,"15,645.65",fDDF63dd9dAaDff,3737,Luke,Wang,"Travis, Hanson and Harrington",South Rachelburgh,Bhutan,(647)068-3735x023,730-344-1780x05221,stacey84@luna.com,2020-08-15,https://bailey.info/
18-May-2021,Tax,00.00,"2,235.09","13,410.56",97e1CB981A1691C,3249,Robert,Leon,"Riggs, Larson and Rojas",Lake Cassieberg,Iceland,(838)069-6468,782.031.0755,dukeleon@wilkins.com,2021-06-09,https://jacobs-boone.com/
18-May-2021,Transfer,08.50,00.00,"13,419.06",249Fa5FBcaC04bf,8527,Kaylee,Harvey,Payne-Dominguez,West Brittany,Madagascar,115.030.9033x603,(160)939-1663,fritzbrady@evans-barajas.com,2021-07-25,http://www.shannon.info/
18-May-2021,Tax,00.00,"2,236.51","11,182.55",750Aae9D0Dbd0CB,3012,Danielle,Pham,Merritt-Schroeder,Edwinton,Guatemala,001-209-598-6389x472,710.998.8673,tanner87@hale.com,2021-04-27,http://buckley.info/
18-May-2021,Bill,05.29,00.00,"11,187.84",B31c210B2D05ed0,2216,Daisy,Shaw,Castillo Group,Sierraburgh,Qatar,+1-448-681-9378,(056)993-8612x0336,vbates@tate-walls.com,2020-04-13,https://fischer.com/
18-May-2021,Miscellaneous,57.31,00.00,"11,245.15",BDcB6bc99a4d851,3425,Allison,Stein,Mann LLC,Steeleland,Nigeria,879-356-7614x81653,(903)246-7465x3421,jortiz@cain-marshall.biz,2022-04-12,https://www.beck.com/
18-May-2021,NEFT,00.00,"3,748.38","7,496.77",15ffA1e0cC8cAf3,6986,Stephen,Farmer,Woodard-Salas,East Breanna,Saudi Arabia,677.912.7740,(459)762-2207x616,lewisallison@fields.net,2022-02-02,http://www.norris.com/
18-May-2021,Transfer,"4,384.50",00.00,"11,881.27",eb6f0c7dE7B7e7A,5028,Douglas,Lyons,"Cooley, Farrell and Liu",Kathyborough,Guernsey,001-609-324-5800x6101,(798)492-1818x09535,czhang@moreno-luna.info,2022-01-19,http://www.turner.org/
18-May-2021,ATM,00.00,"1,320.14","10,561.13",B1e9adD62E7f8dC,7407,Mason,Lucero,Pennington and Sons,Rhodeshaven,Netherlands,283-253-3270x9619,653.263.9541x1809,kathleen96@sullivan-stevens.net,2021-10-03,https://www.levy.com/
18-May-2021,IMPS,00.00,"3,520.38","7,040.75",A7a0bFDce3DD3ec,8180,Tami,Vang,"Washington, Baker and Fletcher",South Tamaraville,Nigeria,001-476-444-6196x9382,+1-876-960-3706x1242,jaywood@vang.com,2021-10-11,http://www.gonzales.net/
19-May-2021,Cash,02.79,00.00,"7,043.54",0A082ccDCB6ee2E,7727,Kerry,Holland,"Hahn, Navarro and Burns",Aliciamouth,Gabon,346-197-3482x69796,001-339-187-7180x131,jdurham@short.com,2020-02-22,http://caldwell.com/
19-May-2021,Cash,00.00,"7,043.54",00.00,F02b1bB2CEB0F5C,1162,Jose,Costa,Strong-Pierce,West Jeff,Vanuatu,480.463.9446x04739,(288)515-2517x82087,wayne68@wilkins-gould.com,2022-02-17,http://walls-waller.biz/
19-May-2021,RTGS,"15,054.70",00.00,"15,054.70",5fDf2DA29aeaE9b,6889,Julia,Gutierrez,Daniels PLC,West Darrell,Chile,001-495-059-6297,016-551-5111x1936,isabelvelasquez@cunningham.com,2021-12-03,https://rosario-wagner.biz/
20-May-2021,Cash,26.33,00.00,"15,081.03",48eFeDF756DA0D2,9501,Eugene,Mccoy,Humphrey PLC,Barneshaven,Papua New Guinea,570-903-1441,(647)185-8307x943,michael47@wilkerson.com,2020-02-14,https://www.gaines-henson.com/
20-May-2021,IMPS,"3,354.30",00.00,"18,435.33",DbE634fd0B4d8FC,1240,Larry,Sawyer,"Mccall, Padilla and Woodward",Port Carrie,Bulgaria,001-615-631-4552x37599,(353)522-3641x7791,cholder@mccarty.com,2021-08-14,https://burke.com/
20-May-2021,ATM,00.00,"1,843.53","16,591.80",6B9EafEfBB4Bc3F,5058,Clifford,Huerta,"Shannon, Bauer and Chapman",Bradleychester,Georgia,+1-303-592-7312x829,9994159714,rosecaldwell@ball.com,2022-01-19,https://www.beasley.com/
21-May-2021,Debit Card,00.00,"1,659.18","14,932.62",4fb1ff44b8dC5cd,6622,Yvonne,Bryant,Bowen-Maldonado,Mullenmouth,Mauritius,198.338.2994,(477)058-9400,yyates@delacruz.net,2022-05-21,https://mcgee-wall.com/
21-May-2021,Purchase,02.20,00.00,"14,934.82",4C9cb3097B2C1eD,3307,Rodney,Bishop,Mosley-Velez,East Alexandraville,Pakistan,001-468-012-9080,001-135-858-2653,mcfarlandbrady@crosby.com,2020-03-03,http://french.net/
21-May-2021,Reversal,00.00,"3,733.71","11,201.12",BDA897F22d2cDa2,6913,Charles,Ibarra,Carlson PLC,South Tannerberg,Faroe Islands,267-186-8475,8842231926,melinda06@meyer.info,2021-01-10,http://gibson.com/
21-May-2021,RTGS,00.00,"1,600.16","9,600.96",50Eadc900bb0a6A,7238,Bianca,Hays,Serrano Inc,Adrianhaven,Georgia,(578)892-2301,001-930-077-1419,yblackburn@wilkins-travis.com,2021-11-14,https://romero.com/
21-May-2021,Bill,00.00,"1,371.57","8,229.39",C94FffbA5B72344,9396,Francis,Morse,"Briggs, Mercado and Callahan",Port Travischester,Germany,824.599.6723x86192,+1-727-398-7646x7556,tlevine@duran.com,2020-05-14,http://willis.org/
21-May-2021,Reversal,00.00,"1,175.63","7,053.76",7f9C9E79fC2EC4C,5577,Matthew,Booth,"Wilkins, Beasley and Keller",Port Isaiah,Portugal,001-676-490-1595,+1-397-228-7947x113,preeves@noble-schaefer.com,2020-06-08,http://www.vincent.net/
21-May-2021,Cash,00.00,"1,763.44","5,290.32",c44857DcA12cd7C,3380,Glenn,Herring,Mcneil Ltd,Lake Sarah,Kuwait,446.778.8839,520-383-9022x55857,pfaulkner@orozco.com,2020-09-01,https://yang.org/
21-May-2021,Bill,00.00,"1,763.44","3,526.88",AbA8dd430553bF1,1669,Derek,French,Fritz Group,Lake Raymondborough,Botswana,+1-562-498-9218x0652,(125)614-1450x972,williamcline@rowe-bishop.com,2021-10-21,http://www.kirby.com/
21-May-2021,RTGS,"107,357.80",00.00,"110,884.68",C5FbA08308f596b,7982,Melinda,Fields,Vang-Ochoa,Dixonton,Montenegro,034-808-3993x2357,546.919.6522x77779,cody03@webster-vance.com,2021-12-02,https://www.kelly.com/
21-May-2021,Purchase,00.00,"12,320.52","98,564.16",fCcCf0B2bbACEAa,9928,Omar,Sherman,Barajas Group,Haroldfurt,Holy See (Vatican City State),096.367.5827,(724)644-0128x8158,toddvaldez@rush.com,2022-03-13,http://www.steele.com/
21-May-2021,ATM,"1,689.90",00.00,"100,254.06",A1E45be6F37f3e1,7351,Javier,Davila,York-Duran,South Gabriellastad,Guinea,+1-397-864-4290x17232,+1-707-993-5057x06675,fgreene@mayo.com,2022-01-06,http://manning.net/
21-May-2021,Miscellaneous,00.00,"50,127.03","50,127.03",bAF7eba25fFf9d3,7731,Julian,Pace,Pineda Group,North Charles,Falkland Islands (Malvinas),767.295.6618x599,746.459.8105x16356,fordkari@rodgers.com,2021-03-08,https://melendez-blanchard.net/
22-May-2021,Cheque,"3,624.00",00.00,"53,751.03",23af8033Ea28CF8,8546,Sierra,Carter,Sexton Group,Lake Norman,China,304-509-9946,(619)406-0383,vickiefranco@calhoun.info,2020-12-27,https://smith-brennan.com/
22-May-2021,ATM,00.00,"8,958.51","44,792.52",2C8fD3b5b9B9Fa3,8892,Patricia,Byrd,Aguilar-Mckay,New Corey,Monaco,(865)674-4330x677,(879)602-2338,uguerrero@oconnor-hutchinson.biz,2022-01-12,https://bender.org/
22-May-2021,Transfer,06.00,00.00,"44,798.52",B44ec66f4D70d47,8510,Meagan,Whitney,Hunt-Stein,Mccoymouth,Serbia,741.671.9809x6696,001-945-267-5583,dparker@hurley.com,2022-04-06,https://sweeney-barr.biz/
22-May-2021,Miscellaneous,"1,820.70",00.00,"46,619.22",Fa0CeBEac3d3Adb,9737,Jeanette,Mcgrath,Lane Group,Evanland,Tajikistan,(326)945-3917x71218,717.970.2020x82182,stephencohen@murphy.biz,2020-05-23,https://harris-ryan.net/
22-May-2021,Reversal,00.00,"11,654.81","34,964.42",7343664912a4CdC,7214,Kristie,Trevino,"Rodgers, Blackburn and House",Millsberg,Central African Republic,(326)193-5548,(305)343-7390,swashington@barnes-perkins.net,2022-04-27,http://carson.com/
22-May-2021,Commission,00.00,"8,741.11","26,223.32",eEF7ea406d36dbA,2456,Daniel,Love,"Hinton, Caldwell and Gross",Kentton,Puerto Rico,2418308843,344-618-2713,montgomerylacey@gibson-hayden.com,2021-09-03,http://www.vazquez.com/
22-May-2021,RTGS,00.00,"2,622.33","23,600.99",a2E9C0e8e8a23AB,7092,Luis,Jefferson,"Maldonado, Fitzgerald and Hendricks",Cardenasmouth,Tunisia,(004)029-1431,848-223-3075x024,brettmarks@tate.net,2021-10-23,https://hayes-larsen.com/
22-May-2021,Debit Card,00.00,"23,600.99",00.00,Cd1Ecacaf6976d5,6414,Hailey,Carney,Tate-Mooney,Tristanland,Norway,001-847-925-1594x9655,307-422-3807x02295,tommyshelton@potts.org,2022-04-02,https://nielsen.biz/
22-May-2021,ATM,434.05,00.00,434.05,a75Cd6A25aB21A4,9779,Nicolas,Benjamin,Wise Inc,Phyllisside,Montenegro,1294296010,975-224-4884,karicasey@mccarthy-benjamin.net,2021-08-03,https://charles-levine.org/
22-May-2021,Bill,70.01,00.00,504.06,b1477A9cfbc031A,8424,Franklin,Dennis,Gilbert PLC,Atkinsonfurt,Sierra Leone,6347369510,5745852340,debbiebaldwin@james.com,2020-05-08,http://armstrong.com/
22-May-2021,Interest,00.00,252.03,252.03,a2f3DBd4d6143EA,7123,Charlotte,Watkins,"Patterson, Ayala and Lowe",Haydenhaven,Guernsey,001-029-282-8237,+1-934-039-3677x49546,elainecox@lowe.com,2021-09-08,http://www.evans.com/
22-May-2021,Debit Card,00.00,42.01,210.02,5a3Ed08524aA9CA,423,Cole,Byrd,Dillon-Perry,Hansenhaven,Aruba,+1-987-530-4402x2205,958-830-8852x883,obrienisabel@braun.com,2020-02-01,http://hudson.com/
22-May-2021,Cash,"201,562.00",00.00,"201,772.02",74fdd3EFa9976E1,8766,Jay,Collins,"Roman, Watson and Meza",Port Timothyland,United States Minor Outlying Islands,498-452-9681x656,830-877-7308x6308,antonio28@foley.org,2020-01-06,https://gonzalez-bass.net/
22-May-2021,Cheque,00.00,"40,354.40","161,417.62",a3AC64E3e9D9DfF,4948,Frederick,Marks,"Shields, Garcia and Browning",Pennyburgh,Trinidad and Tobago,(283)555-5229,9348738998,ubanks@black.com,2020-11-16,http://www.flowers-sutton.com/
22-May-2021,Miscellaneous,00.00,"20,177.20","141,240.42",8E8D1C0F7B5EaAC,8732,Alec,Guerra,"Shepherd, Rodriguez and Mendoza",Jacquelineberg,Syrian Arab Republic,9161178344,(180)692-7773x12849,cochranjasmin@fuller-mcneil.com,2021-09-20,https://macias-whitaker.com/
22-May-2021,Bill,05.43,00.00,"141,245.85",30D3De9E82eDB6D,8304,Bobby,Maynard,"Howard, Hendricks and Tapia",Elizabethchester,Ecuador,232.183.9588,001-307-590-3776x70863,candicelowery@mills-beltran.info,2022-02-24,https://duran-cantrell.com/
22-May-2021,Bill,00.00,"20,177.98","121,067.87",Aaddb77cDbA6dFf,1026,Parker,Macdonald,Hammond-Schroeder,Taylorport,Gibraltar,+1-768-914-5114,004-831-5646,kylie72@payne.com,2021-10-14,http://rivas.com/
22-May-2021,IMPS,00.00,"17,295.41","103,772.46",d9CdA8A223Bac8A,6643,Jasmine,Warner,Marshall LLC,North Ivanport,Macao,3688676144,001-024-318-0015x65390,audreybird@davis.com,2020-09-14,https://www.buckley-schroeder.com/
22-May-2021,Bill,"230,751.00",00.00,"334,523.46",9e7B6Ebe312D3f5,7951,Denise,Levine,"Mcguire, Berg and Weaver",Claytonfurt,Italy,337.423.4019x9407,9417584561,foleycarla@hill.org,2020-08-21,https://kerr-rodriguez.com/
22-May-2021,Cash,346.90,00.00,"334,870.36",07C3F32D92dE412,1604,Deanna,Mejia,Sheppard-Glass,Collinfurt,Dominica,644-929-5961,001-554-183-6046,gabrielle06@logan.com,2020-02-20,http://pruitt.com/
22-May-2021,ATM,00.00,"66,974.07","267,896.29",c2B4aCe2a0b2F3C,5582,Joy,Levine,Washington Inc,Oliverbury,Puerto Rico,805-359-1808,001-054-788-3116x5619,richsamantha@adkins.com,2020-09-23,https://www.page.com/
22-May-2021,Cash,157.00,00.00,"268,053.29",16F0421Dd94C4fD,1428,Cameron,Meza,Gardner-Bridges,Sawyerside,Brunei Darussalam,659-260-1914x196,+1-598-815-1270x26682,gordonandersen@duarte.com,2022-02-20,http://www.soto.biz/
22-May-2021,Debit Card,06.00,00.00,"268,059.29",dabeFBadD80Eeec,2097,Erik,Hatfield,Frost-Marquez,East Dalton,Guatemala,326.359.9776,+1-731-976-9733,barbarasosa@cain.com,2020-09-24,http://hayes.com/
22-May-2021,ATM,07.00,00.00,"268,066.29",bF4e8A45B33A1fb,6631,Megan,Benitez,"Mccarthy, Chapman and Estrada",Rickybury,Tunisia,(081)008-4992x84631,001-192-048-8872x635,blakegillespie@ashley-mccall.com,2021-07-20,https://www.serrano-perez.com/
22-May-2021,Debit Card,00.00,"53,613.26","214,453.03",CEf8C3D6868E9Cd,6032,Lindsey,Bauer,"Campbell, Rivas and Chan",Angelport,Switzerland,001-936-078-1003x82806,(639)838-3001x7353,davidsondebra@irwin-brady.org,2020-02-18,http://bates.org/
22-May-2021,Cheque,51.00,00.00,"214,504.03",FfBBFd5cFBbdF3A,1641,Tammie,Cunningham,Yu Ltd,North Billville,Peru,+1-726-124-9474x7924,840.027.3793,michaela61@sims-terry.net,2020-04-25,https://hicks.info/
22-May-2021,Tax,"1,096,908.50",00.00,"1,311,412.53",3e61E93EE5BdA6C,5330,Kerry,Giles,Sharp-Salazar,Eddieton,Czech Republic,+1-836-193-5017,106-257-0584x356,alejandroconley@burch.com,2020-12-10,https://barber.com/
22-May-2021,Debit Card,"55,584.53",00.00,"1,366,997.06",aeBC90Ed8FF0773,4477,Rickey,Mack,Combs-Parker,New Elaine,French Guiana,001-857-665-4588x10549,004-154-7377,gallagherdenise@anthony-daniel.com,2022-01-07,http://www.espinoza.com/
22-May-2021,Commission,00.00,"455,665.69","911,331.37",2Dbea9dBC2FE0D3,9209,Luke,Whitaker,Hanson LLC,Carlaport,Venezuela,001-912-230-0189x07363,001-046-870-8180x5047,mariamoreno@flores-thompson.com,2020-07-05,http://weeks.com/
22-May-2021,Cheque,"246,128.20",00.00,"1,157,459.57",85a4a4b4CeAF8B3,7194,Daisy,Chung,"Golden, Ibarra and Mendez",Kurtville,Sierra Leone,001-676-094-1335x407,4225598406,gary95@leach-watkins.com,2020-12-13,http://wolfe.com/
22-May-2021,Miscellaneous,00.00,"385,819.86","771,639.71",2e9d1d7eEeeE705,9984,Kristina,Mcbride,Mosley-Leblanc,Dawsonside,Peru,(978)364-6347x42361,(793)868-2981x26244,barbara02@frey.com,2022-02-13,http://nielsen-durham.org/
22-May-2021,Transfer,42.00,00.00,"771,681.71",07b84cc0992C54D,3238,Rebecca,Harvey,"Baxter, Navarro and Good",Sallyhaven,Yemen,332.163.1031,360-390-1490x245,steelecurtis@chase-hurley.biz,2020-09-01,https://www.davenport-gonzalez.com/
22-May-2021,Transfer,00.19,00.00,"771,681.90",B1e9adD62E7f8dC,7407,Mason,Lucero,Pennington and Sons,Rhodeshaven,Netherlands,283-253-3270x9619,653.263.9541x1809,kathleen96@sullivan-stevens.net,2021-10-03,https://www.levy.com/
22-May-2021,Commission,00.00,"192,920.48","578,761.43",BF2a993e17eda92,4101,Dillon,Gibson,Andersen Ltd,Lake Erin,Mali,+1-584-333-5625,050.827.9926x904,bobby37@juarez-hansen.com,2021-01-13,http://morton.net/
22-May-2021,IMPS,07.60,00.00,"578,769.03",AeB8D236777AFbA,8909,Vicki,Manning,"Stewart, Hurley and Gilmore",Penningtonchester,United Kingdom,(461)625-2889,001-204-079-3794x24434,amckinney@york.com,2021-06-13,http://www.gutierrez.com/
22-May-2021,Cheque,51.00,00.00,"578,820.03",406e575A1ac25b4,2870,Gregg,Patrick,Guerrero-Bowers,Jodiborough,Saint Pierre and Miquelon,+1-106-591-5768,001-285-655-7431x596,faulknerkara@wade.info,2020-07-30,http://eaton-ho.com/
22-May-2021,Miscellaneous,"21,410.94",00.00,"600,230.97",0fdCdc9c49C089A,95,Greg,Cortez,"Barajas, Hale and Ferguson",Knightmouth,Mayotte,579.250.1047,001-620-909-8580x84663,bonillaalex@cervantes.org,2021-03-20,http://www.mayer.com/
22-May-2021,Bill,00.00,"66,692.33","533,538.64",080D6E03aAd45BB,5687,Melissa,Haley,Russell-Burns,Lake Randallshire,Central African Republic,001-211-072-8998x83905,+1-094-777-0081x62910,xashley@hood.com,2021-07-08,http://ford.com/
22-May-2021,NEFT,"2,790.37",00.00,"536,329.01",570A781Bc8631Fb,4408,Sandra,Roman,Reyes LLC,Lake Tracey,Kuwait,350-270-8647,001-308-595-5217,zimmermansue@kennedy-nolan.com,2020-01-23,https://bolton.com/
22-May-2021,IMPS,"1,075.00",00.00,"537,404.01",13B9432bFA84B6b,8701,Tabitha,Steele,Daniels PLC,North Alexandriafort,Faroe Islands,473.609.8772,001-839-526-4457x334,alfred48@rhodes.info,2020-06-17,https://molina.com/
22-May-2021,Cash,"1,999,527.00",00.00,"2,536,931.01",CaeaAC3B3b76b9C,9208,Clifford,Dennis,"Heath, Parrish and Clayton",Lake Karastad,Iraq,946.785.7367x273,159-132-8994,parrishbenjamin@vaughn.net,2020-03-03,https://meyers.org/
22-May-2021,Purchase,19.00,00.00,"2,536,950.01",f3A9a37bD8A7AFA,8366,Anthony,Dominguez,"Blair, Burch and Yates",Samanthaburgh,Kuwait,534-563-8895x05052,001-339-194-7343x5010,alec12@mcneil.com,2021-08-09,http://bender-deleon.net/
22-May-2021,Cash,140.70,00.00,"2,537,090.71",EEBdcedE0C720b1,6593,Kristy,Sexton,"Mora, Davila and Ballard",Lake Rodney,Costa Rica,931-540-6411x2225,571-094-7843,savannahdowns@hood.com,2020-02-03,http://www.reilly.com/
22-May-2021,ATM,"78,762.00",00.00,"2,615,852.71",99e3711ba06B94A,1423,Timothy,Perry,Randall and Sons,Lake Cassandra,Togo,(801)315-8311x6874,685.879.0528x33358,malikbradley@pierce.com,2021-11-05,http://www.stokes-arias.info/
22-May-2021,Purchase,00.00,"1,307,926.36","1,307,926.36",AfCeAc9d8b0fAde,8403,Jacqueline,Howe,May-Booth,South Annette,Iraq,001-422-440-1309x6447,001-555-632-0351x68364,farcher@horton-thompson.com,2020-09-11,http://www.cohen.info/
22-May-2021,Tax,00.00,"163,490.80","1,144,435.57",578bff300a7Db6B,5346,Adam,Neal,Allen Ltd,Port Melanie,Israel,+1-469-898-4348x20145,+1-500-120-3500x041,randolphpaula@richards.com,2022-02-28,http://www.ochoa.com/
22-May-2021,Purchase,"1,582,803.50",00.00,"2,727,239.07",Ac483f4f19F8DF1,8731,Gene,Knapp,"Huff, Valencia and Donaldson",North Karlborough,Cambodia,(563)983-3373,993-838-3787x746,charlotte91@brennan.net,2020-02-04,http://www.bernard-ramsey.com/
22-May-2021,Commission,863.00,00.00,"2,728,102.07",69B1063ca06b2be,871,Jaclyn,Bartlett,Mitchell PLC,New Grace,New Zealand,001-280-762-0724x253,956-355-1203,floyddawn@shields.org,2020-03-27,http://meza-hatfield.com/
22-May-2021,Cheque,00.00,"682,025.52","2,046,076.55",feEb3aF95E4514A,3335,Riley,Cisneros,"Woodward, Fitzpatrick and Spencer",Spencerstad,Canada,+1-286-255-6707x810,3734148497,rbuckley@jackson.com,2020-12-16,https://www.foley-zimmerman.biz/
22-May-2021,Interest,00.00,"2,046,076.55",00.00,e17AB63fd4058C5,8923,Mitchell,Hamilton,Patrick-Guerra,Lake Manuelville,Ecuador,001-223-448-7598,138-322-5803x018,prestonspence@montoya.com,2020-12-24,http://stevens-escobar.biz/
22-May-2021,Interest,"1,771,854.50",00.00,"1,771,854.50",9fCAb51Caf9A4C7,8419,Christopher,Curry,"Allison, Farrell and Weaver",Brettport,Saint Pierre and Miquelon,+1-062-833-9170x77901,315.418.4391,zkidd@jacobson.com,2020-11-15,https://www.frazier-hawkins.com/
22-May-2021,Tax,56.20,00.00,"1,771,910.70",398F72A29BcCF9E,4529,Stacey,Cisneros,Phillips Group,Lake Travistown,Djibouti,088-653-9307,+1-165-973-3688x1931,shari79@peterson.com,2022-05-11,https://mcclure-nelson.biz/
22-May-2021,Miscellaneous,00.00,"442,977.68","1,328,933.02",6AFE9e8b5dCEbA0,114,George,Wiley,"Dillon, Bonilla and Spears",Soniaborough,Venezuela,001-058-121-9076x80580,001-841-168-9150x72755,preston76@house.com,2020-08-07,https://valencia.com/
22-May-2021,IMPS,269.00,00.00,"1,329,202.02",B2ECE6Cc7f2deC0,640,Alan,Villegas,"Alvarado, Kaufman and Lamb",North Ericburgh,Cote d'Ivoire,+1-249-979-3562x95692,+1-618-504-7515x57239,uwebb@carroll.com,2022-05-09,http://yates.com/
22-May-2021,ATM,"123,885.00",00.00,"1,453,087.02",A87ADB9f283fBBC,5774,Sandra,Fitzgerald,Vazquez and Sons,North Carlmouth,Taiwan,(354)535-0766x42008,4789416814,chobbs@richmond.biz,2021-01-29,https://www.ramsey.org/
22-May-2021,ATM,00.00,"484,362.34","968,724.68",CdEba1AA3272cA7,9857,Martha,Harrington,Grimes-Juarez,East Miaburgh,Cocos (Keeling) Islands,934-158-0116x06347,102.279.7915,kristine83@chambers.org,2020-10-08,https://www.giles.info/
22-May-2021,Commission,00.00,"161,454.11","807,270.57",a5b4D563dcddAEa,6430,Isabel,Sheppard,"Walton, Frost and Hunter",Johnathanchester,Burkina Faso,927.933.9786,+1-045-632-6607x733,rickholt@pena.com,2020-08-19,https://www.carlson-moreno.biz/
22-May-2021,Miscellaneous,"50,152.84",00.00,"857,423.41",b95dbCA73Cc3dEe,4753,Katherine,Mccarthy,Logan-Mercado,Molinaville,Cape Verde,197.736.9589,188-493-1831,kerriwerner@nash-curry.com,2020-09-13,http://www.singleton.info/
22-May-2021,RTGS,00.00,"285,807.80","571,615.61",AF64c02A20410f5,1925,Susan,Faulkner,Dillon Ltd,Port Kirstenmouth,Zimbabwe,+1-491-811-4201x4025,(325)759-9729x95975,leroymeyer@beard.com,2021-02-01,http://www.berg.biz/
22-May-2021,Miscellaneous,466.00,00.00,"572,081.61",88F34dAfaAf9C13,9630,Bobby,Thompson,"Potts, Juarez and Gaines",Nancyburgh,Hungary,284.082.9099,7469575996,rosalesjoy@orozco.com,2022-03-18,https://wu.info/
22-May-2021,RTGS,"45,843.80",00.00,"617,925.41",C4EbFcdc2ca405d,7784,Shelby,Martin,Rhodes Inc,Gainesberg,Cote d'Ivoire,+1-290-098-9706x9990,+1-357-341-5510,tvalencia@day-patel.com,2021-10-15,http://graham.com/
22-May-2021,Miscellaneous,00.00,"123,585.08","494,340.33",6f4cc20ddA6B8E2,9473,Adrian,Estes,"Barrett, Brady and Krause",Miamouth,United States of America,001-081-060-8929,379-845-0437x883,adrianawalton@briggs-blackburn.org,2021-08-13,http://www.bradley.biz/
22-May-2021,Cheque,00.00,"494,340.33",00.00,ef2E35aaBbd01D2,2394,John,Hickman,"Hammond, Webster and Stewart",Faithchester,United States of America,+1-384-821-8201,(141)082-0694x4352,ngates@escobar-merritt.com,2021-10-28,https://www.may-owen.net/
22-May-2021,Purchase,03.00,00.00,03.00,8Ab6EaF6ddFaCCD,6281,Eddie,Hebert,Walters and Sons,Warnerland,Ireland,7473596566,4737261333,blogan@blair.com,2020-10-30,https://www.blankenship.net/
23-May-2021,Tax,"26,889.00",00.00,"26,892.00",8C7B9B10C7786Cf,6830,Jeffrey,Melton,"Copeland, Glass and Charles",Rubiotown,Cote d'Ivoire,0457665382,4098098321,durhammarilyn@merritt.com,2021-05-03,https://moran-maldonado.biz/
23-May-2021,ATM,"134,993.59",00.00,"161,885.59",Fa1bf4A5aDb3AE6,9042,Laurie,Blackburn,"Holt, Meyers and Sharp",Beckytown,Argentina,7275517486,230-110-7181x574,chenselena@cochran-fuller.info,2021-03-31,https://washington-brewer.com/
23-May-2021,Transfer,00.00,"32,377.12","129,508.47",1DDD6CabFeBa6E3,3440,Maxwell,Pearson,Hess and Sons,Leeburgh,Palau,782.103.0340x12417,058.991.3605x595,yhodge@holden.com,2021-07-22,http://www.montoya.com/
24-May-2021,Interest,16.70,00.00,"129,525.17",2028eAbCcc10DBC,7071,Wyatt,Long,Bauer-Lane,Schmittfurt,Maldives,709.769.1540x511,530-998-6117x9248,holdendustin@allen.com,2020-12-13,http://blair.com/
24-May-2021,Transfer,07.00,00.00,"129,532.17",74962aB79cCeb5F,2101,Julie,Russell,"Paul, Melendez and Ritter",East Chloe,Ireland,001-673-692-5097x58951,1969950864,robin82@burnett-ware.org,2020-07-27,https://www.shelton-contreras.com/
24-May-2021,Commission,481.80,00.00,"130,013.97",d218F17eEaeB96F,9764,Barry,Bruce,Schaefer-Hanna,Port Tom,Netherlands,+1-698-623-2470,439.017.1855,timchan@mcgee.net,2021-12-20,http://mccullough.com/
24-May-2021,ATM,54.04,00.00,"130,068.01",F6D0f24eaD824aC,2125,Keith,Daniels,"Rice, Woodard and Rich",Lake Ginamouth,Honduras,+1-944-706-9471,927.859.9526x90045,scantrell@mcclain.net,2020-01-27,https://vasquez-friedman.biz/
24-May-2021,ATM,00.00,"13,006.80","117,061.21",5e44E8aB94B3fe7,865,Francis,Collier,Mccullough-Buchanan,West Devonhaven,Benin,952-724-9134x8369,182.228.5375x0121,chadmckay@daniels.com,2022-05-11,http://www.stanton.info/
24-May-2021,Cheque,00.00,"14,632.65","102,428.56",AB0170CBB439bbA,7055,Tom,Little,Castaneda-Torres,Port Dorothymouth,Belgium,014-562-6889,001-021-796-7430x159,micheal76@adams.org,2021-12-01,http://harrell.com/
24-May-2021,RTGS,420.16,00.00,"102,848.72",Fe672df1557D2B8,8208,Shelley,Stokes,Sharp-Carroll,Lake Darylview,New Zealand,099-355-0140x62291,387-614-7887x90503,kendra91@richmond-evans.com,2021-11-15,http://zavala.com/
24-May-2021,Cheque,22.19,00.00,"102,870.91",fe37d03f9802ebc,4341,Debbie,Hoffman,Mclean-Hayden,Villarrealstad,Christmas Island,327-559-1875x91548,944-391-0173,pcampos@spence-johnson.com,2020-10-29,https://kennedy.com/
24-May-2021,Transfer,00.00,"51,435.46","51,435.46",E5c60890A5FDB0B,8737,Adam,Galvan,Shepard PLC,Kaufmanhaven,Poland,766.355.8190x0352,373-648-8009x40076,terrichandler@duke-zimmerman.com,2020-07-28,http://www.hull-stuart.org/
24-May-2021,RTGS,00.00,"7,347.92","44,087.54",6dEDcc5ea39AeDd,4430,Debra,Silva,Murray and Sons,Rachaelport,Zambia,+1-897-414-0996x104,(999)302-4051,katherine35@schroeder.com,2020-03-18,https://www.dougherty.org/
25-May-2021,Reversal,00.00,"5,510.94","38,576.60",147ea12Fbac36F4,5279,Lori,Harding,"Day, Prince and Petersen",Port Glenn,Aruba,(131)893-8633,5215492547,msantos@owens-reid.org,2020-04-25,https://www.phelps-schmitt.com/
25-May-2021,Reversal,03.00,00.00,"38,579.60",fA9E5e13CECd1B1,2592,Gloria,Frank,"Cross, Kirby and Roach",South Ashleeshire,Macedonia,2204058228,001-459-843-5166,krystal05@carlson.info,2022-01-20,https://www.mccullough.biz/
25-May-2021,Commission,00.00,"7,715.92","30,863.68",dd509eaBA3F8089,260,Patrick,Barnett,"Riley, Phelps and Castro",Gabrielleland,Saudi Arabia,486-945-7392x76409,907-200-5367x69663,cassie94@booth.biz,2021-08-12,https://melton.com/
25-May-2021,Bill,00.00,"5,143.95","25,719.73",edfDaE95d451a1B,3606,Paula,Hess,Montoya Group,Port Deanton,Israel,408-671-9078,001-717-478-8847x2483,virginiasilva@willis-cook.biz,2021-11-15,https://rowe-wong.info/
25-May-2021,NEFT,"9,122.00",00.00,"34,841.73",6F2bB1D3c9cb075,5664,Timothy,Fletcher,Carney Inc,Katherinemouth,Slovakia (Slovak Republic),143-468-4947,+1-571-415-5490x0558,gabrielmcmahon@mayer.com,2021-04-30,http://leon.biz/
25-May-2021,Purchase,00.00,"6,968.35","27,873.38",34066E745CEE42c,3529,Yolanda,Friedman,Zhang-Parsons,West Jeanne,Nauru,+1-585-188-7266,(309)158-1416x4299,mcphersontamara@odom.com,2022-01-20,http://vincent.org/
25-May-2021,Reversal,00.00,"6,968.35","20,905.04",07eea61711B52EE,7644,Abigail,Douglas,Evans PLC,Lake Coleview,Madagascar,0397487452,5464484049,cindyfranco@wyatt.com,2021-03-08,https://www.roy-archer.com/
26-May-2021,Cheque,28.50,00.00,"20,933.54",c811AA9e7356884,1596,Ryan,Baldwin,Cortez Inc,Landryside,Tuvalu,486.680.9465x023,6973275695,stacie98@newman.com,2021-12-30,http://duarte.com/
26-May-2021,Cheque,"22,487.00",00.00,"43,420.54",4d46b1FFEE7fB2a,4127,Kelsey,Daugherty,"Mcdowell, Mcdowell and Anderson",Lake Meredith,Ghana,001-693-769-1775x08886,238.668.1358,edwinsutton@lynn.info,2021-09-25,http://www.nolan.org/
26-May-2021,Tax,75.00,00.00,"43,495.54",0Baaeef2A4bAFCc,2064,Christine,Reynolds,Murphy-Hebert,Arellanoburgh,Lao People's Democratic Republic,(579)233-4974x66128,874-948-6778x56390,simonbradley@hodges.com,2020-11-07,http://www.morrison.info/
26-May-2021,Debit Card,00.00,"7,249.26","36,246.28",CfD5ED9Ce8b8777,4382,Jennifer,Marquez,Nicholson-Rowland,Lanceville,Equatorial Guinea,935-496-6952,001-624-704-7014x34974,robersoncurtis@huynh-blankenship.com,2020-01-31,https://www.schneider.com/
27-May-2021,Debit Card,"1,521,771.00",00.00,"1,558,017.28",Ae477E4DE4242Ae,5564,Samuel,Petersen,"Lang, Cardenas and Paul",Lake Kelsey,Belarus,353-801-3661,363.408.0962x18161,jacobsontammy@glenn.net,2021-12-05,https://leonard.net/
27-May-2021,ATM,"161,643.84",00.00,"1,719,661.12",0DdF6Fe25EBb121,3626,Dana,Crane,"Le, Oliver and Hull",Haasfort,Iceland,558.227.9880,(824)406-3128x9078,qwiley@buck.net,2021-10-10,http://delgado-pacheco.com/
27-May-2021,Bill,00.00,"429,915.28","1,289,745.84",9B566d4c28bB6f6,4481,Jenna,Robinson,Pittman and Sons,Shanemouth,Cameroon,(856)018-6782x3115,001-832-327-0136,treed@donovan-knox.com,2021-12-28,https://www.bender.org/
27-May-2021,Reversal,00.00,"1,289,745.84",00.00,8d86ce9eae9Ff74,4785,Kelly,Keith,Wade PLC,Noahton,Heard Island and McDonald Islands,(026)127-4371x160,001-891-571-5511x45466,ncastaneda@townsend.com,2020-02-11,https://patel.net/
27-May-2021,IMPS,"29,558.00",00.00,"29,558.00",e4daDAE10CEc643,9368,Joshua,Navarro,"Williams, Morrow and Murillo",Lake Cory,Brazil,+1-212-221-0688x36053,(448)424-6990x067,carterterry@snow.com,2020-09-17,https://www.johns-arellano.com/
27-May-2021,Tax,00.00,"29,558.00",00.00,A5BC21eAB190AFE,7446,Henry,Miranda,"Cameron, Williamson and Price",Haroldfurt,Macao,+1-456-415-7502x5762,859-412-7415,jvilla@moody.com,2021-06-08,http://www.odom-carlson.info/
27-May-2021,IMPS,"2,225.92",00.00,"2,225.92",fFBcA2113842Ed9,4060,Vicki,Velazquez,Peters-Ballard,Mercedesfurt,Namibia,061-256-5893x17324,4044746427,nporter@ingram.com,2021-03-07,https://mullen-barber.com/
27-May-2021,ATM,00.00,741.97,"1,483.95",1Ee561fc5165E4C,7324,Darren,Vincent,"Heath, Blankenship and Fuentes",Lake Pam,Cuba,001-168-490-1965x38063,4128388068,abigailhubbard@simon.com,2022-01-30,http://rice.net/
27-May-2021,Commission,00.00,148.40,"1,335.56",78Dfc889fA5fd4b,3312,Tara,York,Hoover and Sons,Courtneyside,Jordan,813.443.9372,+1-326-662-5416x209,roweconnor@garza.com,2020-01-22,http://pena-foley.org/
27-May-2021,Debit Card,60.26,00.00,"1,395.82",5a1bCfF2C6Cfc18,3660,Steve,Powell,Noble-May,West Russell,Afghanistan,7532662805,352-654-2536,bushbetty@klein.com,2021-05-19,https://gardner.info/
27-May-2021,Tax,"3,588.90",00.00,"4,984.72",beE9583aeb96e4A,9078,Dennis,Joseph,Morse-Mckee,North Melissa,Paraguay,001-703-594-6539x54244,667-134-1482x899,kendra81@vasquez-jenkins.info,2021-05-16,https://www.cannon.com/
27-May-2021,Bill,00.00,498.47,"4,486.25",3E6a5a626eeb149,5809,Don,Richmond,"Frederick, Brock and Kim",West Elijah,Bhutan,855.943.4820,4065007222,tphillips@carrillo.info,2021-04-23,https://www.glass.org/
27-May-2021,Miscellaneous,"146,765.50",00.00,"151,251.75",C1B0285B3B8f99e,8896,Tara,Wade,Durham-Fernandez,Wisehaven,Cote d'Ivoire,+1-802-235-3552,(124)555-5289x94265,desireemorales@howell.com,2020-05-07,https://james.com/
27-May-2021,NEFT,00.00,"37,812.94","113,438.81",1EBeA37d789b7fa,7113,Cathy,Rivers,Clarke-Trevino,Staceybury,Kiribati,(480)412-0451x7728,353.653.3248,mmoon@washington.com,2022-01-21,https://flowers-rodgers.com/
27-May-2021,Transfer,367.00,00.00,"113,805.81",4c03149fe9e81a0,7999,Randall,Weeks,Carrillo-Hurst,Lake Ernest,Vanuatu,008-682-9292x7238,453.901.7542x8216,yriggs@pugh-larson.com,2020-01-07,https://www.nichols-grant.com/
27-May-2021,Cash,"30,790.00",00.00,"144,595.81",D4D055e7D51Ad8B,6073,Dillon,Petty,"Marquez, Faulkner and Barron",North Yolandaside,San Marino,+1-768-145-1720,8820756899,cochrantracy@wu.net,2020-10-04,https://www.duffy.biz/
27-May-2021,Reversal,00.00,"14,459.58","130,136.23",2E1fDFc73D4B224,8868,Isaiah,Ramirez,"Trujillo, Rios and Browning",Debraland,Latvia,687.801.6794x53241,250-759-6778x94693,chelsey49@dean.info,2020-02-07,https://moon-hensley.com/
27-May-2021,ATM,03.00,00.00,"130,139.23",68b561BEf8D6EF3,9146,Tammy,Kerr,Scott Inc,East Dawnport,Colombia,(990)286-4483x3753,930-610-4706,qstuart@carr.com,2022-02-20,https://lowery.net/
27-May-2021,Cash,00.00,"65,069.62","65,069.62",94fBaEc207eDdfa,3276,Christian,Garza,Palmer PLC,New Chase,Djibouti,+1-245-918-3186x8039,001-637-415-5706,sproctor@le.biz,2022-04-03,https://www.scott-vance.com/
27-May-2021,ATM,00.00,"8,133.70","56,935.92",bbE9C0B6e5ff0DF,2335,Barbara,Booth,Avery LLC,Grimeschester,Slovakia (Slovak Republic),454-651-8146x4008,6558750908,xcobb@trujillo.com,2020-12-08,https://www.cooley-chavez.com/
27-May-2021,Reversal,04.01,00.00,"56,939.93",c45Abdc2C2EeacF,4707,Gavin,Greer,Moran-Morrison,West Joannborough,Grenada,(130)480-4084,+1-757-907-5239x4974,maddenkenneth@andrews.com,2021-09-11,https://www.hodges.com/
27-May-2021,RTGS,00.00,"28,469.97","28,469.96",544Fa7EEdfFa487,7890,Gary,Santana,Pearson PLC,Sawyerview,Somalia,860-815-6862,729-160-8978,beverly42@reyes.info,2021-01-01,http://www.moran.com/
27-May-2021,Commission,00.00,"7,117.49","21,352.47",9Eb9A4D09A5E7Ae,7936,Oscar,Henson,"Jackson, Wilkerson and Morris",Port Tara,Gibraltar,771-918-4317x5497,001-310-937-7474x099,raguilar@friedman.com,2020-07-27,http://bright.com/
27-May-2021,IMPS,00.00,"21,352.47",00.00,93Eb9e9a68e3259,1397,Spencer,Tran,Elliott PLC,East Nicholasmouth,Montserrat,001-266-692-3522,368.981.1019x54415,rhonda25@osborn-cobb.com,2021-05-05,http://www.henry-richards.org/
27-May-2021,Transfer,"1,536,781.00",00.00,"1,536,781.00",4BA72a310B352DC,790,Xavier,May,"Oconnor, Owens and Valdez",Frederickborough,Yemen,+1-951-144-2673,001-714-108-1636x46929,beckglenda@gamble-mccann.com,2021-08-27,https://www.tucker-warner.org/
27-May-2021,Reversal,00.00,"1,536,781.00",00.00,b6f012Ba94fc40A,3793,Stacey,Galloway,"Kelley, Zhang and Fitzpatrick",Martinezburgh,Serbia,438.515.4241,(943)965-2322x999,tami19@bray-calhoun.com,2020-10-16,https://fritz.net/
27-May-2021,Interest,"1,983.00",00.00,"1,983.00",D2F48F2BCD63A28,4050,Eduardo,Hall,"Crane, Atkins and Garrison",Madisonborough,Libyan Arab Jamahiriya,392-169-9100x0979,032.391.1030x371,crogers@humphrey.com,2021-12-06,https://www.rivers-paul.org/
27-May-2021,Tax,"3,440.20",00.00,"5,423.20",57d1A3C52Dc88Ab,8291,Benjamin,Hammond,"Stevenson, Griffin and Osborne",West Jackieside,Niue,432-568-6620x804,1439320764,pmccall@newton.com,2020-06-02,https://skinner-underwood.com/
27-May-2021,Cash,"16,559.00",00.00,"21,982.20",8c1DffF9a631Cdf,866,Johnathan,Ramos,Raymond-Briggs,North Melaniestad,Congo,+1-538-403-4687x0089,(215)672-1531,jmorton@huff.com,2020-02-25,http://parsons.info/
27-May-2021,IMPS,04.30,00.00,"21,986.50",711c51B9cE48f5C,6806,Kiara,Velez,Walter-Mccall,North Trevorhaven,British Indian Ocean Territory (Chagos Archipelago),(537)001-8265,(918)191-2486x703,rollinsjulian@ritter.biz,2022-04-04,http://www.newton-durham.com/
27-May-2021,Cash,00.00,"3,664.42","18,322.08",ACb0e9577288863,4752,Gwendolyn,Brandt,Lutz Ltd,North Bryanview,Estonia,766.910.4760,0123664018,colleencervantes@roberson.com,2020-05-17,http://miranda-patton.com/
27-May-2021,Interest,"96,425.20",00.00,"114,747.28",4fc78eBbE025ffa,4173,Wesley,Reid,Oconnell Group,South Kirstenchester,San Marino,314-973-4524x869,714.305.3778x9175,cassidy32@wells.com,2021-06-02,https://barrera-blair.org/
27-May-2021,Cheque,05.28,00.00,"114,752.56",86Df56BFCc0a7CA,15,Catherine,Blackwell,"Mack, Garcia and Schaefer",Lake Seth,Dominican Republic,001-915-961-8896x5744,(310)185-3032x0974,calhounalisha@hardin.net,2021-03-30,https://barker-bishop.info/
27-May-2021,Bill,"217,070.80",00.00,"331,823.36",e065eBDEc7deF3d,3682,Clinton,Patterson,"Lloyd, Pierce and Valdez",Villanuevaville,Sri Lanka,520.223.3796x03827,861-567-0266,fitzgeraldmitchell@pennington-mcguire.info,2020-11-25,https://villanueva.org/
27-May-2021,Commission,271.90,00.00,"332,095.26",180C3ff1Bfa0ee5,2794,Yolanda,Macias,"Mcfarland, Malone and Huber",West Bradberg,Isle of Man,368.597.3651,550-766-1883,bobbywebster@lyons.org,2020-11-14,https://mathis.net/
27-May-2021,Purchase,"14,051.19",00.00,"346,146.45",Ff9ea1647acFb6B,4567,Jodi,Newton,Kaiser-Dorsey,Angelberg,United States Virgin Islands,832-114-1565x1026,001-951-329-3477,mackenziemcneil@stewart-manning.com,2020-01-23,https://randall.com/
27-May-2021,Transfer,"16,089.00",00.00,"362,235.45",75e1B0ECAD06F60,1216,Karen,Powell,Ballard Inc,Wallschester,Bahrain,(837)887-4976x23484,+1-692-477-5826x6040,nobleharold@lawrence-christensen.com,2021-03-31,https://reese.com/
27-May-2021,NEFT,39.00,00.00,"362,274.45",Bfa3bCc248D4289,1500,Jake,Whitney,Floyd and Sons,New Javier,Brazil,(938)229-2017,(852)721-4601x27340,gouldtroy@shelton-compton.com,2021-01-25,https://wall.com/
27-May-2021,Bill,00.00,"72,454.89","289,819.56",9C6F632d1b8f1dC,752,Nathaniel,Elliott,Rubio Group,Douglashaven,Timor-Leste,456-411-6731x91761,+1-289-220-7244x69050,prestonchambers@higgins.com,2021-05-25,http://larsen-willis.info/
27-May-2021,Commission,00.00,"32,202.17","257,617.39",0DC4332A50d6C6F,2538,Alison,Hoover,Dillon-Decker,Danfurt,Trinidad and Tobago,+1-556-305-5793x738,965.672.7253x736,omar03@castro.com,2020-07-16,https://solomon.info/
27-May-2021,Debit Card,00.00,"85,872.46","171,744.93",bDAFceeAe7c9527,4454,Jamie,Shepard,Ellis PLC,West Lynnborough,Samoa,196.969.9859,151.655.0231,iankaiser@peck.com,2021-08-16,https://www.hood-ho.com/
27-May-2021,RTGS,"1,399.00",00.00,"173,143.93",DBc90a31dc1B95F,9244,Jorge,Buckley,Shields-Sharp,Alejandrafort,Costa Rica,(416)131-8338,403.965.3502x4236,qdoyle@randall-best.com,2021-09-21,https://hodge-mercer.com/
27-May-2021,Cheque,534.10,00.00,"173,678.03",F6De59D2A51BBbE,59,Sarah,Powell,Pearson-Choi,Masseyhaven,Palestinian Territory,586.224.7039,171-888-6974,ivanhiggins@charles-estrada.com,2021-09-30,https://www.mcneil.com/
27-May-2021,Purchase,00.00,"57,892.68","115,785.35",3b1C52B2Bc21beE,9483,Shelia,Hicks,Montoya Ltd,Port Cathyland,Egypt,2095106725,5077440560,autumn25@manning.com,2020-09-18,http://guerrero.com/
27-May-2021,Cash,40.10,00.00,"115,825.45",a46FFff90b0562a,2836,Tammy,Yates,"Higgins, Saunders and Curry",South Guy,Liberia,(483)929-8903x3430,527.306.6413x016,rbarker@mccann.com,2021-04-10,https://burns.org/
27-May-2021,Bill,00.00,"12,869.49","102,955.96",a3d167a14c934e8,3947,Carlos,Cooley,"Larsen, Gallegos and Ray",Keithshire,Cayman Islands,798.718.5041x29254,001-418-828-6953,rossrusso@larson.com,2020-01-20,https://lindsey.com/
27-May-2021,IMPS,00.00,"17,159.33","85,796.63",c45Abdc2C2EeacF,4707,Gavin,Greer,Moran-Morrison,West Joannborough,Grenada,(130)480-4084,+1-757-907-5239x4974,maddenkenneth@andrews.com,2021-09-11,https://www.hodges.com/
27-May-2021,Interest,00.00,"9,532.96","76,263.67",6c01dCb121335Ee,4890,Mindy,Bird,Reid-Velazquez,West Warren,Central African Republic,458.541.6503x464,001-929-658-3215x818,lmitchell@ruiz-hancock.net,2020-03-19,https://floyd-morton.com/
27-May-2021,Bill,00.00,"25,421.22","50,842.45",4f610f6dFaEEc2d,1275,Carl,Bowers,Boyd-Kane,Pedrofort,Macao,+1-179-081-7854x918,4625387594,ethan09@orr.com,2020-05-21,http://watson.org/
27-May-2021,RTGS,"2,920.30",00.00,"53,762.75",Fb24617FaC12275,596,Dakota,Daugherty,Baird and Sons,Alvaradoside,Gambia,001-390-044-6327x0751,544-297-6387x43350,davidmcconnell@wood.info,2022-01-22,http://www.wood-willis.info/
27-May-2021,Debit Card,00.00,"13,440.69","40,322.06",d4B5845ceEBe667,3555,Belinda,Reeves,Bush LLC,West Haileyport,Peru,142.027.4130x31827,001-435-379-6121x58933,sierrameza@terry.com,2021-05-12,http://reid.info/
27-May-2021,Bill,00.00,"40,322.06",00.00,4096c18Ffe12d1f,6977,Tanya,Peters,Brock and Sons,Graceburgh,Korea,+1-907-371-1962x6132,347-011-0000x66073,jillian40@patel-banks.com,2020-06-18,http://suarez.com/
27-May-2021,Purchase,02.60,00.00,02.60,c2B4aCe2a0b2F3C,5582,Joy,Levine,Washington Inc,Oliverbury,Puerto Rico,805-359-1808,001-054-788-3116x5619,richsamantha@adkins.com,2020-09-23,https://www.page.com/
27-May-2021,Debit Card,59.46,00.00,62.06,F488BB88Df10aed,5295,Kristine,Gonzalez,"Schwartz, Fletcher and Mcfarland",Patriciaport,Micronesia,1284670415,963-615-4676x17437,oscar23@zavala.biz,2020-07-02,https://hicks.org/
27-May-2021,Transfer,"146,779.40",00.00,"146,841.46",15Fc31775Fb614A,5565,Cory,Mendoza,Browning-Gibson,Marthafort,Iceland,(556)934-9267,+1-322-219-5806x00975,blakecole@sellers-herrera.org,2021-08-13,https://orr.com/
27-May-2021,Debit Card,00.00,"16,315.72","130,525.74",dc97Fe1ef8a90a9,8357,Gregg,Hernandez,Kelly-Ball,New Corey,United Kingdom,101.699.5567x76230,928-879-0640,julian33@roy.org,2020-05-03,http://velazquez.com/
27-May-2021,Transfer,52.00,00.00,"130,577.74",d7d7CE69fCb6CCE,3458,Veronica,Cortez,"Sampson, Ali and Mcknight",North Ivan,Angola,783.643.0047x9065,(238)046-2450,christinemarsh@kirk.com,2020-02-01,http://bolton.com/
27-May-2021,Cheque,17.00,00.00,"130,594.74",3f50Fe6E4C05edb,2127,Cheryl,Juarez,Marsh-Sims,Davebury,Germany,+1-089-557-1139x93718,727-427-2556x7274,katherinecolon@byrd-hickman.org,2022-02-22,https://gomez-patrick.org/
27-May-2021,Transfer,00.00,"18,656.39","111,938.35",6D5daAA9eCCc0dB,7565,Thomas,Koch,Kemp-Owens,Kelleyside,Tonga,475.793.8024x272,(432)673-9610x88258,simonbailey@escobar.com,2020-07-20,http://www.randall.com/
27-May-2021,Reversal,416.50,00.00,"112,354.85",Aa93B2ef1fdCB80,9754,Martin,Wagner,Mullins-Olsen,Port Tristan,Norfolk Island,(666)360-2604x5646,2686075516,changmark@robertson.info,2022-03-24,http://lynn-beard.net/
27-May-2021,Interest,00.00,"37,451.62","74,903.23",7baBEE7a9B959cA,4962,Corey,Rush,Carr LLC,Lake Terry,Mongolia,+1-991-035-1347x22446,(569)458-0860x905,brian28@trevino.com,2021-09-29,http://nielsen.net/
27-May-2021,Miscellaneous,53.50,00.00,"74,956.73",148babFdcf2aef6,9184,Hayden,Rhodes,"Curry, Dunn and Travis",Julieland,New Caledonia,448-115-8504,032-319-0348,tabithaglover@adkins.com,2022-03-17,http://www.barrera-lam.com/
27-May-2021,Debit Card,00.00,"14,991.35","59,965.38",b5d1Ba4BE81d0Bd,8045,Cheyenne,Estes,Dyer-Hayes,Montgomerybury,British Indian Ocean Territory (Chagos Archipelago),001-719-961-7063x96172,593-564-3966x450,oknight@howard.com,2021-03-08,https://www.shelton.com/
27-May-2021,Reversal,00.00,"9,994.23","49,971.15",AC7Eaf9cAb2E66A,7259,Sue,Blackburn,"Ballard, Holden and Wang",Lake Sydneyborough,Jamaica,001-537-462-7135,321.549.1452x4002,saunderssue@montoya.com,2021-02-25,https://jensen.com/
28-May-2021,NEFT,00.00,"24,985.58","24,985.58",f6D781338DaC5E9,8184,Kirsten,Carney,Frank Inc,Dennismouth,United States Virgin Islands,+1-338-013-5872x058,242-938-6832,hansonariel@morgan.com,2021-09-25,https://baker-atkinson.info/
28-May-2021,Miscellaneous,"18,862.00",00.00,"43,847.58",dCF77D2BB96Cd8d,4995,Debbie,Simon,Kirk PLC,New Bianca,Singapore,(729)969-8630,+1-073-581-7087x279,davepitts@turner.org,2020-10-21,http://www.griffith-morton.com/
28-May-2021,Commission,00.00,"7,307.93","36,539.65",5DFeEaDE4CAa019,2361,Geoffrey,Riggs,Lawrence-Sweeney,Kellytown,Finland,0383757850,(098)854-6379x89143,allenbuck@vazquez.biz,2020-11-01,https://kramer.info/
28-May-2021,Commission,00.00,"4,567.46","31,972.19",B25B0d4Fe18aBaF,5260,Valerie,Salinas,Montes Inc,North Rebecca,Ecuador,556.816.2235,001-399-480-1899x054,knightclaudia@mcgee-carr.net,2020-10-05,https://sanders.com/
28-May-2021,IMPS,00.00,"7,993.05","23,979.14",f5dd3cD6fACA03f,7414,Brianna,Horn,Archer Inc,New Tracimouth,Zimbabwe,(133)569-2914x9380,+1-858-722-9597x75665,bblackburn@lowery.net,2021-10-31,https://sosa.com/
28-May-2021,NEFT,48.25,00.00,"24,027.39",dCc658DcFEa11E2,510,Theodore,Ball,Fitzpatrick-Rosario,Noahchester,Jordan,583.202.7673x8782,632-272-6463x8949,vmelton@harris-roth.biz,2020-03-05,https://www.ross.com/
28-May-2021,RTGS,00.00,"4,004.57","20,022.82",A8d84178dAA908d,2229,Felicia,Mccarthy,Gray Group,East Evan,Barbados,(121)424-4751x2621,0514963070,jenkinsmason@haley.com,2020-07-06,http://www.garner.com/
28-May-2021,Transfer,299.30,00.00,"20,322.12",30B69Cc6Ac1af3f,4964,Nicole,Luna,"Daugherty, Morris and Hamilton",Livingstonland,Chad,9284645368,001-466-528-1699x590,macdonaldjustin@bird.com,2020-08-25,http://randolph.com/
28-May-2021,RTGS,00.00,"2,540.27","17,781.86",B00F455Ead8eaF5,8622,Charlene,Vang,"Doyle, Velez and Garrison",North Mckenzieburgh,United States of America,(161)244-9414,4039128651,mrose@hancock.biz,2020-08-20,http://www.carter-lutz.com/
28-May-2021,Reversal,00.00,"3,556.37","14,225.49",2ef7898c342EBe6,9316,Patty,Morrow,Hale PLC,New Dontown,Djibouti,000.618.2439x599,026.568.7836x8860,nchaney@gill-galloway.com,2021-03-11,https://williamson.com/
28-May-2021,Miscellaneous,00.00,"1,422.55","12,802.94",e20Cc5CBBb348a1,6158,Maurice,Davila,"Ortega, Bean and Navarro",Juliaside,Sweden,756.630.5249,661-496-9244,rothvalerie@estrada-mckenzie.com,2021-10-07,http://www.berry.com/
28-May-2021,ATM,40.40,00.00,"12,843.34",bd57BaAdcc701Ec,7232,Lynn,Juarez,Blevins-Hill,Drewview,Uganda,578.295.4229x285,001-226-505-7732,stewartnancy@franco-reyes.biz,2020-10-19,http://www.fuller.com/
28-May-2021,ATM,00.00,"1,605.42","11,237.92",8CeaB2697903D9A,6036,Shaun,Alvarado,Villegas and Sons,Geoffreytown,Mayotte,001-449-923-2348x61639,9935465464,lindsayholt@durham-turner.com,2021-07-28,https://www.gonzales.com/
28-May-2021,Bill,09.00,00.00,"11,246.92",88c7Cd0aC9e8E3a,7109,Jeffery,Cardenas,"Ramirez, Berger and Simpson",West Haroldton,Saint Martin,001-562-430-5216x099,+1-388-672-2719x7467,mchaney@landry.net,2021-05-02,https://www.gill.info/
28-May-2021,Cheque,00.00,"3,748.97","7,497.95",Dcae5D501C9adD3,1857,Monique,Alexander,"Small, Fox and Lamb",West Shellyview,Bolivia,001-999-291-7401x8115,775-142-8391x19212,arthurwang@pittman-foster.com,2021-07-03,https://www.johns.com/
28-May-2021,Reversal,00.00,"1,249.66","6,248.29",8E1662DA103AF57,5688,Alisha,Norris,Pearson Group,Mckenzieville,Australia,001-858-268-9484x6183,+1-564-306-6833x618,dillon17@lawrence.com,2022-03-05,http://cooley-vance.biz/
28-May-2021,Miscellaneous,00.00,"1,041.38","5,206.91",B67f0bC593dE9e4,2215,Cassidy,Rush,Marks Group,South Jacob,Saint Barthelemy,567-513-3075,+1-456-266-7485x845,dennis88@francis.com,2020-04-25,http://mcneil.com/
28-May-2021,Transfer,00.00,"5,206.91",00.00,Aaa65bcDf93aeDd,9335,Jackie,Decker,Holt Group,South Shellybury,Congo,001-010-385-8318x20864,724-293-1020x117,gritter@whitaker-benton.com,2021-12-21,https://www.kennedy.com/
28-May-2021,Debit Card,"1,797,464.50",00.00,"1,797,464.50",483fE2AD3cFfA6A,7353,Jody,Buck,Haas-Ritter,Thorntonport,Syrian Arab Republic,741.874.6342x57821,643.940.2516x04648,olawson@holt.com,2021-06-24,https://www.boone-cook.com/
28-May-2021,Miscellaneous,"20,638.75",00.00,"1,818,103.25",fD8ebdFBC6484c0,9903,Donald,Key,Walsh PLC,Owensmouth,Tuvalu,3837627237,001-615-917-7244,mejiavictor@neal.info,2021-06-12,http://www.pineda.net/
28-May-2021,ATM,00.00,"181,810.33","1,636,292.92",93CE401F9Cb3C4c,5008,Danielle,Kim,Hughes Group,East Tashamouth,Bangladesh,2002382133,+1-913-031-4428x075,huertamarc@pierce-glass.net,2022-04-20,http://www.davidson-riggs.info/
28-May-2021,Tax,"2,759.71",00.00,"1,639,052.63",3Bde0AecDdcd9B5,3422,Janice,Daniel,"Jensen, Cooley and Merritt",South Terranceshire,Guinea,(085)451-7811,(454)438-6204,katrina61@kramer.com,2022-04-21,https://www.johnson.biz/
28-May-2021,NEFT,143.76,00.00,"1,639,196.39",41fbbaaEBdCe268,7520,Madison,Jefferson,Ellis Group,Port Cristina,Montenegro,967-823-3344x1692,(379)875-2265x025,vcowan@lindsey.com,2020-01-11,http://www.ortiz.com/
28-May-2021,Transfer,"2,479.00",00.00,"1,641,675.39",6aF49EC7Ca9d6c7,5636,Joy,Hendrix,Conway-Glass,West Joe,Ethiopia,+1-042-899-8839x06372,(141)315-9777,caitlinpage@frye.info,2021-08-29,http://www.foley-moran.com/
28-May-2021,IMPS,00.00,"273,612.57","1,368,062.82",34e58FDfe6CeAE6,7559,Derek,Weaver,Glass PLC,Bridgethaven,Peru,(303)511-5921,+1-411-184-3489x96449,swallace@owens-bruce.com,2021-03-02,http://flores-hale.biz/
28-May-2021,Commission,00.00,"228,010.47","1,140,052.35",4d44BEDBE8C8bAe,6921,Patty,Ramirez,Quinn Group,Mcneilborough,Isle of Man,+1-937-639-7652x1822,+1-921-613-9222x84016,kristopherolsen@huynh.com,2020-10-23,https://www.cooper.org/
28-May-2021,ATM,06.00,00.00,"1,140,058.35",CEF4632DAEd6EB0,1167,Judith,Powell,Suarez-Lewis,East Geraldberg,Madagascar,810.507.7664,696.341.3798x1016,cbenitez@suarez.org,2021-10-06,https://www.madden-hendricks.com/
28-May-2021,ATM,"1,853,846.00",00.00,"2,993,904.35",FFbDa4Bbc2A1edc,8768,Howard,Kline,Valencia-Wong,North Henrybury,Micronesia,9478077311,076-899-1459x77464,parkertammie@perkins-hebert.biz,2022-01-31,https://hogan.com/
28-May-2021,Tax,00.00,"598,780.87","2,395,123.48",18C6DdeecC3A9cF,483,Andres,Hebert,Bolton Ltd,Donmouth,Iceland,747.141.6951,954-020-5949x887,nathaniel36@livingston.com,2020-07-30,http://www.beltran.com/
28-May-2021,Bill,02.59,00.00,"2,395,126.07",e2fc00edd3AafF5,841,William,Lindsey,Faulkner Group,Tannerberg,Angola,(269)196-8907,206.746.5770x8507,jodifigueroa@rosario.net,2020-10-26,http://petty-mcclure.com/
28-May-2021,Bill,00.00,"342,160.87","2,052,965.20",9C27Ef395A5B3Fa,6626,Melanie,Copeland,"Oneal, Archer and Castro",West Rachael,Nicaragua,635.675.3935x40355,(403)981-4358,craigwebster@patrick.com,2021-12-16,http://www.velazquez.net/
28-May-2021,NEFT,475.50,00.00,"2,053,440.70",A1B4E6935ddEbb6,644,Mary,Morris,"Barton, Singleton and Castillo",North Marciaside,Bolivia,070.130.4264,(758)432-8491,holderevelyn@dunn-tucker.com,2021-01-05,https://krueger.com/
28-May-2021,RTGS,00.00,"205,344.07","1,848,096.63",AbD453727d69b88,4816,Randy,Jimenez,Brock and Sons,South Kaitlynberg,Germany,725.115.9119,498.021.1063x2395,mendezpamela@velazquez.info,2020-09-30,https://robertson-pierce.org/
28-May-2021,Reversal,00.00,"264,013.80","1,584,082.83",F3E3daeCcfddE9A,3220,Roy,West,Matthews-Patterson,Dariuston,Uganda,+1-140-610-5033x66695,+1-033-641-5317x004,moyermark@moran.com,2020-07-16,https://www.ballard.net/
28-May-2021,Cash,80.41,00.00,"1,584,163.24",B0B76b1dc860Ff6,6792,Katherine,Aguirre,"Fox, Sherman and Love",Charleneville,Fiji,001-083-395-7832,365-254-9098,estark@berger-villegas.com,2022-01-10,https://www.pittman.com/
28-May-2021,Cash,"204,479.53",00.00,"1,788,642.77",E2fEF1bA17A5A4B,2454,Drew,Rubio,Daugherty-Cruz,New Melaniefurt,Somalia,0394431738,001-865-775-3311,barrybrittney@ramsey-villegas.com,2020-02-14,http://sandoval.com/
28-May-2021,Cheque,00.00,"447,160.69","1,341,482.08",fEB05baEc5ba41d,27,Emily,Calderon,Todd-Acosta,Lake Sallyport,Cameroon,038.443.6100,618.908.5890,shelley82@jarvis.com,2021-06-17,http://www.larsen.org/
28-May-2021,Purchase,00.00,"447,160.69","894,321.39",b6f012Ba94fc40A,3793,Stacey,Galloway,"Kelley, Zhang and Fitzpatrick",Martinezburgh,Serbia,438.515.4241,(943)965-2322x999,tami19@bray-calhoun.com,2020-10-16,https://fritz.net/
28-May-2021,Commission,04.70,00.00,"894,326.09",fd38eDF1a5c07Ea,6146,Eileen,Brady,"Pierce, Carpenter and Short",Shermanside,Czech Republic,001-272-106-4236,+1-071-523-4520x457,sconway@mcintosh.com,2021-04-05,http://www.higgins.biz/
28-May-2021,Tax,"2,279.06",00.00,"896,605.15",d8cb2fFB01e638E,4242,Joyce,Ramirez,Townsend-Christian,South Roberto,Comoros,822.646.7809x85533,947-795-5072,summermelendez@conway.biz,2021-05-12,https://www.le-frederick.info/
28-May-2021,RTGS,00.00,"224,151.29","672,453.86",D090DDBBCB4Db7b,7102,Vicki,Pacheco,"Kirk, Vega and Lester",Lake Rodneyshire,Hong Kong,012-471-5355,(335)988-5230x4978,joann09@faulkner.com,2021-12-18,https://www.cross-parker.info/
28-May-2021,Cheque,00.00,"672,453.86",00.00,9cFcD26Bdbf3Ac2,8349,Shaun,Beck,"Murray, Cardenas and Ferrell",Lake Leonardstad,Israel,001-786-272-3366x6821,001-181-449-7728x486,eduardoandersen@ortega.com,2021-12-17,https://liu.com/
28-May-2021,Debit Card,"31,907.41",00.00,"31,907.41",fd14D2d6dDad2F3,9363,Michael,Avery,Bailey LLC,North Miashire,Haiti,+1-680-279-3048x13605,(612)854-1328x7458,turnermelissa@lam.com,2020-11-14,http://www.small-meyer.net/
28-May-2021,IMPS,488.80,00.00,"32,396.21",Ff935DE2ab1fd1D,5141,Becky,Esparza,Lynch-Morse,East Luketon,Iran,224-533-0860x1210,697.565.5561,andrea26@nelson.com,2022-03-08,https://beltran.com/
28-May-2021,Cheque,00.00,"4,049.53","28,346.68",AAE28ef5F5a74dE,9689,Sherry,Clay,Nichols LLC,Bentleyland,Martinique,001-809-463-5508x4269,489-170-0639,ebryant@rivera-oconnor.com,2021-08-16,https://hughes.biz/
28-May-2021,Transfer,"32,742.00",00.00,"61,088.68",E9379eeC0e4c621,1464,Mariah,Castillo,"Weaver, Bass and Cantrell",East Terry,Mauritius,2064191317,(427)170-6397x4274,candicehenry@berger.com,2020-04-16,http://www.acevedo.com/
29-May-2021,Miscellaneous,00.00,"10,181.45","50,907.23",c7d5Dfe797f015F,4271,Cassie,Barnett,Rivas PLC,Glennmouth,Kuwait,001-096-769-8732x8053,(956)096-1441,uzimmerman@chang-levy.info,2021-01-04,http://ochoa.com/
29-May-2021,Bill,383.90,00.00,"51,291.13",EAa24E17c1796a1,2670,Austin,Choi,"Mays, Chandler and Mccullough",Port Latoya,Pakistan,+1-374-615-2025x0776,582-087-7990,isaacschroeder@arellano.com,2022-04-21,http://www.frederick-snow.net/
29-May-2021,Interest,00.00,"8,548.52","42,742.61",096BEAd75283FDC,7899,Katelyn,Fry,Gibson-Allison,Morseburgh,Ireland,+1-238-310-5770x52572,175.511.9068x746,fduncan@curry.com,2020-12-05,http://romero-buchanan.com/
29-May-2021,Purchase,61.94,00.00,"42,804.55",BCCcB54d5d55d5A,6154,Catherine,Peterson,Mclean Inc,Morganton,French Southern Territories,(003)725-4694x90894,2762736317,lucaslonnie@kim.com,2022-05-17,http://www.fischer.com/
29-May-2021,Cheque,"9,574.76",00.00,"52,379.31",F0dB00CdcE8FA3B,7531,Mallory,Williamson,"Bryan, Roach and Webster",East Chelsey,Anguilla,526.913.8945x292,+1-460-923-4295x3991,mcintoshmonica@mora.com,2022-01-07,https://www.goodwin.com/
29-May-2021,Miscellaneous,02.00,00.00,"52,381.31",C24E4c1C9b88E89,7352,Miranda,Oneill,Mcgrath Inc,Penashire,Honduras,314.791.6200,099-791-1348x0529,mossmandy@davis-crane.com,2021-11-09,http://www.williamson-cline.com/
29-May-2021,Tax,00.00,"52,381.31",00.00,Ef922f8ac05E954,2065,Courtney,Stephenson,Mckay LLC,Contrerasview,Christmas Island,955-957-2546x0811,142-136-5775x06835,louis40@richards-oconnell.com,2020-12-11,https://wong-henson.net/
29-May-2021,Reversal,88.80,00.00,88.80,6DEa5aDE36ebDdC,1223,Randy,Orr,"Houston, Montes and Casey",Bryantown,Marshall Islands,(300)414-5192x278,8236685609,dawn46@perry.com,2022-02-01,https://oliver-black.com/
29-May-2021,IMPS,"1,275.00",00.00,"1,363.80",d0D0F0b144d26DE,2038,Ashley,Massey,"Carson, Hopkins and Cunningham",North Janechester,Djibouti,919.255.0384,259-123-6072x16797,hensonzoe@gaines.com,2020-04-15,https://www.reilly-terry.biz/
29-May-2021,Tax,00.00,"1,363.80",00.00,F806889ebb2aBdc,2494,Fred,Glass,Duncan LLC,East Ariana,Uruguay,7337179645,825-493-2388x08116,derrickmcbride@marsh.com,2021-11-05,https://www.griffin-phillips.net/
29-May-2021,Interest,04.00,00.00,04.00,5934AD8B3Fd9C3A,2759,Stuart,Valenzuela,"Faulkner, Wallace and Hogan",Adamland,Finland,001-268-877-4774,841.501.7399x2679,sabrinafrye@gates.com,2021-05-27,http://keller.com/
29-May-2021,Interest,332.06,00.00,336.06,20Ed3D3d2AA7dc1,6206,Reginald,Arias,Barrera Group,Tomburgh,Chad,946.871.2756,4359002644,melissabrewer@wolf-rice.com,2021-07-18,http://www.long.com/
29-May-2021,Cheque,"122,657.00",00.00,"122,993.06",CD44F2F9C452Ed0,7697,Lorraine,Greer,"Becker, Pruitt and Mullen",Doughertymouth,Vietnam,310.088.8923x5660,001-437-883-3848x8959,hailey04@singh.org,2020-10-23,http://jackson-vance.net/
29-May-2021,Cash,00.00,"12,299.31","110,693.75",151A6a7Deb33bcA,183,Stacy,Hayden,Rush and Sons,Port Shawna,Spain,001-383-579-5745,+1-222-830-3139x0809,gravesalisha@harrell.info,2021-11-24,https://www.li.biz/
29-May-2021,Cheque,00.00,"12,299.31","98,394.44",4a83aB1AEaDA20e,9000,Rachael,Vazquez,Cain-Ashley,Hansenmouth,Equatorial Guinea,249-788-7240x49952,301.370.6988,frostdestiny@hughes.info,2022-04-20,http://www.nguyen-rios.info/
29-May-2021,Transfer,00.00,"12,299.31","86,095.14",DC63a02BDa14af4,65,Nicholas,Mcclure,"Roy, Myers and Fox",East Nicolechester,Nepal,040-706-1022x241,909.727.3778,phelpsandres@hartman-cooper.org,2021-03-15,http://www.levine.com/
29-May-2021,Purchase,00.00,"9,566.13","76,529.01",0b840987F99B954,8394,Diamond,Salas,Martinez Group,West Vanessa,Paraguay,345.624.0903x801,+1-719-260-1582x08621,sarah48@brock.com,2021-11-22,http://patrick.org/
29-May-2021,Bill,66.90,00.00,"76,595.91",d4d2e1a1aD7df6C,936,Darren,Fuller,"Mccarty, Powers and Blackburn",Whiteheadview,Faroe Islands,800-187-0481,001-007-220-6286x96262,sharonwhitaker@marsh-webster.org,2022-04-28,http://www.oneill.com/
29-May-2021,RTGS,372.00,00.00,"76,967.91",078DEe6857a7FC8,7915,Jane,Allen,Meyer-Frost,Madisonfurt,Solomon Islands,757-676-4484,(315)566-2958x60606,hperez@woodard.info,2021-01-25,http://park-garcia.info/
29-May-2021,ATM,"22,255.00",00.00,"99,222.91",C9bFa849Cd1DeEe,7292,Helen,Weiss,"Sweeney, Newman and Guerra",South Bryce,Antigua and Barbuda,+1-545-223-7038x98874,389.415.3502x7264,lancemayer@webster.info,2021-12-15,http://pope.com/
29-May-2021,IMPS,54.43,00.00,"99,277.34",dF9F4f651E0052c,7804,Charles,Mclean,Benton Ltd,Timtown,Peru,030.399.3854x81439,9582312719,harrypearson@collier.info,2020-08-24,https://www.sweeney-kaufman.info/
29-May-2021,Cheque,00.00,"33,092.45","66,184.89",ceeF7BC6bABaFBC,5412,Fred,Zamora,Marshall Inc,South Amy,Guatemala,+1-060-231-9197x7789,980.156.3803,christopherwise@wallace.com,2020-12-07,https://www.mullen.biz/
29-May-2021,Reversal,00.00,"22,061.63","44,123.26",bF3aE9acdDC8e74,2054,Kelli,Blankenship,Lloyd Inc,Sethland,Netherlands,470-052-3300,528.602.1453,kimwiley@ray.com,2020-02-17,https://ruiz-bullock.net/
29-May-2021,Commission,00.00,"4,412.33","39,710.93",05f5e8C38afaADa,6155,Claudia,Mcdaniel,Le-Herrera,North Marissaport,Georgia,001-492-070-8996,345-503-3304x523,jwallace@archer-ewing.net,2021-03-12,http://allen.com/
29-May-2021,NEFT,00.00,"9,927.73","29,783.20",53c9b7C7960c594,1300,Mia,Frank,Kennedy-Hernandez,East Kent,Kazakhstan,803-737-2720x890,+1-229-586-3815,gabrielalloyd@castillo-hahn.com,2020-10-19,https://www.foster.com/
29-May-2021,RTGS,00.00,"29,783.20",00.00,Af8b9eFd6BaDA4a,7763,Raven,Hanson,"Hawkins, Figueroa and Parker",New Joann,Moldova,654-941-4998x345,001-683-190-8079x1755,boydariel@hardy.com,2020-10-14,http://www.bullock.com/
29-May-2021,Transfer,"2,343.80",00.00,"2,343.80",ceBD7E4eC9B8d9d,4055,Lindsey,Santiago,Riley and Sons,Norrisbury,Ukraine,001-145-938-3847x3727,(431)016-8341x1120,greg70@flynn.com,2021-03-25,https://www.quinn.info/
29-May-2021,Reversal,07.00,00.00,"2,350.80",C8Fc39F1Db6ca66,2060,Danny,Rice,"Lynch, Duncan and Krueger",Claytonborough,Mauritius,(355)592-6686x0189,673.179.6909,brendangallagher@fisher.com,2020-09-01,https://www.gallagher-barnes.com/
29-May-2021,IMPS,04.02,00.00,"2,354.82",6bD1f9dF02aadA7,3008,Wayne,Harrington,Fischer-Chaney,Khanstad,Kazakhstan,7903661553,103-956-4670,cooleyaaron@valdez.org,2020-07-17,http://www.blackburn.com/
29-May-2021,Commission,00.00,235.48,"2,119.34",D2Eb1fdbE8C80fD,4026,Stuart,Boyer,"Mcmillan, Leblanc and Ashley",Reedchester,Costa Rica,101-742-9466,001-591-739-2024x4765,teresalambert@maynard.com,2022-01-31,https://www.taylor-finley.com/
29-May-2021,Tax,"9,015.19",00.00,"11,134.53",166dC9a56fe1239,7461,Alejandro,Hopkins,"Gomez, Bartlett and Melton",South Julia,Ghana,0030550666,893.872.3982x307,rivaskenneth@whitaker-blevins.com,2022-02-03,https://miller-cole.biz/
29-May-2021,Tax,00.00,"5,567.27","5,567.26",CFefa76aB91EaD6,1621,David,Figueroa,Coleman Ltd,New Vicki,Norfolk Island,128.691.1808x0491,+1-251-523-4339x2439,maxwell03@whitaker-shaffer.com,2022-02-19,http://www.green.com/
29-May-2021,Tax,00.00,"1,855.75","3,711.51",D2F48F2BCD63A28,4050,Eduardo,Hall,"Crane, Atkins and Garrison",Madisonborough,Libyan Arab Jamahiriya,392-169-9100x0979,032.391.1030x371,crogers@humphrey.com,2021-12-06,https://www.rivers-paul.org/
29-May-2021,Interest,01.00,00.00,"3,712.51",4bCA062e7863a11,5575,Casey,Castaneda,Miranda-Cunningham,Veronicahaven,Slovenia,(081)198-8907x566,(503)026-3612x834,phyllis30@mcknight.com,2020-01-08,https://www.holder.com/
29-May-2021,Bill,"232,119.00",00.00,"235,831.51",a9BF395CFf4A6Aa,4041,Betty,Ritter,"Davenport, Navarro and Wilson",Ronaldton,Sri Lanka,001-116-709-9901x9440,001-419-351-4572x784,parkpreston@brooks.com,2021-02-02,https://wood.info/
29-May-2021,Reversal,"706,762.75",00.00,"942,594.26",e30D09bcC5EaDEC,1957,Stacie,Reyes,Bradshaw PLC,Warnerton,Guinea-Bissau,+1-805-112-3373,651-826-9516,karl57@martin.com,2021-03-14,https://sampson.com/
29-May-2021,Tax,00.00,"188,518.85","754,075.41",0900C54e9Da06e8,8689,Eric,Durham,Padilla-Schmitt,Craneborough,Botswana,(346)909-1513x5215,465.723.3589x654,andersenloretta@pruitt-figueroa.com,2021-06-27,https://www.russo.biz/
29-May-2021,Cash,00.00,"94,259.43","659,815.98",a7E40d6D4CDdeB7,6187,Kristin,Molina,Brock Inc,Kelliehaven,Chile,730-369-0015x622,001-902-805-5954x887,greersierra@kane.com,2021-06-06,http://fowler.com/
29-May-2021,Purchase,00.00,"164,954.00","494,861.98",0cDdf9e46aACEe7,1935,Jennifer,Vang,Gonzalez Inc,Maxwellton,Guyana,7844163994,(839)421-4546,craig46@raymond-cooke.info,2022-05-13,http://www.horne-hurst.com/
29-May-2021,Cash,00.00,"247,430.99","247,430.99",00Ba3F0aC1bDbaE,5779,Christina,Patterson,Livingston Inc,South Danielfort,Macao,001-006-772-8187x398,182-230-0952x903,ana02@tanner.org,2021-03-09,https://www.barnett.info/
29-May-2021,Miscellaneous,00.00,"49,486.20","197,944.79",Ad6cd7b8dca70B1,3971,Shawn,Macdonald,"Todd, Fleming and Donaldson",Hornechester,Guyana,+1-512-589-8105x906,(565)851-4163x16346,cathygomez@schmidt.org,2021-02-21,https://www.fowler-arnold.com/
29-May-2021,Commission,00.00,"21,993.87","175,950.92",3C5ca1Dce7Aaa8f,1813,Kylie,Paul,"Hatfield, Hudson and Glass",Alisonbury,Croatia,200.335.5435,(148)492-5891x31274,tommy62@love.com,2021-04-06,http://delgado.com/
29-May-2021,Transfer,00.00,"21,993.87","153,957.06",aaDdB8bD9aEc74C,8505,Shannon,Duncan,Waller LLC,New Howard,Timor-Leste,697-936-5998,701.195.2540x146,michael05@gibbs-salazar.net,2020-04-18,https://www.reese.com/
29-May-2021,Bill,00.00,"38,489.27","115,467.80",FB523e9885a2AFa,4559,Kristy,Mora,Phelps LLC,Connietown,Oman,6533560714,+1-966-005-6576,joycekristin@mann.com,2020-10-16,https://www.robbins.net/
29-May-2021,IMPS,"1,263,454.50",00.00,"1,378,922.30",bcCfbcB4d7E6e6c,5429,Bonnie,Arias,Brandt-Floyd,Bergerfurt,Iraq,(419)557-9424x1562,3159354157,bradymassey@edwards.org,2020-11-08,http://www.parker.net/
29-May-2021,ATM,00.60,00.00,"1,378,922.90",C3890B19A9B8c2D,9091,Rick,Moss,"Ellis, Avila and Meza",West Kerryton,Heard Island and McDonald Islands,+1-908-474-5745x76405,800.018.6253,judyvaldez@hanson.com,2020-05-27,https://bell.net/
29-May-2021,Tax,15.74,00.00,"1,378,938.64",A324bA2Bdf771AA,9035,Greg,Martinez,Conrad Inc,Salazartown,Portugal,001-524-780-1377x51619,(593)376-9882,steve84@norris-zavala.net,2021-05-09,http://www.carson.com/
29-May-2021,Transfer,00.00,"153,215.40","1,225,723.24",4cdE1c880EF03Cd,6962,Angela,Thompson,Levine PLC,Lake Peter,Equatorial Guinea,(979)524-6033x295,729.847.7763x452,zoe67@arellano-stokes.com,2021-04-24,http://webb.info/
29-May-2021,Tax,05.80,00.00,"1,225,729.04",7afcC5d7faC7bA1,7549,Phyllis,Potts,"Donaldson, Stevenson and Fletcher",Braybury,Estonia,154-877-2097,404-537-9014,billyfuller@cline-lloyd.biz,2021-12-10,https://www.clarke.com/
29-May-2021,Bill,00.00,"122,572.90","1,103,156.14",6Ab34FdcE8E5e02,2566,Brandy,Ferrell,Bishop and Sons,Janicemouth,Spain,8696057153,049.867.1095,cameron24@blanchard.info,2020-02-26,http://ford.com/
29-May-2021,Transfer,00.00,"275,789.04","827,367.10",1BbbBaD7BBeFbb5,6272,Clarence,Novak,"Case, Krueger and Madden",Port Melissa,Isle of Man,1182550808,(117)734-0832x6143,valenciajoseph@harrell.net,2020-06-14,https://hansen.com/
29-May-2021,Tax,"2,191.92",00.00,"829,559.02",ddbD90f2ea0A438,4077,Jamie,Nguyen,"Barrett, Odonnell and Gutierrez",Alexstad,Korea,001-842-453-5736x54189,5991206538,gonzalezkevin@terrell.com,2021-12-30,https://www.burgess.com/
29-May-2021,Cash,75.00,00.00,"829,634.02",9086328A159D5CC,3400,Leah,Griffin,Hinton and Sons,Port Kelseyville,Liberia,+1-467-401-8835,+1-494-105-4043x45919,azuniga@may.com,2020-04-13,https://gaines.com/
29-May-2021,Purchase,"3,946.00",00.00,"833,580.02",Dcee8E26aeE4AFa,1557,Jacqueline,Kaufman,"Horn, Collins and Roy",Clinemouth,Serbia,001-046-689-0176x40861,7094363659,vbean@short.com,2020-11-29,https://www.carroll.com/
29-May-2021,Purchase,"203,317.80",00.00,"1,036,897.82",cfDB96C0EaD9550,5956,Erica,Andrews,Blackwell-Dennis,Balltown,Palau,001-379-361-8902x7493,+1-840-218-7459x8742,wanda09@yang.net,2021-06-29,http://www.trujillo.com/
29-May-2021,Interest,"15,692.65",00.00,"1,052,590.47",CeA1CDF1b2e5da9,1208,Glen,Castro,Douglas Group,Emilyburgh,Albania,158-765-0651x582,907.907.5759,lhatfield@dawson.info,2021-09-01,https://www.schroeder.net/
29-May-2021,Tax,"1,855.30",00.00,"1,054,445.77",6dF247a8294745a,9907,Andres,James,"Clark, Navarro and Bentley",Lake Sophia,Haiti,803.654.8431,(439)704-7958x74356,meaganholland@graham.com,2020-03-30,http://osborn.com/
29-May-2021,ATM,03.00,00.00,"1,054,448.77",dB16EB7Effe4B5f,1094,Ryan,Casey,Jensen-Hamilton,Lake Isaacstad,Israel,(552)634-6632x4299,(637)700-3338x57599,cassidy14@russo-stuart.com,2020-07-23,https://mccall.com/
29-May-2021,Tax,00.00,"263,612.19","790,836.58",ed91594c5aFFdAE,3564,Maureen,Haley,Webster PLC,New Debbieside,Cape Verde,713.649.4493x257,+1-008-697-4739x45151,beardcassidy@parker.com,2021-12-07,https://www.ross-suarez.biz/
29-May-2021,Transfer,00.00,"112,976.65","677,859.93",03dcb2bDD91AEbE,4518,Sheila,Gilbert,Donaldson PLC,Terrimouth,Philippines,+1-098-526-7418x55599,4818932234,davidsonmichelle@rowe-cantu.net,2021-07-06,https://chandler.com/
29-May-2021,NEFT,00.00,"67,785.99","610,073.94",CbE4C5BCEFB7d82,7119,Brenda,Douglas,Dickerson-Ford,New Kimberly,Saint Lucia,+1-980-930-5528,(413)839-1888x17764,reynoldssusan@fleming-buckley.net,2021-05-30,https://www.ellis-wong.com/
29-May-2021,ATM,"1,183.00",00.00,"611,256.94",8b4bdbEe01deA5C,158,Veronica,Golden,"Wright, Contreras and Wagner",North Theresastad,Falkland Islands (Malvinas),(367)700-9543x932,+1-422-724-7575x684,gacosta@stephenson-tyler.biz,2020-03-31,http://www.best.com/
29-May-2021,Miscellaneous,73.00,00.00,"611,329.94",ce3f1ba75c5CaF2,4343,Mitchell,Quinn,Mayer-Mays,South Karla,Korea,(303)658-2688,920-649-2569x4315,mccarthyzachary@kelly.com,2020-06-25,https://www.mcknight-smith.com/
29-May-2021,ATM,00.00,"122,265.99","489,063.95",7F87b0968BC0217,617,Janet,Mccann,Rios Group,South Karl,Slovenia,1309088872,+1-343-813-1969x25447,mdominguez@nolan.com,2021-07-14,http://phillips-gilbert.com/
29-May-2021,Miscellaneous,00.00,"489,063.95",00.00,EC5DD5e4C70d6Fe,6243,Brenda,Perkins,Patrick Inc,West Erikaside,Comoros,039.143.2402,979-524-2577x4040,johnstonconnie@mccormick.com,2020-06-04,https://www.drake.com/
29-May-2021,Miscellaneous,36.45,00.00,36.45,fd98aF1D4F5bd3E,3901,Phyllis,Rush,Blackburn-Gamble,Benjaminstad,Falkland Islands (Malvinas),001-066-043-8275x8962,(304)258-2742x13078,allen00@long.com,2020-12-11,http://www.navarro.info/
29-May-2021,RTGS,00.00,07.29,29.16,C2A7Fc2d37b04be,1934,Clayton,Bryant,"Horn, Wilkins and Knight",Neiltown,Monaco,(057)805-3850,(988)004-7853,cookemarie@morse-romero.net,2021-12-31,https://owens-larsen.info/
29-May-2021,Interest,00.00,03.24,25.92,7346C2DFc1EcE72,6694,Gary,Odonnell,"Abbott, Holder and Hoover",East Michaelview,Puerto Rico,526.236.6696,(785)570-4978x67963,cummingsselena@mcdonald.com,2021-08-05,https://www.warren.com/
29-May-2021,Interest,"125,536.50",00.00,"125,562.42",E3A8D64245dD7f7,4163,Tasha,Lucero,Torres-Whitaker,East Erikafort,Sao Tome and Principe,089.808.8881x2643,467.889.3358x36088,preston37@campbell-cunningham.com,2020-06-02,https://barajas.com/
29-May-2021,Cheque,"28,621.90",00.00,"154,184.32",77c333147Ac56ee,2702,Jimmy,Stanton,"Gross, Ware and Acevedo",Bernardmouth,Cook Islands,(498)775-0476x882,(089)168-9053,jonathancohen@booker-collier.com,2020-09-28,https://www.durham.com/
29-May-2021,Interest,"3,125.10",00.00,"157,309.42",ECD05B505Ba76ec,1079,Renee,Lang,Daniel Inc,East Steven,Philippines,+1-515-849-4431,195.887.3616x453,clogan@estes.com,2020-09-18,http://www.mclaughlin.biz/
29-May-2021,Transfer,03.50,00.00,"157,312.92",C52Fcf0ACaAD08C,5803,Isaac,Brock,Baker-Ramirez,Bernardmouth,Pitcairn Islands,001-813-451-9197x455,(202)636-9824x223,russellbriggs@guerra-mullen.info,2020-10-19,http://www.holland-casey.info/
29-May-2021,Commission,"1,232.10",00.00,"158,545.02",8F3F650B2ddD53B,634,Nicole,Hart,"Mayo, Goodman and Allen",Rochaport,South Africa,218-046-1566,882.665.3819x034,zchapman@villarreal.com,2021-04-02,https://www.johns-kelley.com/
29-May-2021,NEFT,00.00,"17,616.11","140,928.91",a2f3DBd4d6143EA,7123,Charlotte,Watkins,"Patterson, Ayala and Lowe",Haydenhaven,Guernsey,001-029-282-8237,+1-934-039-3677x49546,elainecox@lowe.com,2021-09-08,http://www.evans.com/
29-May-2021,Reversal,00.00,"17,616.11","123,312.80",074A2bEbfcA81F7,3961,Logan,Gross,Bautista-Avila,Danielstad,Belarus,(779)157-4807x6133,001-083-032-4921,willie03@brandt-kline.com,2020-02-28,http://www.arias-pruitt.com/
29-May-2021,ATM,03.40,00.00,"123,316.20",763d9dc4878e1e9,8380,Mary,Stout,Knox LLC,Larsenfort,Oman,346-454-1116,(918)127-4749x7652,kimberly89@benton-chandler.net,2020-07-12,https://villa-conway.org/
29-May-2021,Tax,455.86,00.00,"123,772.06",a36EA2cD2D9F4f1,764,Collin,Sanford,"Key, Obrien and York",Stokesport,Burundi,607.070.7192,3647576021,calvindiaz@snow.com,2020-02-15,https://www.frye.org/
29-May-2021,Cash,00.00,"13,752.45","110,019.61",a1Adf3271aBdd04,6457,Bryce,Gill,Sexton-Lowery,Port Lauren,Gambia,1915035103,+1-098-458-8627x2541,whiteheadtaylor@grant-olsen.com,2021-11-16,https://santana.biz/
29-May-2021,ATM,00.00,"27,504.90","82,514.71",fcECDE5fE92Dcc0,7364,Sean,Salas,May-Dodson,Lake Anita,Portugal,445.231.7411x93693,(048)560-4030x171,wharmon@mckay.info,2021-08-19,http://browning.com/
29-May-2021,NEFT,00.00,"16,502.94","66,011.77",976bcA589A63bdf,9696,Sally,Mckay,Maldonado and Sons,Dustinhaven,Pakistan,984-493-9956x536,+1-824-044-4123x886,marksshaun@castro.com,2020-11-02,https://www.mcintyre.com/
29-May-2021,Commission,535.00,00.00,"66,546.77",0c4597b8DC6A7CD,3280,Cory,Carr,Morris PLC,Paceside,Montenegro,7912045790,+1-686-883-2057x06271,sally15@hood-delgado.biz,2021-10-11,http://www.delgado.com/
29-May-2021,Debit Card,00.00,"33,273.39","33,273.38",FaddddA784EdCeC,9481,Jordan,Nelson,"Roy, Fuentes and Rodriguez",Ianbury,Switzerland,+1-421-248-6063x3976,+1-314-678-9449x0866,gnielsen@walters.com,2020-06-18,https://www.shah.com/
29-May-2021,Commission,00.00,"6,654.68","26,618.70",CB4dFE7eec24D7F,4285,Daniel,Mann,Cunningham and Sons,Tonyahaven,Egypt,(920)339-3917x833,1204543866,rosehodge@middleton-garrison.com,2021-07-18,https://www.weeks-hood.com/
29-May-2021,Cheque,00.00,"2,661.87","23,956.83",2D9FD3aC63Fb117,5949,Jane,Henry,Santana PLC,Owenstad,Maldives,(362)073-5714,(567)279-4241,bartletttim@glenn.info,2020-08-03,https://clay.com/
29-May-2021,ATM,00.00,"23,956.83",00.00,Fec624bb6ca55AC,5174,Joanna,Moon,Baker and Sons,Port Kaitlin,Jersey,(301)135-9206,+1-857-829-3270x09561,josephroy@boyle.com,2021-10-27,https://www.arellano.net/
29-May-2021,Bill,04.90,00.00,04.90,bd2eeD1aB601AF1,4885,Alisha,Hudson,Calderon Inc,Port Christinaburgh,Botswana,108.991.5728x293,(151)632-3663x0150,abuck@holder.com,2020-04-11,https://lutz.com/
29-May-2021,Reversal,"1,449,094.00",00.00,"1,449,098.90",14Bd8abd7779aec,7040,Bob,Austin,"Calderon, Zavala and Harmon",Whiteheadview,Guatemala,001-374-444-9239x847,109-051-7004,charlottebenitez@donovan.biz,2020-03-28,https://rocha.info/
29-May-2021,NEFT,00.00,"207,014.13","1,242,084.77",Ac0EeBFdb41AECF,769,Luke,Pruitt,"Cochran, Humphrey and Phillips",North Alisonton,Israel,889-450-1654x191,(727)010-7891x866,slevy@clayton.com,2021-09-20,https://www.carlson.com/
29-May-2021,Interest,00.00,"155,260.60","1,086,824.17",FC7Fc11c2195998,6064,Alison,Mueller,Tucker-Russo,Hobbsberg,San Marino,138.919.5321x31662,+1-497-116-8185x5820,nathaniel38@burgess.info,2020-06-06,https://www.leach-pham.net/
30-May-2021,Bill,162.31,00.00,"1,086,986.48",03D5DDC0B1CeCa0,3239,Karl,Mejia,Molina-Durham,East Selenafort,Hong Kong,001-715-402-2928x82037,538.454.8560,kthomas@simpson.net,2020-09-28,https://barron.com/
30-May-2021,IMPS,00.00,"362,328.83","724,657.65",2d2CaE9aaDebCcA,2359,Gregory,Finley,"Bernard, Kidd and Maldonado",North Stephaniefurt,Saudi Arabia,001-331-768-2677x2949,(766)787-2336x111,abernard@perkins.org,2021-07-08,https://www.harvey-franco.net/
30-May-2021,ATM,00.00,"362,328.83","362,328.82",85cF0BA71aE67Ec,9313,Dustin,Weeks,Malone-Gallegos,New Chelseybury,Taiwan,+1-707-832-8459,(595)866-7925x94944,crodgers@griffith-barnett.com,2021-04-13,http://hanson.com/
30-May-2021,Interest,00.00,"90,582.21","271,746.62",e1eb57F22b79F18,7676,Jill,Duffy,Matthews-May,North Brittney,Cook Islands,870-316-3631,247-388-4032x1971,claudiamullen@golden-dorsey.com,2021-01-28,http://www.bonilla.org/
30-May-2021,Cash,51.10,00.00,"271,797.72",ad7FababeE9Ebef,4464,Jenny,Young,Daugherty-Haynes,Port Roger,Saint Vincent and the Grenadines,734.260.7724,548.655.5920x8197,pbrown@dyer-swanson.biz,2021-04-17,https://www.rowe-valenzuela.com/
30-May-2021,Cash,343.70,00.00,"272,141.42",56124Dc5553DDc0,5319,Derek,Chambers,Knox-Cooper,Port Savannahview,Taiwan,+1-627-339-7450,+1-473-653-3405x171,ralphperez@blake.com,2020-09-10,http://www.kirby.org/
30-May-2021,Cash,"131,161.00",00.00,"403,302.42",4936DCFe8cCFF8A,3183,Candace,Burke,"Hess, Wong and Bond",Rosemouth,Slovenia,001-381-627-3619x8306,099.828.3204,roy08@hampton.biz,2022-02-14,https://savage.com/
30-May-2021,Bill,00.00,"50,412.80","352,889.62",CbBc4C1ed7Ae6F6,6772,Collin,Lester,Cameron Group,Dannyport,Jersey,001-754-730-6777x2479,+1-326-332-9874x468,angelingram@snow.org,2022-05-20,http://andrade.com/
30-May-2021,Miscellaneous,365.00,00.00,"353,254.62",C9bFa849Cd1DeEe,7292,Helen,Weiss,"Sweeney, Newman and Guerra",South Bryce,Antigua and Barbuda,+1-545-223-7038x98874,389.415.3502x7264,lancemayer@webster.info,2021-12-15,http://pope.com/
30-May-2021,Miscellaneous,00.00,"39,250.51","314,004.11",85E14A8DdAc7CE8,8974,Sheena,Miles,Decker Ltd,Gwendolynhaven,Bangladesh,858-242-8900,001-576-665-0862x1081,cmanning@leblanc.com,2020-02-04,http://jimenez-baker.biz/
30-May-2021,Commission,00.00,"78,501.03","235,503.08",A9bDA2C696C8C1C,1790,Vernon,Gilmore,"Wagner, Briggs and Watts",Port Kaitlinburgh,Malawi,583.153.2719x071,256-050-8318x197,sara83@tran-dorsey.info,2021-04-19,http://www.gould.com/
30-May-2021,Cheque,00.00,"26,167.01","209,336.07",947E3b94CAeCEef,7442,Whitney,Neal,Flynn Inc,Freyborough,Romania,219.950.3125,001-499-049-3288x316,gonzalezmarco@moody-madden.org,2021-01-22,https://www.nunez.net/
30-May-2021,Tax,"1,177.00",00.00,"210,513.07",4BDa2E785507F3A,1014,Tiffany,Gonzalez,"Jarvis, Garza and Zamora",North Jeanne,Paraguay,513-363-5589x576,001-484-199-3334,pbailey@whitaker.info,2022-01-12,https://www.lamb.org/
30-May-2021,Reversal,462.56,00.00,"210,975.63",D4ccA95D79aa49E,4843,Carla,Best,Kaufman-Dougherty,West Sergio,Christmas Island,(031)257-4659,262-827-2570,sullivanglen@cummings.com,2021-03-28,http://khan.info/
30-May-2021,Purchase,"22,991.00",00.00,"233,966.63",B7acDDB21FA2fe8,3549,Clayton,Hansen,Rocha LLC,East Anthonyshire,Jordan,(291)954-6055,7106233478,keith80@daniel.org,2020-01-22,http://turner-curry.net/
30-May-2021,Interest,00.00,"29,245.83","204,720.80",83ce6DEadEf0bC5,618,Allen,George,"Wall, Armstrong and Schneider",Caitlynchester,Israel,077.633.7738,569-072-0443x34035,richardparks@anderson.com,2020-12-12,http://www.calderon-rojas.org/
30-May-2021,Commission,00.00,"22,746.76","181,974.04",7421471D8bcCdcB,797,Maureen,Conway,Garrett Group,South Kerry,Pakistan,001-866-681-8084x140,+1-865-659-5679,krausewillie@randall-mcneil.com,2021-05-09,https://nelson-valencia.info/
30-May-2021,Cheque,00.00,"45,493.51","136,480.53",73544cfD85a37a8,3042,Amber,Lowe,Knox Inc,South Alejandra,Australia,258-580-2604,(646)485-0171,kpotts@guerrero.com,2021-05-13,https://gamble.com/
30-May-2021,ATM,04.70,00.00,"136,485.23",dbE33A72dd94FC4,6201,Sara,Peters,Petty LLC,Rangelhaven,Saint Lucia,634.417.5688x4983,584-123-1121,troywall@bonilla.com,2020-08-12,http://www.hess.com/
30-May-2021,Miscellaneous,"21,377.80",00.00,"157,863.03",8dc574003edE1aC,9482,Anthony,Conner,"Henderson, Carlson and Barr",Coleburgh,Serbia,(825)940-3624x8594,282.032.8750x0243,qwalsh@higgins-spears.com,2020-11-13,http://ford-frost.org/
30-May-2021,Interest,00.00,"52,621.01","105,242.02",Fe4aD5D97Cb58Ae,8939,Terry,Schroeder,Mcdaniel-Jarvis,Wongview,Bhutan,001-413-651-7247x59759,797-847-0282x35317,jacksonmorris@ramos.com,2021-06-14,http://www.blevins-griffith.info/
30-May-2021,Cash,52.00,00.00,"105,294.02",7eB1eb3bD6a641b,1211,Sergio,Ayers,Avila-Tyler,Vickiefurt,Heard Island and McDonald Islands,(102)267-5690,955-577-9277x2175,petersonmiguel@moss.biz,2022-01-13,https://chen.com/
30-May-2021,Bill,00.00,"35,098.01","70,196.01",f1d636E3Ae03dAA,7677,Becky,Bullock,Massey Inc,Port Brittney,Canada,001-920-757-4752,+1-056-604-7720x7148,reyesshelby@cantu.biz,2020-09-09,https://www.gardner.com/
30-May-2021,Tax,50.20,00.00,"70,246.21",cbd8De8Cf26f34C,4296,Drew,Scott,Jennings Ltd,East Deanview,Anguilla,(822)827-1459,163-587-2894x66557,douglasmurphy@huffman-carney.com,2020-06-21,http://www.lutz.com/
30-May-2021,Miscellaneous,"884,441.25",00.00,"954,687.46",EFC2955aF028d4f,9510,Charlotte,Haley,Duffy-Lang,Gabrielleland,Korea,(841)010-2848,(380)413-7171x0641,zrocha@friedman.biz,2020-04-12,https://navarro.info/
30-May-2021,Bill,60.10,00.00,"954,747.56",483fE2AD3cFfA6A,7353,Jody,Buck,Haas-Ritter,Thorntonport,Syrian Arab Republic,741.874.6342x57821,643.940.2516x04648,olawson@holt.com,2021-06-24,https://www.boone-cook.com/
31-May-2021,Cheque,39.00,00.00,"954,786.56",64619Ffb49EcFcf,4863,Jeff,Bolton,"Duke, Fritz and Elliott",East Mikaylaberg,Malawi,625.357.5746,001-582-662-6994x687,watsonsarah@tucker.com,2021-01-15,https://chan-rodriguez.biz/
31-May-2021,Bill,00.00,"190,957.31","763,829.25",64ceeEf0e281709,455,Monica,Duffy,Kane-Calhoun,Port Glenda,Belarus,+1-479-586-3195x388,001-117-353-3149x28596,rramsey@graham-conrad.org,2021-12-27,https://allison.com/
31-May-2021,Miscellaneous,00.00,"76,382.93","687,446.32",75BF0c0820f036D,2858,Autumn,Andersen,"Harper, Cummings and Lester",Maddoxton,Congo,059-637-1381,770-944-2986,frichards@fuller.com,2021-11-24,http://www.jacobs.org/
31-May-2021,Purchase,00.00,"85,930.79","601,515.53",0Da3C262eDa8F2A,4480,Darren,Stephens,Bowen-Lucas,East Tamarabury,Italy,9961663453,001-218-042-6711x83774,gilbert19@curry-cruz.com,2021-01-09,http://www.hansen-carney.biz/
31-May-2021,Miscellaneous,00.00,"300,757.77","300,757.76",761cD254af2510b,9749,Alvin,Stanley,Dominguez Ltd,East Francismouth,Romania,(632)233-9387x7068,(151)673-6114x437,jesse17@villa.com,2022-01-16,http://barker.info/
31-May-2021,ATM,00.00,"300,757.76",00.00,8Acb14a4FBB1F42,7383,Tammie,Good,"Jordan, Bradshaw and Barber",South Jayhaven,Djibouti,001-626-577-9248x0032,382-920-2668x05668,chaselarsen@holland.info,2020-02-03,https://www.bright.com/
31-May-2021,Cash,259.80,00.00,259.80,3Ab96b4e498ad64,4000,Colleen,Cunningham,Webster Group,East Mackenzie,Bangladesh,001-753-392-3971x24188,347-267-1522,swansonspencer@massey.info,2022-01-03,http://cohen-montoya.com/
31-May-2021,Interest,00.00,86.60,173.20,F5d03148eb09e8C,6632,Nancy,Livingston,Stark Group,New Nicholas,Albania,444.275.2143,001-341-584-8992,downsjorge@osborne.com,2022-04-19,http://www.pacheco.com/
31-May-2021,NEFT,"49,514.00",00.00,"49,687.20",de0dB69f8AfDBBf,2427,Brett,Chase,"Bruce, Wilkins and Lowe",East Kristymouth,Guadeloupe,244.465.2230x9457,964-200-7821x1864,cathymedina@berg.com,2020-06-13,http://fisher.com/
31-May-2021,RTGS,00.00,"49,687.20",00.00,9df1C51847107D8,5176,Briana,Romero,"Wiley, Lucero and Delgado",New Jack,Turkmenistan,(230)019-6120x01529,214-947-3393,hallann@wilkerson.com,2021-12-11,http://www.owen-chandler.com/
31-May-2021,Cheque,13.00,00.00,13.00,b089c72F44cffd7,5889,Brent,Mitchell,Freeman-Riggs,New Laurenberg,Guinea,3911780989,+1-547-044-8725x19874,deckershelley@arias-ryan.com,2020-09-15,https://www.kirby.com/
31-May-2021,Transfer,54.47,00.00,67.47,9c6eECab5CFa7ED,4259,Kayla,Dickerson,"Taylor, Mcpherson and Berg",Bakerchester,Palau,(994)964-1383,(040)899-4898x10961,emma64@nolan.com,2022-02-20,http://www.hubbard-sanchez.com/
31-May-2021,Cheque,00.00,33.74,33.74,A6acfb993EF51cd,2636,Donna,Tyler,Burton-Knapp,Carterside,Norway,844.222.3339,(361)193-5259,qmercer@fitzgerald.org,2021-01-15,https://www.leach-schneider.biz/
31-May-2021,Cash,"2,075.00",00.00,"2,108.74",9aB46f1DeA40bCD,366,Sandy,Schaefer,Shannon-Nixon,Royhaven,Croatia,001-989-420-4196x19058,144.472.3581x450,nrandall@brown.com,2020-07-24,http://www.michael.net/
31-May-2021,Bill,177.30,00.00,"2,286.04",FFC1aE0c26c3DD5,1510,Meghan,Young,Terry-Pacheco,Wolfeshire,Azerbaijan,813-377-4407,663-894-5928x6808,hendrickscole@cabrera-miles.com,2020-10-31,https://www.petersen-castro.info/
31-May-2021,Commission,"15,167.00",00.00,"17,453.04",4e9b31EE98db96b,7829,Anna,Melton,Lowe-Hays,Franklinville,Marshall Islands,005-286-6210,001-525-368-6677,mayerkristie@castaneda.com,2022-02-28,http://www.gay.net/
31-May-2021,Miscellaneous,"862,483.00",00.00,"879,936.04",F2fBfDa9a7B1F99,9653,Oscar,Patton,Pennington PLC,Dickersonville,Canada,001-281-761-7802x7257,4997322066,vaughnariana@spears.org,2020-01-16,http://houston-schmidt.com/
31-May-2021,NEFT,00.00,"125,705.15","754,230.89",AEBc2cbC73AB569,8576,Todd,Pace,"Ibarra, Oconnor and Mcdaniel",East Brucemouth,Myanmar,(929)772-9780,644-161-2685,kcisneros@rosales-kirby.com,2021-10-08,http://may-stevens.com/
31-May-2021,Transfer,"3,212.33",00.00,"757,443.22",821DDeeBa5FB326,9393,Lonnie,Castillo,Rosario-Wood,West Jade,Panama,603.901.5631,9465083149,hfischer@stanton.info,2021-11-19,http://www.villegas-mata.com/
31-May-2021,Commission,00.00,"126,240.54","631,202.68",cf621cD3adEDcE4,9760,Stacey,Strickland,Carson-Huang,New Cynthiastad,Burundi,622.214.0740x72240,(711)458-4641,millsgabriel@bird.com,2021-12-05,http://www.conway.org/
31-May-2021,Tax,00.00,"78,900.34","552,302.35",CF1C6b51A58C0aD,5476,Trevor,Strong,"Kaufman, Baker and Mendez",Xaviershire,Turkmenistan,7900361682,001-230-845-1088x5381,gavinfinley@bauer.com,2022-02-22,https://www.chang-cook.info/
01-Jun-2021,RTGS,00.00,"92,050.39","460,251.96",01821Ca1aABADF5,9422,Emily,Lloyd,"Navarro, Rivas and Richardson",Port Staciemouth,French Guiana,(917)006-2739,535.407.7889,sboone@munoz-sweeney.com,2022-05-21,http://macdonald-hardy.com/
01-Jun-2021,Cheque,00.00,"92,050.39","368,201.57",8bFe89d11F4Dedb,211,Claudia,Dickson,Booth Group,Neilmouth,Central African Republic,(661)303-9573x42402,(937)236-0146x969,kaitlinbooth@hurley.com,2020-08-17,https://www.rhodes.biz/
01-Jun-2021,IMPS,02.47,00.00,"368,204.04",eAEF0A4cbB50fef,4535,Xavier,Vargas,"Compton, Villanueva and Spence",Levineview,Benin,001-474-644-7339x965,709.942.9793,lhunt@griffith.com,2021-10-14,https://www.elliott.org/
01-Jun-2021,RTGS,00.00,"61,367.34","306,836.70",70fe1B9BF7deFaf,700,Max,Blair,"Lucas, Walsh and Mercer",Hensonborough,Jordan,0913948757,001-225-032-0959,gmcgrath@mercer.com,2020-06-08,https://www.wilson-sloan.com/
01-Jun-2021,Commission,07.41,00.00,"306,844.11",fCAEd4cEBA29D26,7082,Priscilla,Galloway,Buck-Schmitt,West Kara,Iceland,(779)548-8896x96637,001-784-298-8900x9430,fjames@forbes.com,2021-11-28,http://barnes.com/
01-Jun-2021,Miscellaneous,"3,494.00",00.00,"310,338.11",d342b8C9cbCfB4e,7932,Bridget,Carpenter,"Collier, Novak and Monroe",Mcconnellburgh,Vanuatu,404-593-8120x5650,833-845-3664,mconrad@lamb.com,2020-12-29,https://www.christian.com/
01-Jun-2021,Cheque,"17,319.00",00.00,"327,657.11",b7AFA72118d4ee3,4463,Larry,Gentry,"Everett, Shepherd and Brown",East Chris,Jordan,001-956-139-9094x7437,001-351-325-8476x557,kharper@moreno-holmes.com,2021-12-21,http://www.moore-holloway.info/
01-Jun-2021,Commission,"29,497.68",00.00,"357,154.79",18a9655d5b6dDb6,4478,Isabella,Parker,"Carroll, Nixon and Roach",Gilbertborough,Algeria,141-204-7488,041-697-8138x53115,pgoodman@hart.com,2021-11-04,http://www.morse-bell.org/
01-Jun-2021,Cheque,00.00,"71,430.96","285,723.83",497A81a8Bc137FF,8464,Joel,Ho,Goodman-Osborne,Lawsonmouth,Guam,6680074387,(334)717-7618,cody23@robinson-mooney.com,2021-08-13,http://www.ortega.biz/
01-Jun-2021,Tax,00.00,"47,620.64","238,103.19",d86Ce96cEe1343d,3345,Caitlin,Carr,Arias-West,North Connorland,Hungary,825.157.2957x6170,589.382.1840x8887,wwright@bernard.com,2022-02-05,http://www.mccormick-mcguire.com/
01-Jun-2021,NEFT,"1,763.60",00.00,"239,866.79",0aee1acDdbF6d3D,3158,Catherine,Lyons,"Davila, Krause and Henry",Port Randall,Bahrain,001-249-694-1733x458,416-351-8900x246,rebekah91@hubbard-ware.org,2021-02-01,https://paul.com/
01-Jun-2021,RTGS,"10,480.48",00.00,"250,347.27",fF36d9FeEf6f876,6415,Carolyn,Vance,Gonzalez LLC,North Wyatt,Swaziland,+1-338-997-6048x52664,353.993.8509,bergsamantha@bridges.net,2020-04-22,http://juarez-merritt.com/
01-Jun-2021,IMPS,00.00,"62,586.82","187,760.45",2Fa2CC4f2A2FE5F,3911,Sherry,Eaton,Norman-Bird,Port Caleb,Saint Barthelemy,067.847.9041,(441)811-3647x55239,antonioelliott@williams.com,2020-12-30,http://cannon-berg.com/
01-Jun-2021,Cash,00.00,"23,470.06","164,290.39",DAb6E975e60f4C4,5726,Leah,Preston,"Livingston, Morales and Glenn",Lake Carla,United States Minor Outlying Islands,+1-095-472-7116x540,981.967.2410,cristiantownsend@rhodes.info,2021-05-29,http://www.hamilton-arias.com/
01-Jun-2021,IMPS,00.00,"23,470.06","140,820.33",4F1c6bA9Ded6D33,4215,Maria,Mayer,Mckinney-Humphrey,Hoovermouth,Afghanistan,+1-437-477-6649x4282,001-925-817-6769,michelecarney@norris.biz,2021-08-22,http://odom-costa.biz/
01-Jun-2021,Tax,00.00,"15,646.70","125,173.63",5Ef3A983bDdBBEB,9853,Aimee,Barnett,Berry-Huff,South Bonnie,Malta,1771102499,522.377.7061,franciskristi@walsh-shaw.org,2022-02-22,https://parsons.com/
01-Jun-2021,Reversal,"28,311.50",00.00,"153,485.13",505B2d5Ec1cbbe5,4275,Micheal,Hester,Vargas-Andersen,South Ashlee,Guam,001-522-639-1149x7090,6591009337,rosshinton@carey.biz,2020-09-17,http://frank.com/
01-Jun-2021,Cash,00.00,"19,185.64","134,299.49",ebfBfCd49f4e8FD,1868,Sheri,Andrews,"Vance, Lopez and Gillespie",Dorothyfurt,Saint Lucia,175.487.6371,001-648-823-8417x3830,palmershelia@charles.com,2020-08-30,https://bradley.net/
01-Jun-2021,Bill,07.31,00.00,"134,306.80",fCaB3ABC49bF713,1614,Dorothy,Vance,Sweeney-May,Nunezbury,Oman,+1-796-636-6677x9002,3573602786,shorton@nolan.com,2021-08-11,http://www.ochoa-rose.info/
01-Jun-2021,Miscellaneous,26.00,00.00,"134,332.80",D9544D1Ba89D1c8,2545,Perry,Moody,Evans Ltd,North Susanmouth,Israel,943-114-1789,049.390.4695x7828,harperalfred@ford.info,2021-03-25,https://www.roberts.com/
01-Jun-2021,NEFT,00.00,"16,791.60","117,541.20",C0eDb5e7ee1dbfA,783,Adrienne,Bowers,Leonard-David,Diazhaven,Burkina Faso,194-635-7007,001-281-717-0845x16063,davidkatrina@rose.com,2020-03-22,https://vang.biz/
01-Jun-2021,Transfer,131.00,00.00,"117,672.20",Cb91d3DDF9e3D5D,8525,Kelsey,Gould,Garrett Group,West Heather,Belize,(774)064-1646,130-698-5083,karenleach@rush.net,2021-03-02,https://stanton.net/
01-Jun-2021,Cash,00.00,"58,836.10","58,836.10",d0D80547aD45beA,7505,Martha,Bush,Weaver Ltd,New Danamouth,Azerbaijan,589-139-2372x06877,+1-270-573-0732,erodriguez@mosley.info,2021-11-29,https://yoder.com/
01-Jun-2021,Reversal,00.00,"58,836.10",00.00,beE9583aeb96e4A,9078,Dennis,Joseph,Morse-Mckee,North Melissa,Paraguay,001-703-594-6539x54244,667-134-1482x899,kendra81@vasquez-jenkins.info,2021-05-16,https://www.cannon.com/
01-Jun-2021,Transfer,"3,047.10",00.00,"3,047.10",93603f57EaC25A5,4024,Kerry,Buck,Wise-Sanchez,West Jennaland,Macedonia,(131)363-4286,(696)656-2149,theresa07@roth.biz,2022-02-10,http://brennan.com/
01-Jun-2021,Bill,00.00,"1,015.70","2,031.40",Bdfb94c29dd34FF,1854,Kaitlyn,Jefferson,"Riddle, Nelson and Beard",Roweburgh,United States of America,(573)103-1010,(730)390-0577x2847,kmays@parks.com,2021-10-04,https://www.sweeney.org/
01-Jun-2021,Commission,00.00,338.57,"1,692.83",CCEF2Aa8B663F5E,1702,Lacey,Madden,"Wheeler, Sandoval and Gay",New Daniel,Estonia,437.467.6644x7230,940-053-3708x2393,zmaldonado@bass.com,2022-01-31,http://www.maldonado-armstrong.net/
01-Jun-2021,Reversal,00.00,169.28,"1,523.55",F91F83c423F5bD4,3275,Herbert,Livingston,Huber Group,Jesseview,Ecuador,+1-691-779-7932x599,223.793.5696,harrissean@wise-sloan.biz,2021-11-14,https://cochran.net/
01-Jun-2021,ATM,00.00,507.85,"1,015.70",25b867D7ADcdbc8,9391,Denise,Berry,Mcintyre-Lawrence,Lake Meghan,Cyprus,300.729.6290x9467,(218)580-8525,eileen81@prince.net,2021-05-14,http://pineda.com/
01-Jun-2021,Interest,00.00,507.85,507.85,A6Dd3dB5bA44D3e,6165,Brian,Mccormick,"Foley, Cortez and Durham",Natashaland,Angola,001-545-162-9350x33238,316-806-7075x645,wwatts@dalton.com,2020-02-10,http://www.mcpherson-fischer.biz/
01-Jun-2021,ATM,"1,935.00",00.00,"2,442.85",0E4A43238802a3a,2083,Michael,Mcfarland,Sparks Ltd,Sandyport,Nigeria,7932786825,001-645-762-3145,brenda93@knox-padilla.com,2020-10-12,https://www.haynes.info/
01-Jun-2021,Debit Card,00.00,814.28,"1,628.57",Fe5cF5C0f05C194,3223,Clayton,Peck,Ewing-Willis,Helenmouth,Liechtenstein,001-544-677-7045x4042,(613)827-3134x4886,jphelps@roach.com,2021-09-05,http://www.hayes-miller.net/
02-Jun-2021,Interest,"748,612.00",00.00,"750,240.57",aE954839a03D5b5,2741,Tasha,Matthews,"Parks, Pineda and Mendoza",South Walter,Venezuela,(387)086-9534x26661,001-781-566-8485x325,noahdominguez@reyes-snow.com,2020-03-28,http://lowe.net/
02-Jun-2021,Reversal,256.00,00.00,"750,496.57",2aeaEcE5a7e7d59,7031,Tristan,Gomez,Luna Group,East Deborah,Austria,331.827.7748x244,900.151.1942x118,lhahn@johnson-chambers.info,2022-03-08,http://navarro-little.com/
02-Jun-2021,RTGS,"101,946.00",00.00,"852,442.57",E80a2C0b1dcEBDa,3927,Beverly,Morton,Guerrero-Morrow,West Peggybury,Algeria,298-789-8903x60076,535-130-6363x04970,rjames@guerrero.com,2020-11-22,http://henderson.com/
02-Jun-2021,Tax,00.00,"284,147.52","568,295.05",3143ab48A6A6f3f,6253,Pam,Dunn,Dudley and Sons,East Jessemouth,Angola,001-382-793-0649x879,079.002.1443x338,juliabutler@todd.net,2020-09-24,http://fox.com/
02-Jun-2021,Debit Card,"45,591.80",00.00,"613,886.85",97e1CB981A1691C,3249,Robert,Leon,"Riggs, Larson and Rojas",Lake Cassieberg,Iceland,(838)069-6468,782.031.0755,dukeleon@wilkins.com,2021-06-09,https://jacobs-boone.com/
03-Jun-2021,Commission,00.00,"102,314.48","511,572.38",b33d8d8A8a0ba5B,8517,Roger,Wagner,Sawyer and Sons,North Gabriellestad,Philippines,624.249.9946,964.048.4362x691,haleylloyd@skinner.info,2020-01-03,https://www.parsons.com/
03-Jun-2021,Reversal,00.00,"255,786.19","255,786.19",6FE3aDBdC1BBDdE,1104,Leroy,Taylor,"Silva, Mclaughlin and Haynes",New Susanview,Sierra Leone,789-388-3973x5555,862-868-1448x7789,rebekahescobar@best.com,2021-02-23,http://www.cole.info/
03-Jun-2021,RTGS,"613,763.75",00.00,"869,549.94",5391DfeAEeA4c8A,8077,Martin,Kelley,"Hawkins, Underwood and Weaver",Schneiderstad,French Guiana,942-749-3894,001-972-874-8952x4756,jerome17@farmer-rubio.info,2022-01-19,http://www.becker-guerrero.info/
03-Jun-2021,Bill,427.00,00.00,"869,976.94",78ef6B3B256BaF2,4347,Xavier,Stanton,Singleton PLC,Tammieview,Lesotho,+1-964-303-7859x5992,620.349.2774x951,waynejacobson@kidd-terry.org,2021-09-05,https://velazquez-spencer.com/
03-Jun-2021,Cheque,02.83,00.00,"869,979.77",F1ceFabDBAbdE1f,1589,Tammie,Lane,Moody Inc,Sheltonland,Japan,001-136-220-1282x112,988-735-0598x14165,isims@jimenez.info,2021-08-08,http://miranda.com/
03-Jun-2021,Cash,"2,934.50",00.00,"872,914.27",1cBAdC365B1D194,8060,Glen,Payne,"Reyes, Cobb and Newton",North James,Honduras,953-535-4339x2890,931-533-6106x7189,christie61@phillips.info,2021-08-21,http://hays.com/
04-Jun-2021,Cheque,52.50,00.00,"872,966.77",3782d1AbCF86496,2519,Leonard,Cohen,Castro-Rodgers,West Grant,Tunisia,882.798.7207x43514,(535)121-4703x1879,emcdaniel@chung.org,2020-02-19,https://porter.com/
04-Jun-2021,Debit Card,"56,338.60",00.00,"929,305.37",1188C7553bDB6cd,2717,Micheal,Knight,Barrett and Sons,East Rose,Croatia,294.648.9937x128,(274)483-1425,katherine15@elliott-warren.info,2021-07-22,http://hayes-crosby.com/
04-Jun-2021,Tax,53.00,00.00,"929,358.37",d7f67f3cC13506c,8632,Nichole,Miranda,Bell-Giles,Mejiamouth,Djibouti,592.999.2729,(163)887-3896x3933,zkey@small-hickman.com,2021-12-25,http://www.fitzpatrick-haynes.com/
04-Jun-2021,Cheque,00.00,"309,786.12","619,572.25",F7d5CEbbE72a432,9821,Stuart,Norman,"Carr, Camacho and Forbes",New Patrick,Vietnam,406.736.8965,589-651-5432,peter47@gallagher-stewart.biz,2021-12-26,https://www.parrish-mathews.net/
04-Jun-2021,Debit Card,00.00,"123,914.45","495,657.80",c0F95C4823CfbAd,1867,Lori,Fritz,Ramsey-Henry,West Anitafurt,Gibraltar,869-161-3806x72773,(620)496-6950,mandy36@benson.biz,2021-06-11,http://clayton.com/
04-Jun-2021,RTGS,"1,650.00",00.00,"497,307.80",c6049BfA0AF2888,6351,Cody,Donaldson,King-Yoder,West Tonimouth,Guinea,761.117.3563x0122,001-986-430-3259x793,rparks@galloway.info,2020-03-28,https://www.benson-ewing.com/
04-Jun-2021,NEFT,50.80,00.00,"497,358.60",8AAe7FA22CDBefc,5007,Courtney,Mcmahon,Atkinson Group,Robertsonshire,Grenada,(930)131-0206x824,(438)771-0099x35592,tammymcdonald@chambers-hancock.biz,2021-08-11,https://anthony-moses.org/
04-Jun-2021,Tax,00.00,"497,358.60",00.00,8C45ed8c32fee9b,5629,Angie,Bolton,"Nguyen, Richard and Zuniga",New Frederickburgh,Central African Republic,7945064210,201.217.8801x9892,chase81@beasley-gibson.com,2020-05-16,http://walton-walls.biz/
04-Jun-2021,Reversal,"2,432.00",00.00,"2,432.00",757E4594a9B866B,5020,Nicholas,Case,"Dudley, Lopez and Roman",Sheliaview,Paraguay,001-383-581-0410,934.966.5958x730,sheila74@haney-reilly.biz,2020-10-20,https://www.schroeder.info/
04-Jun-2021,Interest,00.00,"1,216.00","1,216.00",4528d6aBf2Aa4D3,7976,Paige,Hobbs,Valdez Group,Rebekahchester,Montserrat,+1-192-498-7362x89206,356-227-9021x9108,arivas@manning.com,2022-05-01,https://www.rasmussen.info/
04-Jun-2021,Miscellaneous,360.00,00.00,"1,576.00",d3dbD203D24Cdf4,9454,Brenda,Wagner,Pugh-Buckley,North Philip,Nepal,581-933-7515,921-569-7285,huffmanjacqueline@odom.com,2020-07-27,https://burke.info/
04-Jun-2021,IMPS,"28,216.06",00.00,"29,792.06",ceEabAe50A0f63b,8401,Steven,Barrett,"Robles, Gentry and Barker",West Grant,Singapore,962-837-9447x102,001-310-449-6675x619,jenniferbanks@floyd-frank.com,2021-10-27,http://mclean.com/
04-Jun-2021,Bill,00.00,"14,896.03","14,896.03",ed5f59dbfDdEbaF,8713,Robert,Huerta,Rodriguez and Sons,Hahnside,Haiti,062-512-5488x42310,439-471-8366x452,janet46@morrow.com,2020-09-30,https://www.ho.com/
04-Jun-2021,NEFT,04.00,00.00,"14,900.03",fA88e15C5f93faB,2969,Jill,Grant,"Hunter, Davidson and Boone",Gordonstad,Indonesia,001-706-313-8366x118,(648)629-5676x0894,allenmiranda@acevedo.info,2020-03-15,http://www.haas.com/
04-Jun-2021,Tax,"20,986.66",00.00,"35,886.69",D5d2aEf36B2f3b3,7293,Shelia,Adams,Chase Ltd,West Max,Armenia,788-426-4348,418.807.0458,villagabriella@petersen.com,2022-03-31,https://bryant.org/
04-Jun-2021,Interest,00.00,"11,962.23","23,924.46",7dA33Ad5c070D88,1291,Colton,Zavala,"Flynn, Joyce and Nunez",Hayesfurt,Northern Mariana Islands,891-987-1874x3280,001-790-373-0047,gjohns@faulkner.biz,2021-03-21,http://www.ball-lynch.info/
04-Jun-2021,NEFT,"1,257,794.75",00.00,"1,281,719.21",35F1d7ACF1E98ee,2276,Omar,Holder,Meyers-Braun,Alisontown,Grenada,6336966007,+1-515-813-1908x210,isaiahduarte@buck.net,2020-06-20,https://www.juarez.biz/
04-Jun-2021,Bill,00.00,"640,859.61","640,859.60",D1EC6F296dA3cCc,2646,Melinda,Nicholson,Graves Group,Copelandmouth,French Polynesia,348.733.4290,+1-035-486-9530,meredith75@thomas.com,2020-04-18,https://www.yu.com/
04-Jun-2021,Tax,00.00,"640,859.60",00.00,FFC1aE0c26c3DD5,1510,Meghan,Young,Terry-Pacheco,Wolfeshire,Azerbaijan,813-377-4407,663-894-5928x6808,hendrickscole@cabrera-miles.com,2020-10-31,https://www.petersen-castro.info/
04-Jun-2021,Commission,03.21,00.00,03.21,eBBB27E8e5CfcBb,3088,Bradley,Adams,Ewing-Dunn,Lake Martinfort,Poland,+1-834-702-7572x544,001-364-003-0064x8210,egarner@chavez.com,2020-03-14,https://chen.com/
04-Jun-2021,Interest,00.00,03.21,00.00,1dB2fC4eBD7fABc,3288,Evelyn,Buckley,Hull-Humphrey,New Christian,Greenland,109-165-0759x3094,7008231464,marconeill@joyce-dennis.biz,2022-03-27,https://www.cannon-singh.org/
04-Jun-2021,IMPS,64.00,00.00,64.00,aEdAAbcf77908A8,4211,Breanna,Duffy,Daniel-Ford,Danielsborough,Israel,+1-286-826-6093,846.294.5818,alishawoodward@osborn.biz,2021-05-24,http://www.sharp.biz/
04-Jun-2021,Transfer,00.00,08.00,56.00,4fd5eE784ff78FD,1661,Eugene,Good,"Sutton, Crane and Archer",New Shelia,Gambia,940-455-4778x47481,164.035.5681x628,greg88@day.com,2020-08-07,http://herrera-atkins.info/
04-Jun-2021,ATM,00.00,14.00,42.00,4096c18Ffe12d1f,6977,Tanya,Peters,Brock and Sons,Graceburgh,Korea,+1-907-371-1962x6132,347-011-0000x66073,jillian40@patel-banks.com,2020-06-18,http://suarez.com/
04-Jun-2021,Bill,01.00,00.00,43.00,Beb0D2e4BA54a51,22,Roy,Brock,Becker-Woodard,Port Martha,Zimbabwe,001-102-869-0189x1414,303.040.0780x2768,ldelacruz@spence.com,2021-06-27,https://www.norman.org/
04-Jun-2021,Purchase,00.00,07.17,35.83,7BB5a237b72a048,3517,Chloe,Nielsen,Esparza-Pena,Vaughanbury,Mauritius,594-683-0828x21114,001-652-794-5116x6369,rickey48@burns.com,2022-03-10,http://hall.biz/
05-Jun-2021,Cheque,"3,826.87",00.00,"3,862.70",dEECf5ee84cFe16,5992,Carl,Haley,Johnson-Carson,East Diamondburgh,Tuvalu,567.131.1897x75593,6033767997,nortoncrystal@levy.com,2020-03-31,http://terrell.com/
05-Jun-2021,Tax,00.00,643.78,"3,218.92",d5D381A204e861e,9336,Clinton,Mccarthy,"Mcconnell, Pugh and Powell",West Ruben,Macao,(491)608-1759,(545)110-8682x7165,michealcooper@mendoza-conley.com,2022-01-08,http://www.potter.com/
05-Jun-2021,RTGS,00.00,"1,609.46","1,609.46",a54Ccdf893A10eA,5697,Darryl,Flynn,Gibson-Salinas,Tracytown,Montserrat,(378)466-4147x7865,372-745-6798,amanda77@price.biz,2020-02-02,https://www.owen-roberson.com/
05-Jun-2021,ATM,00.00,201.18,"1,408.28",f20a7dcbD2AF1F6,5305,Norman,Ortega,"Lindsey, Simmons and Ponce",Kerrburgh,Saint Martin,+1-764-805-7030,+1-379-526-5536x48893,bglover@mcdonald.org,2020-06-07,https://www.wise-lamb.biz/
05-Jun-2021,Transfer,00.00,281.66,"1,126.62",c3394dF125Ac1d1,8106,Spencer,Short,Avila and Sons,Waltersmouth,Macedonia,(395)587-5477x1755,156-897-9021x4857,nichole25@melendez.com,2020-04-05,https://mcmillan.biz/
05-Jun-2021,Commission,00.00,187.77,938.85,e726c15179C9b55,7019,Howard,Atkins,"Lin, Mosley and Day",Lake Melinda,United States of America,001-639-951-2835x81119,748.678.4710x38369,vbenitez@huff.org,2021-04-17,http://oconnor-braun.net/
05-Jun-2021,Purchase,"28,081.23",00.00,"29,020.08",513Ef7dd2CF46b2,8920,Elaine,Pham,"Henson, Maldonado and Cole",Coltonbury,Spain,156-075-1370x5842,001-705-025-5491x720,caitlin46@rose.net,2021-04-06,http://simmons.com/
06-Jun-2021,Commission,"251,422.00",00.00,"280,442.08",2Ea833b26e7Cb4e,7613,Gina,Pitts,"Parks, Bonilla and Baird",Spearsfort,Liechtenstein,+1-829-445-3636x1423,001-396-112-6366x954,casey10@delacruz.com,2020-07-14,http://casey.com/
06-Jun-2021,RTGS,"1,701,924.20",00.00,"1,982,366.28",0A0EFB6DDB9EB59,2194,Mackenzie,Hancock,Zhang-Mcconnell,Reynoldschester,Palestinian Territory,+1-418-782-5236,001-902-062-3247,christinabass@glenn.com,2021-08-03,https://bean-woodward.com/
06-Jun-2021,IMPS,"7,519.59",00.00,"1,989,885.87",42eb7aBB5beD3bf,7654,Eric,Michael,"Shannon, Huber and Rasmussen",South Joefurt,India,(190)135-3639,(863)570-9722x4738,connor93@coleman.com,2021-10-20,http://lam-villanueva.com/
06-Jun-2021,Cheque,00.00,"284,269.41","1,705,616.46",adc155A42a8FEFa,1926,Janice,Garrison,Nunez Ltd,South Edwin,Mauritania,231-007-9710x4571,341-180-2305x81183,pedro48@page.com,2020-10-21,https://www.clayton.com/
06-Jun-2021,Tax,"2,048,327.50",00.00,"3,753,943.96",EE80FfDDe9fb722,5586,Eileen,Craig,"Bailey, Sanders and Haley",Port Antonioshire,Tanzania,792-238-8526,360-976-9787x92393,isabella56@shepherd-wade.com,2020-06-02,http://www.shaw-ayers.com/
06-Jun-2021,Commission,"1,593.60",00.00,"3,755,537.56",8F9e8A45A206a69,9292,Jackie,Wong,"Duran, Cortez and Mccullough",Lindseyland,Afghanistan,772-065-3283,892.689.9330x291,kathleenfranklin@cunningham.biz,2020-04-10,https://lyons.biz/
06-Jun-2021,Interest,00.00,"751,107.51","3,004,430.05",fCDd81Aa0cADD38,9959,Caitlin,Tate,"Howe, Bates and Forbes",North Latoyafurt,Norway,5274550159,(586)291-2525x0018,gwendolynlam@chang.com,2021-09-29,http://gonzalez.com/
06-Jun-2021,Miscellaneous,00.00,"500,738.34","2,503,691.71",5Ffc1d1A7177cBd,5370,Francis,Townsend,"Hobbs, Bartlett and Harmon",South Marcview,Bermuda,306.059.6320x729,377-631-7023x86821,fhuang@crawford-avila.com,2020-12-16,http://gentry-york.info/
06-Jun-2021,Commission,00.00,"1,251,845.86","1,251,845.86",5fC3f10EfdE6A1B,3786,Aimee,Grimes,"Padilla, Oneal and Best",New Edwin,Colombia,(737)439-0256x807,+1-524-047-7263x0152,hectorandersen@hurley.com,2020-08-26,https://gilbert-curry.com/
06-Jun-2021,Tax,00.00,"417,281.95","834,563.91",9370FfBbE0Eb03e,6189,Kaitlyn,Solomon,Padilla Ltd,Goldenview,Cambodia,+1-818-041-8162x50349,9256249153,derrick36@hanson.com,2020-12-23,https://www.weiss-oneal.net/
06-Jun-2021,Bill,"1,266,396.00",00.00,"2,100,959.91",1d7cf54E67cfc3d,4278,Loretta,Riggs,Jensen Inc,Craigville,Mozambique,473.493.9985x998,001-473-399-2322x6335,kelseywatkins@gillespie-prince.info,2021-12-13,https://www.cameron-villarreal.info/
06-Jun-2021,Cheque,00.00,"210,095.99","1,890,863.92",E30e361B14eD1Ec,1639,Bridget,Benton,"Beck, Butler and Duran",Erinfort,Russian Federation,612-119-6547,092-153-0362,wesleywalter@whitaker.com,2022-04-21,https://greer.net/
06-Jun-2021,Reversal,00.00,"630,287.97","1,260,575.95",86DA925B478DB0f,1659,Jorge,Patrick,"Benton, Blair and Wolf",Chaseland,Poland,545.112.6471,(544)966-3686x6711,krystal75@ware.com,2021-12-26,https://murray.com/
06-Jun-2021,Bill,00.00,"180,082.28","1,080,493.67",F4Df75bB26B0FB6,8193,Matthew,York,Welch and Sons,North Andresmouth,Uganda,386.530.2651,195-087-9697x947,hodgessophia@harper.com,2021-05-17,http://turner.biz/
06-Jun-2021,IMPS,"29,475.00",00.00,"1,109,968.67",e90BDb1cFa1072A,3271,Wyatt,Ibarra,"Bryant, Escobar and Porter",West Jasminemouth,Honduras,702-970-6647,+1-817-054-4185x095,qvillegas@page.com,2022-04-15,http://roy.info/
06-Jun-2021,Miscellaneous,"6,085.00",00.00,"1,116,053.67",aefCBd26Fc3E9Fb,6371,Cheryl,Ramos,Morris-Floyd,Mccartyhaven,Somalia,001-111-164-3967,(475)102-3490x866,fdavis@dickerson.com,2021-08-03,https://odonnell.com/
06-Jun-2021,Debit Card,00.00,"279,013.42","837,040.25",EF0dcDf4EeF1CC6,9036,Toni,Nash,Davis Group,Owenschester,Madagascar,623.835.5112x8429,001-236-711-1266x89503,autumnbrennan@estrada.org,2021-10-06,https://www.carter.net/
06-Jun-2021,Purchase,02.00,00.00,"837,042.25",D894CeaA225BdF0,5567,Mia,Newton,Lucero-Ryan,Kimberlyview,Lesotho,001-514-679-4175,(652)980-5569,wayne07@frank.com,2021-01-11,https://campos.com/
06-Jun-2021,RTGS,"24,202.20",00.00,"861,244.45",bA8addb8ABfbEAF,3849,Brent,Valdez,"Knight, Horn and Reed",West Xavier,San Marino,214-956-3703x0855,+1-318-423-0812,jillthornton@hardin.com,2020-03-20,https://mcknight-gilmore.com/
07-Jun-2021,ATM,00.00,"95,693.83","765,550.62",a19f7e350abECff,5473,Arthur,Dorsey,Wilcox Ltd,Lisaside,United States Virgin Islands,687-171-7144x6493,4303753359,mdixon@bates.com,2021-07-29,https://www.benton.com/
07-Jun-2021,Miscellaneous,00.00,"382,775.31","382,775.31",59EED312CCA35F5,6580,Luis,Lang,"Mccoy, Wang and Moss",Lake Hannah,Cote d'Ivoire,001-088-260-1755x78482,2892503111,iturner@shields.com,2020-10-10,http://www.price.net/
07-Jun-2021,Debit Card,00.00,"42,530.59","340,244.72",7D07A123cDaebfB,2327,Darius,Howard,Wong PLC,Port Kiara,Wallis and Futuna,(363)202-6090x16483,+1-355-472-0719x51811,mistyluna@maldonado-roberts.com,2021-05-04,http://colon.com/
07-Jun-2021,ATM,"1,819,005.00",00.00,"2,159,249.72",dEDa1a7Acf11A2f,2586,Miranda,Villa,Cummings LLC,Lake Davidhaven,Uzbekistan,+1-185-920-3303x6156,0387183534,twalsh@macdonald.net,2021-05-12,https://www.sawyer.com/
07-Jun-2021,Transfer,02.00,00.00,"2,159,251.72",bfa3b8f1D2BD11D,2678,Frederick,Bullock,"Costa, Rice and Stein",Tracieside,Tonga,363.977.1199x4895,001-446-842-9584x81384,hayleyweber@gilbert.com,2021-08-31,https://travis.com/
07-Jun-2021,Reversal,00.00,"239,916.86","1,919,334.86",Cf119AA28EddAaa,6037,Michael,Rios,Holder PLC,Lake Shellymouth,Bolivia,606.175.8654,646.259.9978,marioporter@jordan-oconnor.com,2021-01-26,http://shepard.com/
07-Jun-2021,Cash,"1,846,870.25",00.00,"3,766,205.11",e144acaeAC1CAac,5515,Kathy,Brewer,Hughes-Riley,New Tara,Uganda,001-558-882-8195x4006,164-433-1760,mpowell@moreno-villa.com,2020-06-21,http://bradley.com/
07-Jun-2021,Cheque,23.22,00.00,"3,766,228.33",eDdbcf3Cef7cFFe,1465,Dana,Thomas,"Holloway, Berry and Brennan",South Meaganchester,American Samoa,7206651395,038-632-4229,summerball@beard.com,2022-04-18,http://hester-graham.com/
07-Jun-2021,Purchase,00.00,"1,883,114.17","1,883,114.16",e8D652f7548AA7b,4423,April,Gonzales,"Guerrero, Doyle and Khan",Lake Shellyfurt,Seychelles,193-687-6250x05644,001-365-944-4918,tammie99@horton-wise.net,2020-07-01,http://www.stanton-caldwell.biz/
07-Jun-2021,RTGS,"3,563.77",00.00,"1,886,677.93",D3adB8EcC411db8,2649,Mathew,Choi,"Mason, Ibarra and Pace",East Gina,Somalia,524-019-0586x32049,279-862-5911x704,alejandro59@mcintosh.com,2021-07-20,http://www.kline-lozano.com/
07-Jun-2021,Debit Card,06.00,00.00,"1,886,683.93",e40FDBc2F4a009C,5897,Makayla,Burns,Alvarado Group,West Thomasburgh,Seychelles,001-235-196-7139,813.560.9994,xkrueger@chandler.com,2021-10-19,http://www.randolph.com/
07-Jun-2021,NEFT,"21,954.80",00.00,"1,908,638.73",aea7dbBe7ebf2aC,3922,Gilbert,Randall,"Klein, Wade and Quinn",East Jacobhaven,Isle of Man,(235)313-0778,001-367-416-5397x597,shahbrett@fry.com,2020-06-22,http://crawford.net/
07-Jun-2021,Bill,00.00,"954,319.37","954,319.36",8DFF51276FBbfE6,277,Angel,Garcia,Sutton-Johnson,Claireton,Brunei Darussalam,818-047-4846,674-596-0383x764,malonejanet@harvey.com,2021-07-27,http://www.zimmerman-michael.org/
07-Jun-2021,Transfer,00.00,"318,106.45","636,212.91",29AEFEE6fe1DaE2,1031,Angie,Lynch,"Foster, Mcintosh and Sandoval",Colleenport,Sao Tome and Principe,001-041-802-7317x11370,(768)835-2406x0642,gdavenport@bradshaw-shaffer.biz,2021-02-08,http://www.murillo.org/
07-Jun-2021,Bill,04.04,00.00,"636,216.95",b1aF5479A44e168,5470,Ray,Meyer,Novak-Steele,South Zoebury,Hungary,001-175-218-2438x214,(127)874-8343,snowjim@murphy.net,2020-08-21,http://clayton.com/
07-Jun-2021,Transfer,00.00,"159,054.24","477,162.71",0aaf8c613B18f0F,2833,Joan,Hardy,"Schmidt, Colon and Craig",Elaineville,Aruba,001-502-385-2305x9698,+1-876-767-6625x49244,qfoley@patton.com,2022-01-19,https://pollard.com/
07-Jun-2021,NEFT,00.00,"238,581.36","238,581.36",F196D46EbfbA82f,3711,Riley,Dickson,Logan-Chambers,Port Shelly,Uzbekistan,526-837-9911,001-643-608-3302x3445,tracey47@ayala.com,2020-11-26,http://www.glover.com/
07-Jun-2021,IMPS,03.88,00.00,"238,585.24",846eFdCc7dC3da4,5860,Malik,Henderson,"Salinas, Kline and Austin",West Carly,Saint Pierre and Miquelon,001-333-398-0191x263,(967)236-5311x13603,spencerangie@fuentes-finley.com,2021-04-08,http://www.hicks.com/
07-Jun-2021,Interest,00.00,"79,528.41","159,056.83",Ba5d97ccb36E6B6,6902,Denise,Sawyer,Lyons LLC,North Warrenshire,Belarus,001-565-991-9313x05394,1194644018,kerri33@gates.com,2020-10-17,https://zamora.com/
07-Jun-2021,RTGS,"1,783,401.00",00.00,"1,942,457.83",f8f2FeFbFa8F6C4,4039,Kayla,Page,"Boone, Stanley and Booth",Lake Nicole,Egypt,001-878-439-4702x58343,138.242.5581,tatkinson@butler.com,2020-06-04,https://www.herrera.com/
08-Jun-2021,Commission,00.00,"215,828.65","1,726,629.18",70f65f3fAb06177,1424,Cindy,Christensen,Wong-Santana,Claytonhaven,Slovakia (Slovak Republic),907.142.0938x5120,001-030-375-6458x77875,nlam@brown.net,2021-10-11,https://www.hendricks.com/
08-Jun-2021,Cheque,246.00,00.00,"1,726,875.18",4b23a37B0757BDd,9924,Clarence,Dunn,Bush-Ward,Alecborough,Belgium,276.152.1500x30677,758.027.0137,weissjake@ortega.info,2021-11-13,https://humphrey.com/
08-Jun-2021,Reversal,00.00,"215,859.40","1,511,015.78",eD0AF70b5a6568c,7499,Erica,Kramer,Copeland and Sons,North Albertfurt,French Guiana,421.765.5116,+1-813-595-0892x774,lynn66@holloway.net,2022-01-05,http://www.harvey.com/
08-Jun-2021,Miscellaneous,00.00,"755,507.89","755,507.89",6Bf825F2e2bE740,998,Colton,Galloway,Zhang-Villarreal,Lake Candicechester,Burkina Faso,001-140-235-0607,(755)823-8649,marie11@mullins.org,2020-03-29,http://www.fox.biz/
08-Jun-2021,Miscellaneous,00.00,"188,876.97","566,630.92",2dE43AbcE4aEA0E,5728,Melody,Wiggins,Kirk-Gross,Robinton,Mayotte,001-479-056-0416,952.434.3319x737,ymoody@caldwell.com,2021-12-12,https://carrillo.com/
08-Jun-2021,Purchase,"135,814.70",00.00,"702,445.62",dffD784D1b12BEE,7502,Shirley,French,Palmer-Hines,Starkside,Cape Verde,001-346-805-8479,001-688-615-8940x23939,mollyoliver@thompson-molina.net,2021-12-19,https://www.lutz.net/
08-Jun-2021,Debit Card,"25,260.08",00.00,"727,705.70",dC8CB3EcfC6BDaA,2505,Jesus,Cunningham,Kelley Group,North Melissa,British Virgin Islands,(943)527-4394,001-313-365-0667x9961,summer34@gates.info,2020-11-17,http://hanna.info/
08-Jun-2021,IMPS,00.00,"242,568.57","485,137.13",B14CA096FFd34Ba,1243,Colin,Garrison,Lowe and Sons,Lynnside,Portugal,(182)783-0273,759.294.4276,deaton@washington.info,2021-08-09,https://pope.info/
08-Jun-2021,Tax,"113,454.30",00.00,"598,591.43",ce0bCeb4e42f2B4,1264,Raymond,Rush,"Spencer, Bowen and Crawford",South Annchester,Christmas Island,7470169517,+1-792-374-1111x223,ronaldbennett@gregory.com,2021-09-10,http://www.moses.com/
08-Jun-2021,Tax,00.00,"99,765.24","498,826.19",e4aeF985Db6e3Bb,2943,Dalton,Blanchard,Jackson LLC,West Melody,Timor-Leste,319.531.8769x7938,+1-065-194-3631x5369,logan88@krueger.com,2021-06-10,https://www.oneill-brady.com/
08-Jun-2021,Debit Card,"1,262,344.20",00.00,"1,761,170.39",C28FD0e9cceEFcf,9419,Paige,Leblanc,"Higgins, Garner and Osborn",East Melodystad,Mali,963.828.2481,(888)550-6833x29410,sergiogarrett@gentry.com,2021-09-06,http://morales.com/
08-Jun-2021,Reversal,00.00,"587,056.80","1,174,113.59",58EAF74F7DC8Dbe,9546,Norma,Berg,Taylor-Douglas,Tannerberg,Sri Lanka,817.454.2077,132-204-1561,wyattelliott@campbell.com,2020-03-05,https://www.miranda.com/
08-Jun-2021,NEFT,"1,418.64",00.00,"1,175,532.23",Cd418655e7d267C,8338,Geoffrey,Townsend,Vance Inc,Lake Marvinburgh,Trinidad and Tobago,0334412243,398-964-9082x1984,ptownsend@mclaughlin.com,2020-06-07,https://brock.com/
08-Jun-2021,IMPS,00.00,"167,933.18","1,007,599.05",3e61E93EE5BdA6C,5330,Kerry,Giles,Sharp-Salazar,Eddieton,Czech Republic,+1-836-193-5017,106-257-0584x356,alejandroconley@burch.com,2020-12-10,https://barber.com/
08-Jun-2021,Cheque,"185,525.40",00.00,"1,193,124.45",67A22a0b165A0e5,8277,Tom,Clements,Velasquez PLC,Normaside,Guatemala,5249985504,726.092.9208x028,craigpeck@davies.biz,2020-11-30,https://www.taylor.com/
08-Jun-2021,Cash,06.10,00.00,"1,193,130.55",dA336c1aB4BE466,5130,Thomas,Munoz,"Cherry, Howard and Lowery",Zoeview,Fiji,(592)933-7720x32601,(391)578-7601x299,masongregory@blanchard.com,2020-03-04,http://www.holder-guerra.net/
08-Jun-2021,Purchase,00.00,"596,565.28","596,565.28",0Fbb27D0AD0e5eF,5718,Jocelyn,Mack,Dodson-Wise,Lake Connie,Argentina,074.161.9308x4485,656.174.2741x01999,kristie36@nielsen.info,2020-08-27,http://morrow.biz/
08-Jun-2021,Commission,00.00,"66,285.03","530,280.25",26b77e7CBf59856,5006,Connie,Porter,Benjamin-Galloway,Curtisfurt,Barbados,499.382.3292x88532,(449)116-4209,yolandapaul@durham.com,2020-03-21,http://www.combs.org/
08-Jun-2021,Bill,399.50,00.00,"530,679.75",75e1B0ECAD06F60,1216,Karen,Powell,Ballard Inc,Wallschester,Bahrain,(837)887-4976x23484,+1-692-477-5826x6040,nobleharold@lawrence-christensen.com,2021-03-31,https://reese.com/
08-Jun-2021,Transfer,00.00,"132,669.94","398,009.81",447fA5Eb7280F1B,3118,William,Mckinney,Vega Inc,Cooketon,Greece,0897336013,(106)102-3768x94948,jeffrey76@shelton-bray.com,2020-12-26,http://www.klein.com/
08-Jun-2021,IMPS,"4,075.18",00.00,"402,084.99",DD5f5df7fF3B78A,8788,Betty,Bryan,Grimes-Lara,Lake Tammy,Morocco,505-019-2831x6432,369-855-7032,mdurham@mcmillan-kaufman.biz,2021-03-01,http://rowe.com/
08-Jun-2021,NEFT,00.00,"402,084.99",00.00,C1dD8CC8B81F92B,815,Terrence,Hunter,Vaughan Ltd,Nixonfurt,Switzerland,490.304.4749x3318,(187)542-1660x49752,herbert99@simpson.com,2020-02-12,http://www.deleon.com/
08-Jun-2021,NEFT,"28,139.27",00.00,"28,139.27",0d17bEee6CcAe22,834,Jennifer,Booker,"Hopkins, Frederick and Wall",South Rachel,Reunion,342-905-6732,+1-430-361-1703x4186,ronnie20@sharp-foley.com,2021-03-09,https://taylor.biz/
08-Jun-2021,RTGS,429.00,00.00,"28,568.27",f80b8038baa9De3,5297,Meghan,Townsend,Bowman Group,Duaneton,Cocos (Keeling) Islands,(541)002-1423x916,358.581.4126x1627,hannahrobertson@leon-larsen.com,2020-12-27,https://www.navarro.com/
08-Jun-2021,Debit Card,00.00,"4,761.38","23,806.89",F24Eb26bFAE93E1,9306,Earl,Hebert,"Hester, Mcdaniel and Wiley",South Katie,Kenya,001-719-999-6391,001-894-633-3827,deborahgentry@mayo-bolton.org,2021-12-25,https://www.hawkins-goodwin.com/
08-Jun-2021,Purchase,"2,034,076.00",00.00,"2,057,882.89",A61F5cBF8Baf106,4985,Stefanie,Baker,"Sanford, Casey and Castro",North Aimee,Central African Republic,492.401.5682x785,372.684.8586,tommy90@berry-lane.com,2021-05-06,http://www.sellers.biz/
08-Jun-2021,Commission,00.00,"293,983.27","1,763,899.62",b1AACCDDea8Fece,3427,Rickey,Arellano,Davenport-Chapman,South Mistymouth,Tonga,(260)536-1877x9724,3002719451,shawncook@cardenas-guzman.info,2021-01-18,http://hatfield.info/
08-Jun-2021,Commission,00.00,"440,974.91","1,322,924.72",c7Ec9BD73e62deB,9704,Paige,Beltran,Rosario-Barajas,Salinasfort,Ethiopia,+1-119-901-5164,+1-225-345-5873x3467,lawrencehowe@york.com,2021-05-20,http://www.porter-bates.biz/
08-Jun-2021,Cash,56.52,00.00,"1,322,981.24",e1B07addD3A0eea,9442,Elizabeth,Cooper,"Wilcox, Fuller and Sloan",North Lucas,Peru,(522)898-9494,(518)932-0605,alexandercisneros@wright.com,2021-07-18,https://www.lane.org/
08-Jun-2021,ATM,"22,224.00",00.00,"1,345,205.24",089dDB025EB5DCf,3662,Franklin,Stephens,Ewing Ltd,East Johnnyland,Cook Islands,9920916632,+1-022-043-5176,jonathonpetersen@benjamin-vaughn.com,2021-06-08,https://long-sanders.com/
08-Jun-2021,Commission,120.65,00.00,"1,345,325.89",ADBDc0979A2cB5b,3593,Maria,Nolan,"Rivera, Floyd and Lucas",Marquezhaven,India,001-298-118-3215x5845,519.079.1582x2757,hayleychapman@petty-austin.com,2020-05-06,https://www.cannon-callahan.org/
08-Jun-2021,Interest,00.00,"134,532.59","1,210,793.30",4FAECeB4ff5EC4c,2812,Beverly,Howell,Gentry Inc,West Terrance,Egypt,081.368.6932x02989,7909268060,hornlucas@waters.org,2021-06-14,http://reeves-santana.com/
08-Jun-2021,NEFT,258.00,00.00,"1,211,051.30",ccFbE36B36DA8ca,906,Stacy,Wright,Mcmillan Ltd,Lanceburgh,Macao,(298)415-3714x8433,(084)259-2369,brittany22@blake.org,2021-04-12,http://www.perkins.biz/
08-Jun-2021,IMPS,00.00,"151,381.41","1,059,669.89",08800F76A7bb4c0,1936,Cathy,Stanley,Kline Group,Lake Hayden,Nepal,556-116-4958x14315,024-650-8735x25924,kirsten54@hansen.info,2020-12-09,http://mack.info/
08-Jun-2021,IMPS,00.00,"105,966.99","953,702.90",cb6Bfc5f51bfd7B,9333,Angela,Willis,Huber Inc,Morrowland,French Polynesia,229-641-6306,(730)856-7869,aimee57@harrington.com,2020-06-24,https://www.ortega-sullivan.com/
08-Jun-2021,Cheque,161.00,00.00,"953,863.90",2F93cB2Fe98c5CC,2824,Jackie,Larsen,"Zhang, Wiley and Reeves",Brettfurt,Sweden,715-018-8464,493.903.8174x313,leroy10@riggs.biz,2020-07-28,https://www.wang.com/
08-Jun-2021,Miscellaneous,01.00,00.00,"953,864.90",d7D3BCBeFf13f3e,498,Max,Stevens,Andrade and Sons,Port Andrea,Kiribati,001-828-822-9276x6667,+1-715-551-8609x19994,neilpittman@daugherty-atkins.net,2020-07-16,https://www.barajas.com/
08-Jun-2021,Cheque,00.00,"476,932.45","476,932.45",eaca8d4b8D3bcB1,6925,Adrian,Joseph,Travis PLC,Morrisonmouth,Djibouti,9577561599,(136)560-9541x0135,krasmussen@yu.info,2021-12-21,https://www.cherry.biz/
08-Jun-2021,Cheque,00.00,"238,466.23","238,466.22",77ECeDc4ECFE3e7,6055,Donald,Frank,"Hays, Shaw and Perkins",South Theresachester,Niue,085-270-5158x82630,001-752-467-4977x15704,xbarr@shelton.com,2021-12-27,http://www.mayer-wu.com/
08-Jun-2021,RTGS,"3,778.23",00.00,"242,244.45",eCEE08Fb05B4BBE,8455,Bryce,James,Bean Group,West Kristen,Syrian Arab Republic,001-448-418-6568x822,001-866-900-5528x295,davidmcdowell@wheeler-burgess.org,2020-06-25,https://stuart-hunt.biz/
08-Jun-2021,Debit Card,00.00,"242,244.45",00.00,4F1deABbaB7CdC2,7253,Wyatt,Villegas,Hanson Ltd,Blackburntown,Faroe Islands,+1-289-389-5304x7147,390.019.1646x8160,lutzclinton@livingston.com,2020-10-01,https://woods-dominguez.net/
08-Jun-2021,Miscellaneous,"13,763.00",00.00,"13,763.00",FAcCa20A01f1782,1707,Kellie,Davenport,Lewis Inc,Clinemouth,Antigua and Barbuda,1101291547,001-069-498-8492x022,maria02@becker.com,2022-03-28,http://ball.biz/
08-Jun-2021,Debit Card,00.00,"1,720.38","12,042.62",68AEaA6B9EfDE2f,4710,Ricardo,Morrow,Woodard Inc,East Max,Heard Island and McDonald Islands,789.882.5400x7795,(159)073-9653x1469,jenna90@clements-allison.biz,2021-07-23,https://quinn-davis.biz/
08-Jun-2021,Interest,"3,125.00",00.00,"15,167.62",9E667AC7abfA2eE,4599,Edwin,Barrera,Stout-Shelton,Mccluremouth,India,666.626.7424x7912,(393)780-3445,curtisnicholson@yates-howard.biz,2020-10-09,http://www.vaughan.com/
08-Jun-2021,Interest,00.00,"3,791.91","11,375.72",a2AefC8445B95AA,3151,Brooke,Contreras,Riggs Inc,North Jacqueline,Christmas Island,077.840.4906,(845)408-3984x7674,matthewfitzgerald@hernandez.info,2020-06-16,https://murray-robertson.com/
08-Jun-2021,NEFT,"557,475.50",00.00,"568,851.22",5934AD8B3Fd9C3A,2759,Stuart,Valenzuela,"Faulkner, Wallace and Hogan",Adamland,Finland,001-268-877-4774,841.501.7399x2679,sabrinafrye@gates.com,2021-05-27,http://keller.com/
08-Jun-2021,Purchase,494.00,00.00,"569,345.22",9A8e359AFb697CD,9900,Kristie,Crosby,Glover Group,Greenhaven,Myanmar,+1-971-169-6006x576,780.365.0598x607,calvinfrench@webb.com,2022-01-29,http://obrien.com/
08-Jun-2021,IMPS,00.00,"71,168.15","498,177.07",28Bd58ADeDbFB6a,9507,Kathy,Robinson,"Costa, Cook and Harmon",West Susan,Saint Martin,001-233-165-9507,+1-747-486-6850x0529,qabbott@le-harper.info,2020-04-18,https://www.charles.com/
08-Jun-2021,Cheque,"164,218.09",00.00,"662,395.16",AfC371dcd89dbC4,7395,Stephanie,Roy,Solomon Ltd,North Miguelhaven,Indonesia,(358)896-2140,720.671.2502,timvelez@matthews-rhodes.com,2022-02-09,http://www.rivera-mcgrath.com/
08-Jun-2021,Debit Card,12.70,00.00,"662,407.86",EB54EF1154C3A78,1,Heather,Callahan,Mosley-David,Lake Jeffborough,Norway,043-797-5229,915.112.1727,urangel@espinoza-francis.net,2020-08-26,http://www.escobar.org/
08-Jun-2021,RTGS,00.00,"165,601.97","496,805.90",cdc1D2a87296EFB,7937,Larry,Powell,"Hancock, Barker and Arroyo",Paulaburgh,Denmark,385.365.9380,(425)392-1565x8247,barnettgilbert@howell.com,2021-11-06,https://briggs.org/
08-Jun-2021,Cheque,00.00,"124,201.48","372,604.43",1c5515fEee8Cbb2,4352,Melinda,Schaefer,"Wilkinson, Matthews and Sparks",West Gwendolynview,Indonesia,001-996-020-8027x04528,673.882.8623x50601,stacy46@pham.biz,2021-07-14,https://cameron.com/
08-Jun-2021,Interest,00.00,"46,575.55","326,028.88",De404AD4E702f1F,9850,Bobby,Fernandez,Sims-Brock,New Katelyn,Ghana,+1-505-743-9247x16993,(955)306-9069,phillipsisabel@ingram-hebert.com,2020-01-11,http://www.cruz.com/
08-Jun-2021,NEFT,00.00,"36,225.43","289,803.45",dEC3fafcC3fC2D7,8476,Nichole,Medina,"Bauer, Castillo and Moss",South Darlene,Somalia,544-619-7554x894,920.112.9201x098,tammieschwartz@snyder.com,2022-02-10,http://waters.com/
08-Jun-2021,Debit Card,00.00,"48,300.58","241,502.88",2Dbea9dBC2FE0D3,9209,Luke,Whitaker,Hanson LLC,Carlaport,Venezuela,001-912-230-0189x07363,001-046-870-8180x5047,mariamoreno@flores-thompson.com,2020-07-05,http://weeks.com/
08-Jun-2021,ATM,00.00,"30,187.86","211,315.02",c64CC10d636a26a,7848,Levi,Townsend,Blevins-Yu,Baxterstad,Algeria,+1-675-796-0499x4927,001-848-534-4918x16121,cguzman@cooke.com,2021-12-19,http://barry.net/
08-Jun-2021,Commission,44.00,00.00,"211,359.02",dcbf5a3F6FBaEc3,2112,Marcia,Contreras,Hurst-Ashley,South Caseyton,Lebanon,379-373-2422x206,001-821-471-6902x7292,rtodd@hull.com,2022-02-22,https://www.collier.biz/
08-Jun-2021,Debit Card,"24,135.80",00.00,"235,494.82",599cC0d087A5796,9389,Chelsea,Stephenson,"Berg, Allen and Middleton",South Russell,Oman,219.542.2387x564,0042011218,moondarren@carrillo.com,2020-10-31,https://www.mora-wallace.org/
08-Jun-2021,Commission,"4,349.53",00.00,"239,844.35",0dAEF35b5cCAa82,6915,Aaron,Ortiz,"Gill, Roman and Blair",West Bradleyberg,Vanuatu,489-652-6564x3529,+1-694-510-8865x85848,jenniferleon@santos-atkinson.biz,2020-07-19,https://simon-hendricks.com/
08-Jun-2021,RTGS,"250,125.80",00.00,"489,970.15",aFb3A7eDDBc01dE,9358,Spencer,Murphy,Wallace-Bradford,Flemingville,Saint Martin,+1-220-825-0451x617,+1-827-031-3235,shelleyevans@obrien.com,2021-01-03,http://www.mcmahon.biz/
08-Jun-2021,IMPS,00.00,"97,994.03","391,976.12",21C1a2E1e9Cf6cC,71,Brandon,Robbins,"Stark, Deleon and Mann",West Erikview,Netherlands,422-099-2274x577,634.035.7567x20178,qmcdaniel@cruz.net,2020-12-20,https://www.acevedo-macdonald.net/
08-Jun-2021,Miscellaneous,00.00,"97,994.03","293,982.09",7F23F7acC9700EC,3061,Lorraine,Herman,"Berger, Barton and Huffman",New Michaela,Sudan,001-301-655-3175,533.040.0548x08673,hooverbenjamin@parker.net,2021-01-21,http://velez-shields.biz/
08-Jun-2021,Reversal,"32,328.00",00.00,"326,310.09",37DCa71E2C49dad,6112,Bianca,Frank,"Duncan, Collins and White",Robynshire,Tuvalu,364.972.7058x8378,442-441-1933,christine05@lopez-blair.info,2021-07-25,https://www.cunningham-padilla.com/
08-Jun-2021,Debit Card,04.00,00.00,"326,314.09",Ff6b1e9297D9aEA,4666,Jacob,Irwin,"Patton, Dorsey and Davenport",Kennedybury,Dominican Republic,693-852-2729x71569,001-357-723-9905,hlozano@dorsey.org,2020-02-12,https://mills.net/
08-Jun-2021,Cheque,44.49,00.00,"326,358.58",EFCD1FB1406Ec8F,1644,Candice,Orozco,Mcintosh Inc,Lake Reneefort,Zimbabwe,916.311.5483x22590,626-148-0874,ivanyoder@eaton.com,2022-05-17,https://davidson-dean.info/
08-Jun-2021,Cash,00.00,"36,262.06","290,096.52",0Cb63b5E6857ceE,3201,Bethany,Oliver,Moss Group,South Aaronside,Turks and Caicos Islands,(207)027-8662x6792,(700)220-2308x980,vvelez@coleman-rice.biz,2020-07-12,https://morse.net/
08-Jun-2021,Commission,00.00,"58,019.30","232,077.22",BB60B5cC15cF7d2,172,Bridget,Guerra,Dyer and Sons,Lake Debraside,Estonia,7457637395,827-598-8367,frederickmisty@carpenter-nielsen.net,2021-01-25,http://palmer-chan.org/
08-Jun-2021,Interest,00.00,"29,009.65","203,067.57",c672a7Ec1652ddd,1285,Whitney,Rojas,"Crane, Hebert and Velez",Port Bradleyland,Iran,(761)590-7983,001-663-320-0183,lovemaria@shepherd-mcfarland.net,2022-04-16,http://bullock-stevenson.com/
09-Jun-2021,Reversal,00.00,"22,563.06","180,504.51",b700f7Ec36DDcAd,3264,Robyn,Hill,"Hoover, Jacobson and Santana",New Andre,Montenegro,+1-694-562-0057x3452,+1-263-753-1926,allenjoel@kennedy.com,2021-05-23,http://www.allen-mccall.com/
09-Jun-2021,NEFT,63.00,00.00,"180,567.51",A458cb8Bee0b7Ea,3671,Michelle,Crane,"Ellison, Berg and Bridges",North Gabriel,Malawi,+1-321-868-2800x04575,+1-856-647-3509x753,nsingh@mccann.com,2021-07-09,https://www.kane.org/
09-Jun-2021,Cheque,"878,133.20",00.00,"1,058,700.71",edEfffe53c27D6D,7482,Carrie,Kennedy,Contreras-Terrell,Theodoreville,Lithuania,001-299-514-4799x28450,001-937-748-7591,mallory97@ray-dillon.com,2022-03-18,http://barrett.com/
09-Jun-2021,Purchase,00.00,"117,633.41","941,067.30",Ab5A877dB5866bE,1326,Maria,Mullen,Heath-Merritt,Dustinfurt,Netherlands Antilles,001-000-547-8099x273,(389)800-5956x13252,ufrench@tate.net,2020-03-02,https://www.powell-jackson.com/
09-Jun-2021,Debit Card,00.00,"94,106.73","846,960.57",f2897BCC311CF98,2652,Aaron,Mcgrath,"Villa, Maynard and Hernandez",Brookeshire,United States Virgin Islands,424-237-0336x51924,304.559.2307x875,hannah15@phillips-pineda.com,2020-12-15,http://baker.biz/
09-Jun-2021,Bill,"1,600,800.00",00.00,"2,447,760.57",Aa6c730c2c53EcD,8412,Stanley,Richard,Wiley LLC,Santosberg,Korea,235-644-9245,054.490.3842x311,nle@salazar-cabrera.info,2020-07-07,http://vega.biz/
09-Jun-2021,IMPS,"2,084.10",00.00,"2,449,844.67",D1fD4Fdcffa7A9A,1339,Pedro,Herman,Silva LLC,Port Cristian,China,+1-436-086-8884x6052,793.295.4048x69900,lmurillo@matthews.com,2021-07-08,https://kent-jones.net/
09-Jun-2021,Reversal,01.94,00.00,"2,449,846.61",F42529e02B94786,9844,Heidi,Gregory,Potter-Duncan,Jamesbury,Cocos (Keeling) Islands,112-720-7428x2877,601.059.1987x406,hbraun@sexton.net,2020-08-19,http://www.stevens.org/
09-Jun-2021,NEFT,00.00,"349,978.09","2,099,868.52",b447DbC633E65a0,7992,Denise,Browning,"Davies, Gould and Barker",North Cory,France,606.156.8226,563.816.2238x37092,rvalencia@jensen.info,2021-07-26,http://branch-hays.com/
09-Jun-2021,Purchase,00.00,"299,981.22","1,799,887.30",0CB6b49D995cB6a,3707,Taylor,Pittman,Hodge-Ramos,Karinaside,Fiji,(478)414-7283,664.162.7535x2124,ryansherri@collier-ritter.com,2020-03-16,https://www.brennan.org/
09-Jun-2021,NEFT,00.00,"449,971.83","1,349,915.48",1dd04E1E001F206,9911,Cheryl,Payne,Bryan-Ward,Elijahmouth,Uganda,(225)630-9854,+1-711-203-4407,thompsonbob@serrano.com,2020-03-03,http://blanchard.com/
09-Jun-2021,Miscellaneous,"166,048.62",00.00,"1,515,964.10",9Bd0A0ccF14BE5c,5379,Megan,Hughes,Ortega-Graham,Smallland,Latvia,+1-410-291-8441x1285,454-804-5543x34601,travisrivers@singh-hobbs.net,2021-11-20,http://abbott-dunn.com/
09-Jun-2021,IMPS,00.00,"303,192.82","1,212,771.28",Cb994EA466ae830,4743,Margaret,Carter,"Walton, Rowe and Hanna",Donaldland,Uruguay,634-283-6940x96754,(749)709-8352x581,cashley@bates.net,2020-11-28,http://www.herman.com/
09-Jun-2021,Bill,00.00,"151,596.41","1,061,174.87",00EA1C9FCb20FE2,4349,Linda,Gilmore,"Gonzalez, Brennan and Pugh",New Nicolemouth,Kyrgyz Republic,001-515-200-0285x187,(956)221-3411x01886,tracey12@pratt.com,2020-11-01,https://baker.com/
09-Jun-2021,Interest,175.50,00.00,"1,061,350.37",8D0bCEDAA2b6E32,7260,Penny,Farrell,Juarez-Levine,Daltonport,Cameroon,490-388-8228x3811,4298155748,saustin@buck-jefferson.biz,2020-08-04,https://cannon.com/
09-Jun-2021,Cheque,00.00,"106,135.04","955,215.33",f5c6f2bdf8d64BF,7216,Wesley,Trujillo,Adams and Sons,Goldenport,Niger,699.483.6571x355,310.356.9367x6095,apearson@carson-schmitt.com,2021-07-09,https://houston.com/
09-Jun-2021,RTGS,00.00,"106,135.04","849,080.29",3BC681EBdC551FD,8794,Allison,Roy,Horton-Maldonado,Carolineburgh,Zimbabwe,+1-393-992-6682x15632,001-868-785-6831x6130,lancemcknight@harrington.com,2021-11-22,https://www.joyce.org/
09-Jun-2021,NEFT,02.20,00.00,"849,082.49",D7Ba0FBF04dAd2f,8147,Gregory,Mitchell,Mercado-Rivas,Hendricksview,Monaco,001-675-333-8549x671,001-951-808-2242x12075,zwaters@conley.com,2020-03-24,https://wu.com/
09-Jun-2021,Cash,00.00,"121,297.50","727,784.99",BEfA2CBE462e561,1998,Natalie,Rosales,Johnston LLC,West Melissa,Niger,+1-008-522-5954x9262,(683)532-7801x3943,uboyle@kemp.com,2022-05-28,https://rogers.com/
09-Jun-2021,NEFT,"79,943.40",00.00,"807,728.39",E2cD6c1C328e61B,5378,Sheri,Hall,Ritter-Holt,Port Michaelamouth,Central African Republic,(229)736-5499x814,001-463-169-5637x306,lisacalderon@pittman.com,2021-12-26,https://galloway-jackson.org/
09-Jun-2021,IMPS,186.79,00.00,"807,915.18",Aa3bB6CfbcFFADE,6978,Julie,Park,"Garcia, Sparks and Quinn",West Tim,Taiwan,001-762-430-4210x04715,428-370-2016x271,oscar83@sherman.com,2021-02-05,https://www.duran.com/
09-Jun-2021,Bill,03.00,00.00,"807,918.18",ec75Fb9C6A0DcF1,39,Joyce,Foster,Randolph LLC,Nataliestad,Korea,655.928.6486,+1-966-669-6464,samuel97@wyatt.com,2020-10-29,https://www.schmitt.com/
09-Jun-2021,Cash,00.00,"201,979.55","605,938.64",66f3baa56CfCb9B,9006,Renee,Dodson,Nolan-Rowland,Ethanchester,Tonga,001-281-485-4039x93347,(809)783-3582x4732,desireesimon@ward.com,2020-11-02,https://dennis-maldonado.biz/
09-Jun-2021,Interest,00.00,"60,593.86","545,344.78",B5E0fcb337d5ECf,8530,Doris,Berry,Singh-Hahn,South Zacharyshire,Panama,777-504-5008x6758,(854)504-5790x85519,emmagilbert@craig.info,2020-05-11,https://harrell-savage.com/
09-Jun-2021,Interest,00.00,"77,906.40","467,438.38",dd3Ee8eF3cB6532,2891,Lee,Lane,"Dalton, Trevino and Schmidt",Nicoleville,Niue,001-713-670-2583,610.923.5819,jacobvelazquez@pearson.biz,2022-01-28,https://www.coleman-tyler.info/
09-Jun-2021,IMPS,00.94,00.00,"467,439.32",5df40AfE84eCDE5,2644,Darryl,Craig,Mcneil Group,Tylerview,Equatorial Guinea,(051)618-5198,(461)876-5979,ahull@jennings-golden.biz,2021-01-02,https://www.short-knox.com/
09-Jun-2021,Purchase,00.00,"155,813.11","311,626.21",760FE1bb4727eCC,4237,Mark,Hendricks,"Horton, Sanders and Matthews",Huertachester,Belgium,001-892-084-0399x83092,654.227.4185,reginald38@orozco-hahn.com,2020-06-19,https://www.mcdaniel.com/
09-Jun-2021,Purchase,"12,119.77",00.00,"323,745.98",fe8D20bAdFBBE8F,9257,Kristin,Downs,Collier-Graham,Lake Rodney,Greece,+1-441-040-9009,327.015.8719,ydudley@sparks.info,2022-03-13,https://bray-mayer.com/
09-Jun-2021,Miscellaneous,03.00,00.00,"323,748.98",A9aBbA57AF55c4c,6256,Zoe,Pittman,Crane-Wilkerson,Lake Martin,Niue,608.366.4980,301-160-9334x51469,wigginskerry@lucero.com,2021-01-09,http://www.curry.com/
09-Jun-2021,Transfer,04.00,00.00,"323,752.98",119a6EB0f60EcdB,3825,David,Miles,Welch-Whitehead,South Sherihaven,New Zealand,1137531857,(347)701-1618,paynetammy@mcmahon.info,2021-10-20,https://bullock-johnson.info/
09-Jun-2021,Transfer,00.00,"161,876.49","161,876.49",cD4f552CeAbd0ab,6162,Jeremiah,Schaefer,Diaz-Morse,Sheppardbury,Vanuatu,141.721.3451x6195,+1-321-031-7622x85490,syates@bell-conway.info,2022-02-11,https://guerra-phillips.com/
09-Jun-2021,Interest,"1,339.00",00.00,"163,215.49",f40407457D6ae00,9651,Colin,Bray,"Harrell, Lambert and Sexton",Jamieton,Peru,(713)788-4612x78976,375.274.3108x970,franklin06@everett.com,2021-01-21,https://blankenship.biz/
09-Jun-2021,Purchase,"981,895.75",00.00,"1,145,111.24",cFbdCAdcfbBA735,7381,Darren,Nolan,Lambert-Dennis,Lake Aimee,Falkland Islands (Malvinas),001-743-228-6430x4517,(897)826-3155x96973,cristian03@hopkins.biz,2021-01-12,https://www.greene.com/
09-Jun-2021,Interest,00.00,"163,587.32","981,523.92",AA4549c3Ba58Aa1,4314,Shane,Francis,"Valentine, Peterson and Costa",West Allisonton,Colombia,001-008-596-7689x5580,694-198-3626,basshenry@brandt.com,2020-02-08,http://kline.info/
09-Jun-2021,Reversal,00.00,"196,304.78","785,219.14",E3F17cB68a26fb1,5901,Jaclyn,Foley,"Pierce, Herrera and Lozano",South Luis,Guyana,+1-899-472-9928,001-562-627-2928,katelyngordon@decker-reed.info,2021-04-25,http://lang-dennis.com/
09-Jun-2021,ATM,00.00,"112,174.16","673,044.98",B2A4fEc9fa4FC39,2773,Bill,Andrade,Morrison-Parks,Port Theresahaven,Holy See (Vatican City State),049-239-6225x9348,001-527-193-6094,tbaird@peters-valdez.com,2020-03-13,http://mason.com/
09-Jun-2021,Cash,00.00,"96,149.28","576,895.70",AAa83DeeEb0aaAE,8891,Roberto,Shelton,"Wyatt, Hunt and Durham",Rebeccashire,Falkland Islands (Malvinas),001-073-585-5415x10160,441.548.4128x97231,foxclaire@strickland.biz,2021-08-21,http://www.chambers-rivera.com/
09-Jun-2021,RTGS,00.00,"144,223.93","432,671.78",b2cd2E4C6621E9A,7003,Jack,Ryan,Nash-Rowe,South Vincentmouth,Heard Island and McDonald Islands,756-246-4023x92312,+1-546-729-0163x2367,shanehumphrey@newton.com,2021-04-07,https://sexton-sandoval.com/
09-Jun-2021,Purchase,00.00,"72,111.96","360,559.82",aebeCeAFDc4a8D5,9823,Gabriella,Tate,Bradshaw LLC,Meredithborough,United States Virgin Islands,9195233401,001-839-681-1241x268,harveylorraine@jones-schaefer.com,2021-12-04,http://sullivan-bowers.com/
09-Jun-2021,Transfer,00.00,"72,111.96","288,447.86",Ea7C37fAeBdb0cb,1687,Trevor,Duarte,"Hoffman, Mcfarland and Montgomery",North Ann,Reunion,+1-135-960-6239,610-576-9545x00729,blakevalerie@hooper.net,2020-11-01,http://watts-carlson.com/
10-Jun-2021,Tax,00.00,"28,844.79","259,603.07",4fA018fb372a8EF,2355,Ryan,Bradford,Bennett-Mcfarland,Lake Yvette,Macao,001-998-883-6818x3196,+1-063-013-0220x82289,haneysonia@petersen.info,2021-03-27,https://www.benitez-chavez.com/
10-Jun-2021,Commission,00.00,"43,267.18","216,335.89",D5E21A26f50d2Fb,3569,Doris,Shaffer,Hart and Sons,Nicoleview,Zimbabwe,584-569-2734x8713,(022)080-7819,rosarioelijah@beard-barron.com,2022-01-08,http://www.henson.net/
10-Jun-2021,Cheque,00.00,"27,041.99","189,293.90",EC5DD5e4C70d6Fe,6243,Brenda,Perkins,Patrick Inc,West Erikaside,Comoros,039.143.2402,979-524-2577x4040,johnstonconnie@mccormick.com,2020-06-04,https://www.drake.com/
10-Jun-2021,Reversal,"213,213.00",00.00,"402,506.90",Be5FdBad65E28eC,7933,John,Stevens,Lamb and Sons,Andersenberg,Jordan,995-697-6044,(545)383-6319x59122,kendramayo@evans.info,2020-09-07,http://www.perkins-hurst.net/
10-Jun-2021,Cheque,00.00,"80,501.38","322,005.52",f4d5eAbe0dC4738,615,Kelsey,Dunn,"Trujillo, Castillo and Hudson",Keithchester,Ireland,(477)977-1002,001-044-566-6718x461,ujennings@downs.net,2020-08-08,http://www.valenzuela-kelley.com/
10-Jun-2021,Miscellaneous,"4,283.20",00.00,"326,288.72",8850C8f5E9D7bfF,4721,Vicki,Glover,Luna-Carpenter,North Kim,Sudan,+1-367-238-0534,227.524.0005x1619,kramerandrea@barr-villa.com,2020-07-22,https://west-bowers.net/
10-Jun-2021,Debit Card,55.80,00.00,"326,344.52",0CEEec4Cf248929,346,Ronald,Bradshaw,Becker-Copeland,Port Priscillafort,United States of America,(338)657-8747x492,001-964-879-7515x5491,isabelburnett@kaufman-stevenson.com,2022-03-31,http://www.grimes.net/
10-Jun-2021,Interest,00.00,"163,172.26","163,172.26",e6BC4bCc2eCdDB8,9477,Xavier,Raymond,Pittman-Mayo,North Brittney,Solomon Islands,001-730-558-2565x186,+1-525-814-0675x095,michaelavelasquez@king.com,2020-07-02,https://adams-sullivan.biz/
10-Jun-2021,ATM,96.00,00.00,"163,268.26",d96fC3DcBb6BCcA,6881,Cristina,Ellis,"Barron, Ayala and Hicks",West Fernando,Uruguay,653.027.2134x2981,742.760.3607x87914,watkinsbreanna@eaton.org,2021-12-03,https://www.blankenship.com/
10-Jun-2021,Transfer,00.00,"16,326.83","146,941.43",6a1fECCedcD5C3C,1802,Savannah,Marsh,Hobbs-Mayer,North Toddview,Uganda,001-091-350-9171x113,208-628-6855x25954,ablankenship@mccall.com,2021-03-27,http://juarez-carey.biz/
10-Jun-2021,Transfer,00.00,"16,326.83","130,614.60",D01765c93d9aABe,4245,Lonnie,Holt,"Travis, Burnett and Bowen",New Alexandriaborough,Iceland,0812708863,001-736-457-2080x6438,jacksonnicholson@casey-fritz.com,2020-01-25,http://www.grant-rowe.info/
10-Jun-2021,NEFT,00.00,"65,307.30","65,307.30",C8026EDd92fA99A,2805,Jorge,Barron,Savage Group,Birdfurt,Korea,001-694-969-1879x0735,(819)756-4279,eholland@braun.com,2021-07-08,https://mccoy-ayers.com/
10-Jun-2021,Purchase,00.00,"16,326.83","48,980.48",e0fEEBFe9ef34aE,4695,Jenna,Conley,Stuart-Stevenson,New Haydenton,San Marino,(965)009-5218,639-823-2634x949,ruth64@bolton.com,2020-07-17,http://joyce.com/
10-Jun-2021,Bill,"1,137,316.00",00.00,"1,186,296.48",feC8FCAfDfFEB39,3752,Gene,Payne,Blair and Sons,Nathanmouth,Grenada,001-172-223-3455x05681,680.098.9887x11748,sonya44@salinas-banks.biz,2021-12-27,https://briggs.info/
10-Jun-2021,NEFT,23.00,00.00,"1,186,319.48",FEb0ab9c44F2c50,3659,Claire,Romero,Cummings and Sons,Lewisberg,Central African Republic,(719)781-0560x747,169.910.7439x65877,jacksonwalton@walter.com,2021-10-20,http://www.bauer.com/
10-Jun-2021,Cash,00.00,"593,159.74","593,159.74",7F2f762eaafE03D,5358,Wayne,Landry,Brooks PLC,Kristabury,Northern Mariana Islands,(508)055-1774,(197)676-7251,cantumarilyn@stephenson.com,2020-08-26,https://www.trevino.com/
10-Jun-2021,IMPS,00.00,"197,719.91","395,439.83",5CFcaDEd4df2DaA,452,Joseph,Steele,Meadows PLC,Dyerland,Samoa,(621)466-4444,749-958-2014x289,volson@carter-barr.info,2020-03-21,https://www.floyd-harmon.biz/
10-Jun-2021,ATM,"3,542.00",00.00,"398,981.83",1Ec1b1ffE94e3FF,3894,Rose,Tyler,Gamble-Kemp,New Tabitha,Afghanistan,841-099-1855,743-673-6126,quinncarmen@gilbert.com,2020-06-03,http://hanna.com/
10-Jun-2021,Bill,00.00,"44,331.31","354,650.52",6D719Cd56854ff2,3235,Daryl,Sexton,"Scott, Camacho and Martin",New Steve,Lithuania,(112)957-3267x141,(487)766-1594,zpoole@blanchard.biz,2020-03-24,https://hendricks-rosario.com/
10-Jun-2021,Tax,00.00,"177,325.26","177,325.26",9E86CF1f1b83C4A,4001,Rebekah,Dyer,Bonilla-Li,Kimhaven,Isle of Man,180.777.2613x89178,+1-008-925-0993x4044,elliskyle@cervantes.org,2020-09-02,https://www.ray.org/
10-Jun-2021,Tax,11.00,00.00,"177,336.26",C8Fc39F1Db6ca66,2060,Danny,Rice,"Lynch, Duncan and Krueger",Claytonborough,Mauritius,(355)592-6686x0189,673.179.6909,brendangallagher@fisher.com,2020-09-01,https://www.gallagher-barnes.com/
10-Jun-2021,Commission,"1,690.49",00.00,"179,026.75",eC4B194dEbfA1cF,1763,Wyatt,Jennings,Stone-Wallace,Sheashire,Malaysia,4835747678,8557569201,tammynewman@vazquez-diaz.com,2020-11-14,http://www.whitney.com/
10-Jun-2021,Interest,"180,864.30",00.00,"359,891.05",bdFfFD052b758d6,997,Elizabeth,Montgomery,Benitez PLC,West Pennyfurt,Sweden,001-068-514-7902x5706,945.165.4632x9029,seanhebert@bryan.com,2020-12-16,http://www.huffman.net/
10-Jun-2021,Commission,00.00,"51,413.01","308,478.04",e89bd0bA96B2FED,8210,Adam,Mcknight,Hill-Ballard,Brendabury,Netherlands Antilles,518.431.1423x42869,176.341.9952x679,hoovergene@pugh-hurley.com,2021-02-11,https://www.morris-padilla.info/
10-Jun-2021,Bill,"168,404.00",00.00,"476,882.04",b5e45B5BfCBCE6b,7483,Haley,Livingston,Jennings-Duffy,Orozcobury,Slovenia,001-174-100-4853x135,(342)597-2442x727,lvillegas@pope.com,2020-03-31,https://www.walter.com/
10-Jun-2021,Cash,00.00,"47,688.20","429,193.84",18EC22b40be4f24,8030,Isabel,Humphrey,Vance-Ford,West Kathryn,Russian Federation,089-851-2862x322,9737557872,curtisalexandra@vasquez.com,2020-09-22,http://www.bender.org/
10-Jun-2021,IMPS,00.00,"429,193.84",00.00,74dA0739cCEC5AC,9972,Jennifer,Patterson,Hood and Sons,New Staceyburgh,Germany,001-121-114-3371x35114,9459955980,lisa31@rubio.com,2020-10-31,http://www.bates.com/
10-Jun-2021,IMPS,06.00,00.00,06.00,5b64B8FaD5Fc702,8940,Keith,Mcfarland,"Stanton, Griffith and Marshall",North Sheenamouth,Equatorial Guinea,001-617-436-1720x2596,(224)436-7066x390,acostamorgan@freeman-perry.net,2021-05-14,https://durham-obrien.info/
10-Jun-2021,Interest,00.00,06.00,00.00,bB0f0f4704Ea57D,8368,Chase,Barber,Higgins-Colon,Port Peggyton,United Kingdom,+1-795-510-9791,(185)158-9016,allisonlogan@holmes.com,2020-04-21,http://www.trujillo.com/
10-Jun-2021,NEFT,06.78,00.00,06.78,c319Fe2F9bBecc5,125,Kendra,Petersen,Wilkerson PLC,Port Darryl,Mozambique,(873)933-7409,613-829-7441x67864,wwhite@perez.com,2021-09-12,https://www.kaufman-ho.com/
10-Jun-2021,IMPS,00.00,00.85,05.93,290D433DDc9FA44,7051,Sabrina,Stein,Oconnor-Wheeler,West Brady,Cuba,110.483.9449x445,140.584.2566x48428,guy24@mullins.com,2022-03-24,https://www.suarez.net/
10-Jun-2021,Reversal,"501,386.00",00.00,"501,391.93",fBdC1999Bcfd0ab,6378,Matthew,Townsend,"Valencia, Lynn and Weiss",Macdonaldborough,Iceland,730-857-7256,229-855-0265x52499,herbertsteele@reed.org,2021-12-20,http://www.montoya-escobar.com/
10-Jun-2021,Interest,00.00,"501,391.93",00.00,CDD15130e809Bad,942,Dorothy,Burgess,Dougherty Group,Robertofurt,Bermuda,8130302525,(406)941-5054x34486,bonniewoodard@moss.org,2020-09-10,http://craig.com/
10-Jun-2021,Reversal,53.00,00.00,53.00,0c7fDc168Ec3D0d,9261,Adrian,Guzman,Mills-Kirby,East Autumn,Cyprus,001-644-065-0398x0336,001-640-795-7218x6494,paynetroy@carson.com,2022-03-06,http://www.roach-patterson.com/
10-Jun-2021,Tax,"26,000.00",00.00,"26,053.00",55C6ef3A04Bf0e8,9178,Eugene,Townsend,"Bright, Parrish and Figueroa",Orrview,Bermuda,001-918-435-4268x804,001-876-352-6464x22109,adrienne41@gilbert.org,2021-12-25,https://english.com/
10-Jun-2021,Reversal,00.00,"2,605.30","23,447.70",27BA6ccF0BD9233,5355,Geoffrey,Vang,Bonilla and Sons,Patelborough,Swaziland,001-922-835-4371x63464,(117)307-4642,sergio33@hicks-cantrell.com,2020-07-23,https://peters.com/
10-Jun-2021,Miscellaneous,00.00,"7,815.90","15,631.80",D3EA0dfD2C10FC3,2623,Maria,Quinn,Roth-Hammond,Paulland,Peru,6527295842,+1-104-705-3566x23311,laurenfarley@delgado.com,2020-01-26,https://www.flores.info/
10-Jun-2021,Miscellaneous,12.92,00.00,"15,644.72",D5d2aEf36B2f3b3,7293,Shelia,Adams,Chase Ltd,West Max,Armenia,788-426-4348,418.807.0458,villagabriella@petersen.com,2022-03-31,https://bryant.org/
10-Jun-2021,Cash,42.90,00.00,"15,687.62",497bFE60296a7C5,7175,Brooke,Spencer,"Carson, Hutchinson and Hickman",West Heidiside,Denmark,531.564.4470x949,(205)969-0252,pjacobs@ellison.com,2020-06-06,https://middleton.com/
10-Jun-2021,Reversal,00.00,"3,137.52","12,550.10",E6d410bF341CD2A,9169,Dennis,Benjamin,Joyce PLC,West Suzanne,Fiji,423.643.1091x97929,(781)182-4817x032,anna66@spears-harrison.com,2020-12-13,https://day-zhang.com/
10-Jun-2021,Interest,218.00,00.00,"12,768.10",50f7D8E02dfB621,5524,Bill,Richards,Novak-Long,Byrdburgh,Switzerland,329-543-1121,+1-942-902-4458x281,lekellie@christensen-lam.org,2020-04-08,http://www.cooper.biz/
10-Jun-2021,ATM,"2,196.13",00.00,"14,964.23",E4cAaBEe2c91cc8,6667,Kathy,Novak,Dominguez Group,Coreyberg,Wallis and Futuna,(242)993-8122x53797,+1-684-263-7848,ivan16@nichols-bennett.com,2020-11-27,https://www.hughes.com/
10-Jun-2021,RTGS,00.00,"1,496.42","13,467.81",Bcc2aB11725a6aD,5903,Jared,Dudley,Ramos PLC,Lake Grantbury,Madagascar,7561803074,584-206-7618x3144,williamsnicolas@vaughan.com,2020-06-16,http://drake.com/
10-Jun-2021,Debit Card,07.60,00.00,"13,475.41",be4f53D0ed6aa57,2301,Cameron,Le,Collins-Obrien,Lake Sherritown,San Marino,(667)691-9385,780.923.4808x0592,herbertphelps@reid.com,2020-11-16,https://lester.com/
10-Jun-2021,Cheque,00.00,"3,368.85","10,106.56",18a581e3EAa0370,5171,Alexandra,Wolf,"Gray, Atkinson and Mcmahon",West Norman,Samoa,835-595-7464x231,+1-770-027-7968,ynorman@cochran.com,2021-08-20,http://hunt.biz/
10-Jun-2021,Miscellaneous,00.65,00.00,"10,107.21",1F7cF53c7ebFc3D,408,Francis,Bradford,Contreras PLC,New Hayley,Sudan,(266)493-2713x08961,241.387.2339x4572,alejandra14@quinn.com,2022-01-11,http://maynard.com/
10-Jun-2021,NEFT,00.00,"1,123.02","8,984.19",aC3d6e0FE026091,8433,Omar,Snyder,Shea-Branch,Ninaburgh,Slovenia,412-928-1618x1283,+1-526-190-7368x298,chelsey22@lane-weiss.com,2020-01-01,https://ayala.com/
10-Jun-2021,ATM,00.00,"4,492.10","4,492.10",4aC30f4cBAd2bBD,7601,Jennifer,Patterson,Mueller-Caldwell,South Brandi,Indonesia,662-844-8935,001-770-008-5792x962,gwendolyn11@whitehead-erickson.com,2020-08-12,http://hood.com/
10-Jun-2021,Miscellaneous,"2,037,553.80",00.00,"2,042,045.90",a9D37eB293B7fBC,6079,Ann,Mora,"Reeves, Duffy and Santiago",South Jaredtown,Micronesia,684.461.8519,954.008.2684x4434,kaitlinestes@rhodes-shaffer.net,2020-07-25,http://www.peck.org/
10-Jun-2021,ATM,00.00,"680,681.97","1,361,363.93",6dEbC2815A43D78,7083,Jill,Vaughn,Gentry LLC,West Darrellton,Italy,9039482155,665.285.0128x168,maddenmeredith@knox.org,2021-09-25,http://dodson-valdez.org/
10-Jun-2021,Reversal,00.00,"226,893.99","1,134,469.94",02F5a0Dc3ff86cC,5090,Mariah,Galloway,Wells-Duran,Lozanoland,Namibia,001-372-463-0219x96438,001-254-922-8771,usantana@roberts.com,2020-08-02,http://greene-bradley.com/
10-Jun-2021,NEFT,"2,894.80",00.00,"1,137,364.74",bf358b72b24Ffa5,7974,Brenda,Ross,Gallegos-Wong,Housemouth,Guernsey,+1-871-367-6760x9335,001-365-948-2844,martinmercer@anderson.com,2021-06-29,http://www.andrade.com/
10-Jun-2021,Transfer,00.00,"568,682.37","568,682.37",B6bF2E1D05CADE7,268,Rebekah,Weiss,Gallagher PLC,Lyonsshire,Oman,925.881.7050,(040)995-5358x7014,stoutwilliam@forbes.com,2020-03-12,http://lutz.org/
10-Jun-2021,Tax,00.00,"142,170.59","426,511.78",28E652AE681f33B,9120,Trevor,Davila,Everett Inc,Sharptown,Azerbaijan,001-033-405-5418,(578)352-5650x05834,yorkdominic@frye-aguirre.org,2021-09-12,http://gould.com/
10-Jun-2021,Tax,00.00,"42,651.18","383,860.60",daCD7e1c74D0ddf,1743,Norman,Kramer,Douglas PLC,Kurtchester,Oman,464-960-4692,163.524.1975,vegajustin@terrell.com,2020-06-03,https://barron.org/
10-Jun-2021,Tax,00.00,"54,837.23","329,023.37",981dCC429fB53a5,3000,Angie,Evans,Wright-Skinner,Normanbury,British Virgin Islands,001-236-548-9153x13926,890.724.9862,wbeltran@green.biz,2021-03-03,http://strong.com/
10-Jun-2021,Commission,00.00,"164,511.69","164,511.68",E17b7127a53Ca89,3754,Jack,Ali,Reese-Pennington,East Malloryfurt,Saint Pierre and Miquelon,(230)446-7029x229,438.389.5277x5218,geoffrey76@clayton.com,2020-04-25,https://www.franco.biz/
10-Jun-2021,Reversal,"152,862.00",00.00,"317,373.68",Da7D6678a14faff,2958,Seth,Day,"Olsen, Harris and Mack",Irwinfort,Indonesia,(293)026-6170x858,714.304.1658x327,kari88@rose.com,2021-05-06,https://www.wu-waters.com/
10-Jun-2021,Cheque,00.00,"35,263.74","282,109.94",a9BA2bB0debDD4c,6385,Katie,Owen,Meza-Rangel,Graceborough,Cote d'Ivoire,+1-278-671-4085x5711,001-432-688-2892,molinaallen@parker-crawford.com,2021-12-08,http://www.johnson.com/
10-Jun-2021,Bill,"4,078.00",00.00,"286,187.94",B9DCaC19254369b,4975,Dominique,Tapia,Meadows-Cooley,Lake Garyborough,French Polynesia,857-570-8724x2249,2200454553,sherryellison@garza.com,2020-09-19,http://mcintyre.info/
10-Jun-2021,Interest,00.00,"31,798.66","254,389.28",b086Cf491c40B4c,4708,Isabel,Williamson,Esparza-Griffin,South Sierrabury,Colombia,894.742.3667x90373,(065)611-6414x54608,alexa75@vance.com,2020-10-18,http://www.bean.com/
10-Jun-2021,Commission,00.00,"254,389.28",00.00,d20d428FA81a2Eb,447,Sydney,Burnett,"David, Reynolds and Deleon",West Steveborough,Rwanda,001-848-600-5959x841,524.429.0041x0400,makaylafrost@pham.com,2022-01-31,http://www.banks.org/
10-Jun-2021,Bill,"194,432.00",00.00,"194,432.00",dA3738F8Fa334cE,1119,Jillian,Serrano,Hall Inc,Port Kerriberg,Russian Federation,(107)026-9838,281-162-3267x8555,wintersharry@sheppard.org,2021-12-29,http://www.tanner.biz/
10-Jun-2021,NEFT,00.00,"64,810.67","129,621.33",4242bF6Cca6A30f,4523,Kristie,Leblanc,Hughes LLC,Lake Micheal,Lesotho,(540)358-4067x3249,001-201-422-9655x01480,rick76@cantrell-munoz.com,2021-05-11,https://www.li-mitchell.com/
10-Jun-2021,Debit Card,00.00,"18,517.33","111,104.00",41FB63B1bcA71F6,2230,Makayla,Shelton,"Lopez, Oneal and Giles",Marcoberg,Cambodia,001-037-345-2027x37133,036-696-4965,meredith21@mills.org,2021-06-24,http://maynard.info/
10-Jun-2021,Purchase,"268,035.50",00.00,"379,139.50",0cbb5Ac5DDBDE8d,7304,Frank,Daniel,Arias-Stanley,Lake Natalie,New Zealand,488-233-1146x7821,001-671-573-3842x2848,sho@johnson.org,2021-05-27,https://www.blankenship.com/
10-Jun-2021,Commission,"67,316.40",00.00,"446,455.90",A125eadF077Ce68,3878,Juan,Stafford,Silva-Campos,Dukeborough,Jordan,(476)997-1087x877,001-245-628-1639x126,terry28@kennedy.info,2020-12-20,http://summers.com/
10-Jun-2021,Interest,00.00,"49,606.21","396,849.69",0BcE5983C641cBe,9075,Cristian,Bullock,Reeves Inc,Hornberg,Sierra Leone,+1-332-553-8919x99073,(896)945-8038x561,antonio41@horton.info,2020-03-31,https://www.maldonado.com/
10-Jun-2021,Commission,05.00,00.00,"396,854.69",BDB71E4ed782fEa,7678,Bryan,Fowler,Reese PLC,West Patricia,Bulgaria,124-270-7759,234-321-0605x41385,chapmannoah@mayer-terry.com,2020-11-12,http://www.grant.com/
10-Jun-2021,IMPS,00.00,"56,693.53","340,161.16",2C5856eBEEdbe29,3339,Guy,Mayo,"Estrada, Heath and Dunn",South Leon,Niue,894-925-7760x168,+1-812-310-4347x32477,chavezemma@butler-hart.com,2022-04-28,https://stokes-chambers.com/
10-Jun-2021,NEFT,00.00,"68,032.23","272,128.93",FfF9b4baa42BA96,8312,Edward,Sparks,Sutton Group,North Gary,Finland,(929)942-8636x3276,(238)936-0507,rosebob@scott-ayala.com,2021-03-13,http://miller.com/
10-Jun-2021,Debit Card,00.00,"38,875.56","233,253.37",3a0E1CFd3995ceF,3562,Dalton,Morris,Villegas and Sons,East Carolyn,Greenland,495-887-5096x98862,0600120966,yriley@proctor.biz,2022-05-23,http://small-little.info/
10-Jun-2021,Reversal,00.00,"58,313.34","174,940.03",971fa0BB499e0e3,1706,Norman,Bates,"Luna, Ballard and Robles",New Wyatt,Dominican Republic,864-360-2837x98383,546-772-2003x1317,fruiz@burns.com,2020-07-18,https://www.faulkner.com/
10-Jun-2021,Tax,00.00,"17,494.00","157,446.03",DF42EfcdACF9952,6808,Carly,Wheeler,Stokes Group,New Colebury,Montenegro,920-235-9919,001-777-288-4224,bernardhowe@schultz.com,2020-12-23,https://www.fuller.org/
10-Jun-2021,Interest,00.00,"22,492.29","134,953.74",0F116b0fA9632cB,6121,Edwin,Santos,Tran-Anthony,West Theresachester,Gibraltar,601-927-4898x85682,+1-604-991-4692x43657,nathaniel16@downs.com,2021-03-12,http://www.webster.com/
10-Jun-2021,RTGS,00.00,"22,492.29","112,461.45",5fDC6bAE37E5eBf,9385,Shelby,Cain,Campos and Sons,South Francesbury,Bahrain,289.956.0160,398-314-4331,hillmisty@collins.com,2021-06-10,http://delgado.biz/
10-Jun-2021,Commission,64.00,00.00,"112,525.45",888AD00c3adA31a,512,Maxwell,Hall,Holder Group,Meyerport,Switzerland,591.561.9168x18835,969.738.0402x305,fnichols@ho-robinson.net,2020-12-05,https://www.tate.net/
10-Jun-2021,IMPS,06.00,00.00,"112,531.45",d5D381A204e861e,9336,Clinton,Mccarthy,"Mcconnell, Pugh and Powell",West Ruben,Macao,(491)608-1759,(545)110-8682x7165,michealcooper@mendoza-conley.com,2022-01-08,http://www.potter.com/
10-Jun-2021,Cheque,00.00,"18,755.24","93,776.21",F0FA7BAC3DEeBCb,9881,Tom,Sharp,"Dennis, Walters and Foster",Bushshire,Ukraine,(521)461-1502x6362,375.765.1195,cassidyhawkins@bright.info,2022-04-29,https://howe.net/
10-Jun-2021,Reversal,"27,791.20",00.00,"121,567.41",d1aCDbfCf97c12b,6706,Kerri,Meyers,Vang-Shaw,Tuckertown,Guinea,001-856-091-2956x52587,606.040.0420x012,myu@cox.com,2022-05-06,https://shah.com/
11-Jun-2021,IMPS,"149,001.22",00.00,"270,568.63",8bEfF473c4b5C6f,7321,Desiree,Crane,"Johnson, Choi and Hinton",Reneeburgh,Ecuador,055-864-2672x243,8462917376,diamondpatterson@hardy-terrell.com,2021-07-18,http://www.morton.com/
11-Jun-2021,Debit Card,00.00,"135,284.32","135,284.32",3Eb0AC11aa46D1b,6174,Lorraine,Mueller,"Clark, Hanson and Knox",South Latoya,Dominican Republic,721.252.4428,+1-165-350-9471x492,mbonilla@bradshaw.com,2021-06-12,https://www.oconnor-bean.org/
11-Jun-2021,Transfer,04.03,00.00,"135,288.35",8A499D4D82EeaC8,2395,Sydney,Hale,Shepherd-Black,West Carolyn,Brazil,4916787669,900-164-7125,nkline@english.net,2021-10-14,https://www.buck.com/
11-Jun-2021,Cheque,00.00,"16,911.04","118,377.31",a6f01EcEcFf79d1,1784,Frederick,Vargas,"Blackburn, French and Zimmerman",Traciemouth,Mauritius,821-143-1835x110,+1-728-960-4095x68882,suarezcaleb@hoffman-craig.com,2021-03-07,https://herring.org/
11-Jun-2021,Bill,00.00,"59,188.66","59,188.66",f612fDc204BDfdd,3229,Raven,Hughes,Liu-Perez,Curryburgh,Finland,001-865-313-3310x498,174.140.7461x521,tanya20@jacobs.org,2021-11-17,https://www.drake.net/
11-Jun-2021,NEFT,"102,826.50",00.00,"162,015.16",AFDBA1d51C9560f,1615,Wendy,Berger,Boone-Tanner,Isaacside,Papua New Guinea,001-281-674-5905x623,(289)674-6338x5596,mcoleman@parks.com,2021-02-22,https://www.marshall.com/
11-Jun-2021,Tax,00.00,"27,002.53","135,012.63",fc415E95Be291cA,6801,Joanne,Strong,York LLC,Lake Jacob,Iraq,+1-190-102-1796x910,386.641.3518,kentdarren@chen-fields.info,2021-04-14,http://www.roman-roth.com/
11-Jun-2021,Debit Card,00.00,"13,501.26","121,511.37",FAdED1A29b30019,180,Martha,Small,Cordova-Acevedo,Michelehaven,El Salvador,230.073.8571,581-665-8434,reginahancock@walker.org,2021-01-17,http://haney.biz/
11-Jun-2021,Transfer,00.00,"17,358.77","104,152.60",CeFeBEBB6DE6Aef,8727,Courtney,Proctor,"Pham, Escobar and Suarez",Abbottfort,Israel,6663103915,189.679.6910x322,arthur49@dickerson-young.com,2020-07-02,http://www.wyatt-andersen.net/
11-Jun-2021,Miscellaneous,00.00,"26,038.15","78,114.45",4e0dfc5E765fB91,5965,Cameron,Acosta,Moss PLC,East Erikton,Wallis and Futuna,010-070-4052,749.995.3287,jo60@novak-gutierrez.com,2022-02-19,https://bernard.com/
11-Jun-2021,Transfer,299.79,00.00,"78,414.24",94cA16AFe68CC4D,1908,Caleb,Griffith,Morton-Dudley,North Evelynville,Niger,+1-350-020-0270x7526,5361352759,peter97@newton.com,2020-05-10,https://bautista.com/
11-Jun-2021,Interest,00.00,"78,414.24",00.00,62B11dfdfca8A7b,3995,Mackenzie,House,"Bowen, Maldonado and Harper",New Timothyfort,United States Virgin Islands,126-227-2680,753-776-9642x402,marquezeileen@robbins-douglas.com,2020-10-19,https://marquez.com/
11-Jun-2021,IMPS,06.00,00.00,06.00,C4CebfA1A052CdA,7526,Dylan,Juarez,Weiss LLC,Amandabury,Zambia,001-544-247-4131x0330,001-288-816-9754,danhaney@dudley.com,2022-03-05,https://www.ibarra.biz/
11-Jun-2021,Commission,00.00,00.75,05.25,F415d117DfE19e9,6699,Stacy,Coleman,Craig and Sons,South Haley,Australia,001-904-856-5618x255,001-494-739-8136x93666,margaretgallagher@novak.com,2021-05-16,http://carlson.org/
11-Jun-2021,Debit Card,20.40,00.00,25.65,af77E67cFC14F2E,1489,Traci,Bird,"Rodgers, Villarreal and Flores",Woodwardshire,Oman,+1-186-952-8512x3613,001-815-720-2480,spineda@mcfarland-humphrey.com,2021-05-10,http://dyer.com/
11-Jun-2021,Reversal,00.00,08.55,17.10,08D5DeAEd67321d,1666,Dwayne,Wheeler,"Cooke, Walls and Blair",Lake Yvetteport,British Indian Ocean Territory (Chagos Archipelago),573-999-7446,(235)194-7064,jennifer64@church.com,2020-02-09,https://vaughan.org/
11-Jun-2021,Tax,"14,127.00",00.00,"14,144.10",e065eBDEc7deF3d,3682,Clinton,Patterson,"Lloyd, Pierce and Valdez",Villanuevaville,Sri Lanka,520.223.3796x03827,861-567-0266,fitzgeraldmitchell@pennington-mcguire.info,2020-11-25,https://villanueva.org/
11-Jun-2021,Cash,00.00,"4,714.70","9,429.40",ba854ec0BBefac8,8779,Helen,Oconnor,"Compton, Nash and Hubbard",Lake Kristieport,Guinea,001-021-827-2590,790.978.4970,alanmendoza@booth-wolfe.com,2020-08-11,https://mendoza.info/
11-Jun-2021,Debit Card,00.00,"1,047.71","8,381.69",d26bE4a20f25CCA,3474,Gail,Larsen,Robles and Sons,South Cindy,Cuba,001-293-334-4523x0344,288.542.9363x557,rayvalentine@merritt.com,2022-03-31,http://www.madden-abbott.com/
11-Jun-2021,Debit Card,00.00,"1,197.38","7,184.31",CFf86B15D85dBD1,4469,Gwendolyn,Lutz,Schmidt Ltd,Port Bryan,Congo,195-867-1828,(991)359-5176x666,richardfarley@bender-sloan.com,2021-01-05,http://mathis-norton.com/
11-Jun-2021,Cash,00.00,"1,796.08","5,388.23",196DcfDd1ABDeCa,9923,Aaron,Berg,"Wells, Dodson and Rhodes",Lake Gerald,Mozambique,+1-022-635-2617,(038)321-0452,fmedina@kramer-munoz.biz,2020-10-16,http://aguilar.biz/
11-Jun-2021,Reversal,"1,244.90",00.00,"6,633.13",DEBe2627fFf8D05,3040,Kellie,Brandt,Harris Inc,Orozcohaven,Switzerland,+1-833-112-9224x818,(614)376-7264x1293,meyersroberto@villarreal.org,2021-04-13,https://www.barajas.biz/
11-Jun-2021,Purchase,00.64,00.00,"6,633.77",8686ca97e587BA7,7254,Kent,Lucas,Potter-Murphy,Kelseyburgh,Liechtenstein,708-746-6809,001-798-125-6678,victor30@solis.info,2021-03-14,https://www.dudley.biz/
12-Jun-2021,Cash,05.20,00.00,"6,638.97",CdE711D9D2a15Cb,5976,Jean,Murphy,"Baird, Butler and Avila",Raymondport,Dominican Republic,636-733-3119,+1-503-521-5649x6719,gcastillo@valentine.com,2020-11-08,https://www.roth.com/
13-Jun-2021,NEFT,00.00,829.87,"5,809.10",4EFE38C99e5bb4c,8473,Jody,Tran,Choi LLC,East Gavin,Barbados,045-383-2507x8676,+1-960-074-5994,frycaroline@conrad.org,2021-01-19,http://nash.com/
13-Jun-2021,Cheque,00.00,726.14,"5,082.96",790E89DFCA2748D,5813,Alex,Best,Pope-Singh,Ellenstad,Nicaragua,001-828-081-4931,001-301-579-9947x3457,blancharddamon@hoover.com,2021-07-28,https://www.booker-everett.biz/
13-Jun-2021,Cash,"23,058.00",00.00,"28,140.96",3bB4b2F634769EB,2778,Shari,Webb,Levine LLC,North Kerry,Congo,001-995-730-0093x996,964.216.3445,stacie84@stewart-lee.org,2020-08-14,https://www.duran.com/
13-Jun-2021,Debit Card,00.00,"3,517.62","24,623.34",31C64Dc03Bb4FEf,7221,Fred,Benjamin,"Bauer, Cowan and Beltran",Jimmyview,Korea,(074)120-2792x3249,001-477-927-8647x44886,hectoryoder@liu.com,2021-08-29,http://michael-avila.com/
13-Jun-2021,RTGS,00.00,"4,924.67","19,698.67",2CBD9e17dDC79E8,9840,Sara,Lyons,Duarte LLC,Darrylside,Hungary,+1-531-582-4664x85610,001-289-869-4169,brandi03@harris.com,2020-10-28,http://hamilton.com/
13-Jun-2021,Bill,"381,868.00",00.00,"401,566.67",48d405956764549,3608,Juan,Byrd,"Barton, Becker and Ayala",North Tammytown,Tonga,3472490066,106-795-8759,trevor06@cochran.com,2021-02-01,http://www.santos.com/
13-Jun-2021,Cash,758.40,00.00,"402,325.07",bbE1DDC7F7BbfDf,2529,Sandra,Burnett,Mills and Sons,Kurtburgh,Bhutan,+1-232-303-7107x78994,923.066.3441x280,carol05@blevins-spears.org,2021-03-30,http://rosales.com/
13-Jun-2021,Debit Card,00.00,"40,232.51","362,092.56",aBAfDAF3CA90EC2,2192,Jacob,Perez,Roach-Anthony,Chamberston,Palestinian Territory,+1-098-965-7583x4101,(317)606-3649,katie06@greene-pham.com,2021-06-21,https://mcgee.com/
13-Jun-2021,ATM,00.00,"45,261.57","316,830.99",2e8e8cC9FE871c2,4089,Janet,Hamilton,Shannon-Gallagher,Lake Dana,Malawi,(262)651-4854x55593,896.921.1172x3460,miaflores@meyer-harding.com,2022-03-23,https://stewart-harvey.com/
13-Jun-2021,Interest,00.00,"105,610.33","211,220.66",277e8Ab55848fFA,8155,Darryl,Howe,"Drake, Bond and Bradshaw",Obrienside,Cayman Islands,946-944-6992x9108,9165856779,hollybarron@montoya-powers.org,2022-05-25,https://www.lozano-stephens.com/
14-Jun-2021,Commission,00.00,"211,220.66",00.00,e7ad806CDE3Db4B,9301,Mary,Koch,"Santiago, Berg and Mendoza",Lake Marissafurt,Tonga,001-395-277-1371x1920,093-975-4450,joyce65@hampton-stanley.net,2020-05-06,http://www.spence-michael.com/
14-Jun-2021,Commission,07.76,00.00,07.76,2Ecb1e766d1e64A,7630,Angela,Reilly,"Horn, Bowen and Simmons",East Yolanda,Cote d'Ivoire,(043)296-0737,(256)674-6412x15340,burchlaurie@barber.biz,2021-10-30,http://www.calhoun.com/
14-Jun-2021,IMPS,"3,523.00",00.00,"3,530.76",09CC9EbAF60F26E,5480,Rose,Tate,"Shea, Benitez and Davies",Kristinmouth,Nauru,+1-562-662-8749x2482,794.137.2690,umeza@mcbride.net,2020-12-08,https://www.schroeder-valencia.com/
14-Jun-2021,Cash,"9,328.04",00.00,"12,858.80",Afdc83D38C9a06e,3678,Judy,Santiago,Beard Inc,Jermainebury,Puerto Rico,905.486.6039x85738,893.563.6297x0244,dariusolsen@oneal-holloway.biz,2022-01-03,https://kelley.com/
14-Jun-2021,Cash,00.00,"4,286.27","8,572.53",b7CC9cA6676F4Ac,109,Jasmine,Ryan,"Fritz, Haynes and Burgess",Victoriaburgh,Poland,499.825.4529x5083,+1-043-610-8679x8549,swarren@buck-roach.com,2020-06-24,https://frederick.com/
14-Jun-2021,Reversal,129.60,00.00,"8,702.13",311e6BAeA71afb9,3403,Margaret,Anderson,Obrien Ltd,Rochamouth,Rwanda,3235803176,399-249-6071x61268,marisa36@duncan.biz,2022-05-27,https://www.deleon.com/
14-Jun-2021,Commission,00.00,"8,702.13",00.00,22f54B5EbDe3f2F,2459,Ashlee,Mathis,"Griffin, Hayden and Bailey",Kiarachester,Cayman Islands,(839)520-3099x0770,713.516.7109x57193,bdaugherty@patton.biz,2020-11-02,http://www.wilcox-brandt.net/
14-Jun-2021,Cash,00.87,00.00,00.87,a099Ffe1bc2ADda,6789,Tracy,Brock,Rubio-Beck,Lake Noah,South Georgia and the South Sandwich Islands,(036)692-3356x75342,001-835-451-8694x975,rebeccasutton@olsen.com,2020-02-24,http://montoya-gillespie.biz/
14-Jun-2021,Tax,01.00,00.00,01.87,4b23a37B0757BDd,9924,Clarence,Dunn,Bush-Ward,Alecborough,Belgium,276.152.1500x30677,758.027.0137,weissjake@ortega.info,2021-11-13,https://humphrey.com/
14-Jun-2021,Purchase,00.00,01.87,00.00,AB4a3db2FEa2b0c,2685,Kristen,Decker,Raymond-Perry,Rosemouth,Kiribati,+1-486-152-9872x64911,068.601.4438,guzmanmonique@henderson-davila.net,2021-03-14,http://carroll-armstrong.com/
15-Jun-2021,ATM,345.13,00.00,345.13,c3EeEd28dB06e84,6530,Krystal,Palmer,Jimenez and Sons,Dariusberg,Pitcairn Islands,787-941-1436x180,+1-085-779-3491,audrey11@koch.com,2021-02-06,http://lin.com/
15-Jun-2021,Transfer,00.00,43.14,301.99,0a5dae2A45c7f80,3112,Gene,Keith,Mayo Group,West Mercedesside,Montenegro,+1-892-792-7170x521,(980)387-8651x286,juarezfrederick@molina.net,2021-08-03,http://www.fuentes.com/
15-Jun-2021,Purchase,00.00,100.66,201.33,109E4dDADFCAEd4,8004,Lance,Hutchinson,"Mcknight, Mann and Foley",Simmonsberg,Turkmenistan,062.697.9120,001-558-809-1055,shepardalejandro@kaufman.com,2021-04-11,https://www.jefferson.com/
15-Jun-2021,RTGS,00.00,201.33,00.00,fb586506aCBC8b1,5694,Meghan,Pugh,"Arias, Holloway and Bauer",Port Clarenceshire,China,+1-962-881-0296x05204,+1-871-798-6050x0501,rbell@holmes.org,2020-10-15,https://maddox-thomas.net/
15-Jun-2021,Transfer,"8,323.71",00.00,"8,323.71",A5dedAeEf108aAd,2385,Natalie,Sandoval,Stanton-Leach,Hollyland,Cyprus,001-704-627-0165x4560,346-905-9577,edwinrogers@zamora.info,2022-03-02,https://www.turner.net/
15-Jun-2021,Cash,00.00,832.37,"7,491.34",69Ec55bf24B6fc3,2954,Chad,Webb,"Beasley, Travis and House",East Hannahville,Belarus,+1-766-695-2022x2920,984.951.2461,andrademeagan@barrett.com,2021-02-24,https://payne.com/
15-Jun-2021,Bill,00.00,"1,498.27","5,993.07",7D07A123cDaebfB,2327,Darius,Howard,Wong PLC,Port Kiara,Wallis and Futuna,(363)202-6090x16483,+1-355-472-0719x51811,mistyluna@maldonado-roberts.com,2021-05-04,http://colon.com/
15-Jun-2021,Miscellaneous,00.00,"5,993.07",00.00,baF6BF63c8fD59F,4522,Carol,Ponce,"Oconnor, Munoz and Webster",West Laurachester,Mozambique,(521)086-0721x0897,202.271.3030x5913,daryl26@hutchinson-perkins.com,2022-03-07,https://kerr.org/
15-Jun-2021,RTGS,888.19,00.00,888.19,dFc9EE59FEaDff6,2090,Malik,Nielsen,Aguilar Ltd,Port Jerrymouth,Mali,001-707-504-8677x721,001-933-398-7152x691,paigeriley@duran.com,2022-03-03,https://www.gill.org/
15-Jun-2021,NEFT,00.00,98.69,789.50,066BeCcCAC62a7B,7628,Kristin,Schmidt,Richards-Cox,West Cristina,Uruguay,717-000-8643x4726,168-684-7296x611,tasha62@morse.com,2022-05-09,http://www.bird.biz/
15-Jun-2021,Miscellaneous,97.19,00.00,886.69,7d23AeaedBEbbDF,5317,Kiara,Berger,Choi-Kline,Lake Cheyenne,Fiji,986-802-9508x19430,+1-550-657-9327x0777,carlhess@cole-todd.com,2021-03-25,http://wright-deleon.org/
15-Jun-2021,IMPS,00.00,886.69,00.00,EC5f5be70Af8DAD,8906,Tami,Hughes,"Day, Harris and Bowen",Willisport,Guinea-Bissau,(073)073-4372x75351,268.061.6106,lauriewaller@trujillo-mejia.net,2020-05-07,http://www.stevenson.com/
15-Jun-2021,Interest,"78,222.00",00.00,"78,222.00",A7e177F7a1E823b,6455,Nathan,Sherman,"Pitts, Jarvis and Gillespie",Port Rogerville,Croatia,(278)807-0382x03991,(440)191-8284x8157,faithbarrett@richardson.com,2021-08-28,http://www.maynard-bradford.info/
15-Jun-2021,ATM,00.00,"7,822.20","70,399.80",A7aC1b5E554b41C,9965,Rita,Berry,"Fernandez, Nielsen and Ortiz",Frankside,Egypt,808.643.9160,408-324-9457,mcknightvictor@owen.com,2022-01-17,https://pope.com/
15-Jun-2021,IMPS,445.10,00.00,"70,844.90",dB6eb374e03FA48,6041,Renee,Washington,Martin Ltd,Cantrellmouth,Tuvalu,(031)419-3733,+1-895-989-6270x79902,brenda94@pearson.com,2021-11-08,http://house-lopez.com/
16-Jun-2021,Commission,"507,763.00",00.00,"578,607.90",4528d6aBf2Aa4D3,7976,Paige,Hobbs,Valdez Group,Rebekahchester,Montserrat,+1-192-498-7362x89206,356-227-9021x9108,arivas@manning.com,2022-05-01,https://www.rasmussen.info/
16-Jun-2021,Interest,"16,421.00",00.00,"595,028.90",AFBd06F16e8DF6f,3955,Kent,King,"Chan, Simpson and Wiggins",South David,Malaysia,288.173.6385x5023,998.124.8877x6867,velasquezray@sloan.com,2021-11-05,https://griffin.net/
16-Jun-2021,Cash,16.00,00.00,"595,044.90",8cfDf61f8dee194,8567,Donald,Snyder,Lam and Sons,Suzannebury,Argentina,+1-512-347-4201x0891,(724)797-0040x675,chentamara@sampson.biz,2021-09-04,https://cooley.com/
16-Jun-2021,Cheque,04.30,00.00,"595,049.20",EE9aE8170bda805,658,Shelley,Ball,Kent and Sons,Castilloland,Lao People's Democratic Republic,(385)952-1855,+1-567-439-6949x7131,harry93@barber-lambert.org,2020-10-02,http://zhang-wright.net/
16-Jun-2021,Commission,"31,791.80",00.00,"626,841.00",bCa8ce25bcfEE32,6955,Joel,Krause,"Walters, Braun and Guerra",North Suzannestad,Cuba,140-145-0174,134-452-7645,clintonbest@patrick-rogers.com,2020-04-13,https://www.ayala.com/
16-Jun-2021,NEFT,00.00,"125,368.20","501,472.80",02a56F66FeafFcC,8823,Alan,Shah,Herring PLC,Simonland,Switzerland,697-900-0698,001-222-057-9930x53820,glenda65@scott.info,2022-03-20,https://johns-graham.net/
16-Jun-2021,Interest,02.00,00.00,"501,474.80",C54a77E0dFBcCB9,5404,Roberto,Gardner,Wheeler LLC,Port Lance,Latvia,692.047.1650x90600,001-836-416-8043x59621,annacarson@herring.com,2021-12-01,http://baxter-cordova.com/
16-Jun-2021,Cheque,21.00,00.00,"501,495.80",De742Aa0c9dEd57,8898,Bradley,Cole,Allison and Sons,Katieburgh,Ireland,(570)289-7834x98658,767-252-4620x0941,georgeshawna@delgado.com,2020-01-10,http://www.fry.com/
16-Jun-2021,IMPS,00.00,"250,747.90","250,747.90",dFAc465E9Ccc3a6,255,Kara,Pugh,Proctor-Garrett,Kennedyville,Ireland,415.119.1011,063.445.8828x5305,lucas29@mccoy.net,2021-02-22,https://brock.info/
16-Jun-2021,Reversal,00.00,"250,747.90",00.00,C79a97e99CD6a3f,7360,Ricky,Hahn,"Barker, Paul and Walsh",New Sherylshire,Switzerland,(079)146-9140,4457579217,montgomeryclinton@shea.com,2020-06-02,http://www.davenport.info/
16-Jun-2021,Commission,06.40,00.00,06.40,B25B0d4Fe18aBaF,5260,Valerie,Salinas,Montes Inc,North Rebecca,Ecuador,556.816.2235,001-399-480-1899x054,knightclaudia@mcgee-carr.net,2020-10-05,https://sanders.com/
16-Jun-2021,Tax,00.00,00.64,05.76,992a6025D53cec3,8468,Sheri,Webster,Norris Group,West Austinmouth,Guyana,(214)022-9004,001-786-770-7420,katiehawkins@henson.com,2022-01-14,http://www.flores.info/
16-Jun-2021,Tax,00.00,01.15,04.61,F97fE1cea4FFf28,9269,Jasmin,Blankenship,"Hopkins, Lyons and Rose",Robinmouth,Uzbekistan,965.104.4343,037-296-8560,melissafrost@johnson-strickland.com,2020-07-18,http://cooper.net/
16-Jun-2021,Debit Card,428.00,00.00,432.61,ebC4De12FAde3Ad,6523,Harold,Kline,"Bentley, Mckee and Ford",Olivialand,Gabon,001-536-548-7402,(427)121-8236x93734,mark60@beasley.org,2020-03-24,http://barrett-downs.com/
16-Jun-2021,Miscellaneous,00.00,144.20,288.41,AEdd1FCF99b4483,635,Alex,Bryan,Zamora-Burke,Joycefort,Slovenia,776.951.1191,366.584.9124,harperrichard@levy-fields.com,2020-08-21,https://www.barton.com/
16-Jun-2021,Transfer,428.00,00.00,716.41,731C1AB0cAF588b,323,Curtis,Armstrong,Boone LLC,Barkerchester,Comoros,955.476.5937x20987,357.645.5729,monique66@daniel.info,2020-03-09,http://ochoa-hodges.biz/
16-Jun-2021,Commission,05.60,00.00,722.01,f9dA5d03aAbCAEE,8493,Summer,Mcgrath,Roth-Miles,Gallowaybury,Montenegro,417-164-9184,+1-564-044-8319x6951,hannahbell@simmons.com,2020-01-21,http://hoffman-hull.info/
16-Jun-2021,Cheque,00.00,240.67,481.34,C6e3c3fdfdafDaa,4010,Tonya,Moody,"Haney, Hart and Stone",East Bettyberg,Malta,(931)951-4597x6860,924-648-4190,francisco66@brooks-austin.com,2020-04-28,https://www.bell-suarez.info/
16-Jun-2021,Debit Card,00.00,68.76,412.58,beE9583aeb96e4A,9078,Dennis,Joseph,Morse-Mckee,North Melissa,Paraguay,001-703-594-6539x54244,667-134-1482x899,kendra81@vasquez-jenkins.info,2021-05-16,https://www.cannon.com/
16-Jun-2021,Tax,113.00,00.00,525.58,CE8a09eCd1E0Cc1,2827,Troy,Mckay,"Le, Shah and Gilbert",East Desireetown,Korea,+1-661-469-6307x43965,001-343-009-5290x95666,solisnancy@rivas.com,2022-02-13,https://www.klein.com/
16-Jun-2021,Reversal,00.00,131.40,394.19,b52eF2B5510e9df,5882,Walter,Luna,Nicholson Inc,East Albert,Czech Republic,(283)703-3102x48134,(567)113-9939x31543,samuelvillegas@merritt.com,2020-04-03,http://francis.net/
16-Jun-2021,Transfer,06.65,00.00,400.84,F7c6EFB87beeF1B,3461,Robin,Jones,Banks-Barnett,North Wandachester,Fiji,602.324.8275,001-876-081-7620x5027,iyoung@turner.com,2021-05-05,http://white.com/
16-Jun-2021,Debit Card,00.00,44.54,356.30,11D3c8fba9dBcfF,972,Lorraine,Jordan,Dudley-Ray,Websterfurt,Greenland,(577)491-5862,8376253885,prestonashley@rush.com,2020-10-13,http://www.vaughn.org/
16-Jun-2021,Commission,00.00,44.54,311.76,324aEA95Cb3A886,4550,Judith,Schneider,Watson-Burns,Meadowsmouth,Thailand,331-987-6451,005-561-8093x427,vgood@tran.com,2021-03-08,https://morales.com/
16-Jun-2021,Commission,00.00,38.97,272.79,26CaCF757BbA16d,7884,Gordon,Townsend,"Hunt, Suarez and Morton",Jimmyport,Albania,001-375-182-8083x576,001-709-894-4664x047,bcisneros@snyder.com,2022-04-10,http://mcmahon.info/
16-Jun-2021,Tax,"1,909,368.80",00.00,"1,909,641.59",3932C8cbB30Ed0a,2274,Felicia,Lucero,Avila Ltd,Osborneview,French Guiana,802.899.7840x51231,+1-640-667-9562,prattbryan@mack.com,2020-08-31,http://schwartz.org/
17-Jun-2021,IMPS,00.00,00.00,"1,909,641.59",61BE16F85cBF99e,6518,Vickie,Gillespie,Wells Group,Breannafurt,Niger,380-673-4235x616,475-729-6078x01099,clairemooney@rasmussen.com,2022-03-26,https://rhodes.com/
18-Jun-2021,ATM,"1,196,974.00",00.00,"3,106,615.59",C10a4ddae7cD4fF,3479,Chris,Robertson,Young Inc,East Xavier,Korea,243-419-5092,001-105-688-4853x122,dhood@livingston.com,2021-03-11,http://reilly-nunez.info/
18-Jun-2021,Tax,00.00,"443,802.23","2,662,813.36",42BbB3D5efDb7F3,586,Jeanne,Pope,Hinton-Mullins,Simpsonland,Tonga,+1-441-442-5305x49868,+1-516-060-8430x97851,timothy52@hahn-gonzalez.net,2020-10-08,https://strong.biz/
19-Jun-2021,Transfer,"26,446.00",00.00,"2,689,259.36",54Ea659A810eeae,8308,Mariah,Sherman,Roach-Stokes,East Michaelaport,Nigeria,749-439-7112x0007,656.337.5763,boltonrichard@donovan.com,2020-11-06,https://www.sanford.biz/
19-Jun-2021,Reversal,01.00,00.00,"2,689,260.36",FE5Ee2dEeE4cE28,409,Marilyn,Peck,"Solomon, Potter and Merritt",Oscarborough,Western Sahara,(319)744-3383x354,1974058669,stacy53@gardner.com,2022-04-30,http://www.frank.com/
19-Jun-2021,NEFT,"29,470.30",00.00,"2,718,730.66",9c995e3A4AFCdfF,8596,Amanda,Schaefer,"Figueroa, Barnes and Pierce",North Phillip,Cyprus,(205)738-6119x4925,250.870.6591,aliciavillarreal@benitez.com,2021-04-24,http://www.morales.com/
19-Jun-2021,NEFT,00.00,"339,841.33","2,378,889.33",A4Ef3Aa048c01Ba,2920,Helen,Mercer,Gaines Inc,Mcclurebury,Peru,605-520-0709x3077,259-534-8034x865,kellerkevin@hancock.biz,2021-02-25,http://bowman.biz/
19-Jun-2021,Cash,00.00,"297,361.17","2,081,528.16",1c8289ea71E97D9,2026,Kristopher,Tapia,Day-Mclean,Taylorshire,Faroe Islands,679.554.9438x394,+1-377-070-6392,nprince@small-mckenzie.com,2022-04-21,http://nunez.com/
19-Jun-2021,Purchase,00.00,"297,361.17","1,784,166.99",bc011dE2C2aC99D,1645,Charles,Chen,"Beck, Ortiz and Dunn",Martinhaven,Indonesia,+1-588-534-2721x49783,298.841.1919,eclements@gordon-combs.com,2020-07-06,https://blackwell-williams.com/
19-Jun-2021,Commission,00.00,"446,041.75","1,338,125.24",7BF2702b0BCe65b,4621,Brian,Boyer,Wood and Sons,Davehaven,Libyan Arab Jamahiriya,1948468538,542-775-3922x572,maxwell59@shaw.org,2022-01-31,http://cervantes.com/
19-Jun-2021,Purchase,"7,025.30",00.00,"1,345,150.54",2c5eBF3da13Ee49,1655,Bob,Oconnell,Mills LLC,North Jordantown,Namibia,(517)321-9679x21611,552.734.8814x704,yreid@salazar.org,2020-05-14,http://www.rollins-mayo.com/
19-Jun-2021,IMPS,08.84,00.00,"1,345,159.38",CAbF5AF5DDe559c,571,Karina,Benjamin,Rowland Group,North Loganport,Saint Kitts and Nevis,(362)802-4463x17611,264-909-9938x99397,marcussandoval@watts.info,2022-02-03,https://www.henson.com/
19-Jun-2021,Miscellaneous,55.49,00.00,"1,345,214.87",CF89d6ae45AAdFd,1406,Sheila,Riggs,Mathews-Morrow,Blakemouth,Botswana,283.826.5324,001-155-483-7686x2974,lhuffman@hancock.net,2022-05-09,https://www.bush.com/
19-Jun-2021,RTGS,00.00,"192,173.55","1,153,041.32",0Baaeef2A4bAFCc,2064,Christine,Reynolds,Murphy-Hebert,Arellanoburgh,Lao People's Democratic Republic,(579)233-4974x66128,874-948-6778x56390,simonbradley@hodges.com,2020-11-07,http://www.morrison.info/
19-Jun-2021,NEFT,00.00,"576,520.66","576,520.66",C4f6aCE11C89eb9,6008,Selena,Mathews,Lyons and Sons,North Angelchester,Tunisia,(168)726-5516x795,947-064-5988,simpsonevelyn@moran.com,2020-04-06,http://nguyen.com/
19-Jun-2021,Transfer,00.00,"115,304.13","461,216.53",a23B9b1B24455Bd,4394,Julia,Bradford,"Hodges, Whitehead and Hobbs",New Jefftown,Niue,001-458-732-7019x0126,652.880.5694x7294,conneraaron@villegas-herring.com,2021-01-16,https://kaufman.com/
19-Jun-2021,ATM,175.00,00.00,"461,391.53",B6bF2E1D05CADE7,268,Rebekah,Weiss,Gallagher PLC,Lyonsshire,Oman,925.881.7050,(040)995-5358x7014,stoutwilliam@forbes.com,2020-03-12,http://lutz.org/
19-Jun-2021,Debit Card,00.00,"153,797.18","307,594.35",a3cD4Fa03dA7628,168,Connie,Barker,"Colon, Gill and Anthony",Port Audreyside,Rwanda,194-414-4608x29301,105.674.1585,lindsayrocha@preston.org,2021-07-03,http://www.orozco.biz/
20-Jun-2021,NEFT,10.71,00.00,"307,605.06",5FfDcedF910Ae6c,5236,Alex,Herring,"Zhang, Vargas and Perez",Caitlynshire,Costa Rica,001-766-671-5068x90199,816-105-2005x47291,judithhuffman@johnson.info,2021-05-14,https://www.velez-bennett.org/
20-Jun-2021,Purchase,02.00,00.00,"307,607.06",75e1B0ECAD06F60,1216,Karen,Powell,Ballard Inc,Wallschester,Bahrain,(837)887-4976x23484,+1-692-477-5826x6040,nobleharold@lawrence-christensen.com,2021-03-31,https://reese.com/
20-Jun-2021,IMPS,07.50,00.00,"307,614.56",a82EAeBa61Dbb20,8404,Angelica,Peck,"Nielsen, Valenzuela and Cantu",North Kaylee,Honduras,450.693.1381x0938,590.414.1063,sanfordcameron@carter.net,2021-10-28,http://hill.com/
20-Jun-2021,Tax,00.00,"76,903.64","230,710.92",C14abbce3eCfEDf,119,Charles,Daniel,English Inc,West Shawna,Lithuania,5777723656,+1-840-334-4067x391,ckhan@underwood.net,2020-03-25,https://www.chase.info/
20-Jun-2021,Debit Card,395.20,00.00,"231,106.12",41e6283b4456f0E,9772,Alicia,Whitney,"Mcclain, Villanueva and Mcgrath",Port Mandy,Ethiopia,665.776.9309,6470630722,eduardo87@galloway.com,2021-04-13,http://lloyd.info/
20-Jun-2021,Interest,00.00,"115,553.06","115,553.06",a1A4334f7eA2712,2983,Victor,Dennis,"Medina, Bradford and Medina",Lake Daltonborough,Somalia,454-383-6920,(364)073-1028x351,wkirby@cortez.com,2020-01-01,https://coleman.com/
20-Jun-2021,Miscellaneous,00.00,"38,517.69","77,035.37",dAE25B64E0AbFC1,317,Katie,Rios,"Zhang, Christian and Cruz",North Chad,Croatia,878.633.3191,833-852-7856x6413,jeffersonbrandi@cannon-trevino.com,2021-11-21,http://robbins.com/
20-Jun-2021,ATM,"1,561.50",00.00,"78,596.87",4EE4cd7bfeA4Bc6,898,Preston,Rodriguez,Cantrell Group,South Leetown,Micronesia,(360)745-6810,(665)384-1044,brandyholloway@padilla.com,2020-04-21,http://beltran-wallace.com/
20-Jun-2021,Interest,00.00,"7,859.69","70,737.18",7E2B825e5A2DE2D,8145,Olivia,Carter,Carlson-Williams,Lake Adambury,Sierra Leone,333.953.9619x7319,(796)590-8956,bryantasha@kent-nash.net,2021-06-10,http://www.benjamin-holloway.net/
20-Jun-2021,IMPS,00.00,"7,073.72","63,663.46",C6CeBBaDFf5ED10,3204,Kaitlin,Livingston,Proctor Group,Aguilarfurt,Honduras,593-529-7909x683,(289)643-9861,horncollin@downs.com,2020-07-15,https://cervantes.com/
20-Jun-2021,Cash,"1,977,444.00",00.00,"2,041,107.46",7a619E93F0cA947,5922,Leonard,Reid,"Vega, Carroll and Bell",East Michelle,Dominica,+1-301-236-6777x1811,753.267.0061x585,georgehayley@freeman-freeman.org,2020-05-09,https://www.crane-hamilton.net/
20-Jun-2021,Bill,00.00,"510,276.87","1,530,830.60",923911DB7eE2dd9,5801,Joe,Bolton,"Pennington, Frost and Arroyo",Leonville,Iceland,033.917.3047x7708,(175)321-8077x536,john58@sampson.com,2021-11-03,https://meyer.com/
20-Jun-2021,Purchase,"169,470.00",00.00,"1,700,300.60",Cf287eBA045C59A,7973,Melvin,Reynolds,Gillespie-Kemp,Chandlerborough,Iraq,708-957-2994x79146,(226)228-3088x015,hmurray@fisher.com,2020-08-15,http://ritter.biz/
20-Jun-2021,Miscellaneous,00.00,"566,766.87","1,133,533.73",3cBb4ef80f50f64,2303,Dakota,Pacheco,Mckenzie Inc,Ralphborough,Japan,416.142.8154x7807,001-516-725-4972x387,williamsonfernando@meyers.com,2021-10-29,http://williams.com/
20-Jun-2021,Interest,00.00,"161,933.39","971,600.34",c5Ffc6b5BE3C17c,2423,Barbara,Richard,"Riley, Walton and Hahn",Fullerborough,Dominican Republic,295-326-2930x4054,870.943.1503x23405,meadowstanner@cohen.com,2021-06-02,https://www.vega-choi.info/
20-Jun-2021,Debit Card,00.00,"97,160.03","874,440.31",28fedcB3cF4a7B0,9474,Jean,Allen,"Morrow, Chang and Lam",North Tamaraview,Sao Tome and Principe,124.938.0261,(277)169-9343x7804,alice66@larson.biz,2020-04-26,https://www.campbell.com/
20-Jun-2021,ATM,122.80,00.00,"874,563.11",e0c4AfcBDA20BED,2546,Faith,Madden,"Tate, Calhoun and Blevins",Martinview,Holy See (Vatican City State),+1-685-660-0593,001-016-077-2286x0437,styler@bernard.com,2020-10-30,http://krause.org/
20-Jun-2021,Commission,00.00,"874,563.11",00.00,D8F6Ec6B5EdE6da,2972,Candice,Nixon,Hunt-Santiago,North Nancyberg,Heard Island and McDonald Islands,6335096987,957.984.7008,kiaralindsey@baker-doyle.com,2022-03-21,https://www.mayer.net/
21-Jun-2021,Interest,56.26,00.00,56.26,bd25EBD4ebf2C1d,3804,Courtney,Underwood,Robinson Inc,Terrellburgh,El Salvador,563-006-8236x186,001-524-355-3272x12845,rose11@knapp.info,2021-05-28,https://www.mcconnell.com/
21-Jun-2021,Miscellaneous,00.00,09.38,46.88,E65bAC9F22075AC,290,Damon,Stanton,Joyce Inc,Rubenstad,New Zealand,(311)420-8154x573,+1-962-050-4131x01819,yesenia49@lester-martinez.com,2022-03-06,http://villegas.com/
21-Jun-2021,NEFT,00.00,46.88,00.00,bD3e24AB79D9791,3489,Alison,Kaufman,Stuart Inc,North Elizabeth,United States Minor Outlying Islands,965.693.7696,496.058.8718,cjohnson@rice-andersen.net,2020-10-15,https://rojas-mccall.com/
21-Jun-2021,ATM,593.00,00.00,593.00,7Ca6e4780EaDFDb,8774,Phillip,Russell,Washington-Ball,Calebview,Vanuatu,001-890-679-1683x863,(514)616-1176,carriemeyer@fletcher.com,2022-01-14,https://mcmillan.com/
21-Jun-2021,Interest,01.11,00.00,594.11,899B7A9025aDebb,573,Mathew,Tucker,Rivera LLC,Henrymouth,Luxembourg,+1-807-291-0164x062,+1-153-243-2316x439,taylormartin@donovan-hendricks.info,2021-12-03,http://west.info/
21-Jun-2021,Cash,"12,531.00",00.00,"13,125.11",e9afebccEFCdDc3,6546,Aaron,Pena,"Pollard, Michael and Powell",Port Gavinville,Angola,001-177-689-2075x4203,174.951.0383x2871,yvettewalters@arias.net,2020-08-16,http://www.wilkinson.com/
21-Jun-2021,ATM,00.00,"1,312.51","11,812.60",F4ac9a739556893,5881,Dave,Benitez,Haley-Pacheco,Port Sharon,Philippines,(761)001-3181,+1-411-512-0926x776,darryl04@aguilar.com,2021-11-19,http://www.meyers.com/
21-Jun-2021,Debit Card,"197,781.00",00.00,"209,593.60",EbadC2c181FFB6d,9176,Brent,Tanner,"Acevedo, Richardson and Stokes",New Katherine,Venezuela,444-976-6696,(187)640-4324x13980,mcconnelldeanna@dalton.com,2022-02-26,https://sosa.biz/
21-Jun-2021,Transfer,00.00,"20,959.36","188,634.24",F27d7bbcD560dAd,8227,Brandon,Frost,Spears PLC,Lake Michael,Bolivia,+1-394-629-0417x640,(838)378-4324,astrickland@chan.com,2022-02-11,http://www.watkins.info/
21-Jun-2021,Interest,00.00,"20,959.36","167,674.88",A87ADB9f283fBBC,5774,Sandra,Fitzgerald,Vazquez and Sons,North Carlmouth,Taiwan,(354)535-0766x42008,4789416814,chobbs@richmond.biz,2021-01-29,https://www.ramsey.org/
21-Jun-2021,Cash,"2,454.40",00.00,"170,129.28",dE4ca9b20C1300C,3717,Vernon,Chaney,"Morrow, Hanson and Huynh",Eugenestad,Somalia,(970)643-1026,496.435.7785x8819,harold62@duffy-mejia.com,2020-05-02,http://www.braun.org/
21-Jun-2021,RTGS,51.69,00.00,"170,180.97",78D08ba5622CCF4,3722,Marisa,Hickman,Cherry-Thomas,Macdonaldbury,Montenegro,808-836-1866,+1-844-740-8958x49312,valeriechristensen@berger.com,2021-12-31,http://pittman.com/
21-Jun-2021,IMPS,"1,387,274.50",00.00,"1,557,455.47",28CeCdF5CF5bd8a,8387,Francisco,Schultz,"Shannon, Perkins and Atkins",North Ellenport,Nepal,001-878-538-5497x962,001-043-420-0123x330,fryesylvia@lucas.com,2020-01-17,http://gordon-lloyd.biz/
21-Jun-2021,Tax,00.00,"155,745.55","1,401,709.92",82CbdB72C2b3CE8,5505,Jordan,Swanson,Curry-Freeman,Cainshire,Ukraine,001-940-108-9844x681,+1-163-941-6826,earlmcgee@cox.biz,2022-04-22,https://blevins-miller.com/
21-Jun-2021,Cash,01.90,00.00,"1,401,711.82",aaD5c7FbF3f6D4d,4497,Brett,Goodwin,Ponce PLC,North Biancaberg,Panama,628-129-6530,140-318-3362x43308,dalton92@lopez.com,2021-01-06,https://www.pope.com/
22-Jun-2021,Miscellaneous,00.00,"200,244.55","1,201,467.27",28AaBDDbb69FE3D,4882,Latasha,Shannon,Melendez-Roberson,Cristianhaven,Cocos (Keeling) Islands,001-864-327-8012x8512,(029)676-7544x527,fgriffin@wade-ballard.net,2021-12-26,http://mendez.info/
22-Jun-2021,IMPS,"2,866.82",00.00,"1,204,334.09",97De8e12e4d6D4c,2110,Dale,Glover,Middleton-Bailey,Kirkton,Russian Federation,+1-865-017-0897,(623)074-5647x23370,iburke@case.com,2020-02-23,http://rodriguez.com/
22-Jun-2021,RTGS,00.00,"200,722.35","1,003,611.74",980E92207901934,645,Tabitha,Terry,Li-Ballard,Chrisland,United Arab Emirates,001-312-600-4378x8114,781-562-6124x027,valerie54@cabrera-leach.org,2021-02-18,https://www.roach-velazquez.com/
22-Jun-2021,Cash,00.00,"1,003,611.74",00.00,a8fb6bcF8bFf51a,5663,Justin,Bell,"Gardner, Hendricks and Ferrell",Castrotown,Gambia,001-889-787-6501x37470,+1-212-040-5219x290,angel77@hahn-drake.com,2021-02-18,https://www.scott.com/
22-Jun-2021,Reversal,"69,708.34",00.00,"69,708.34",B9DCaC19254369b,4975,Dominique,Tapia,Meadows-Cooley,Lake Garyborough,French Polynesia,857-570-8724x2249,2200454553,sherryellison@garza.com,2020-09-19,http://mcintyre.info/
22-Jun-2021,ATM,"585,696.50",00.00,"655,404.84",75b6e8F85128EbC,6127,Darren,Becker,Coffey and Sons,Carneyborough,Andorra,001-104-682-1003x2035,1888011391,camposrachel@savage-gaines.com,2021-06-28,http://www.ballard-knox.org/
22-Jun-2021,Miscellaneous,00.00,"131,080.97","524,323.87",1ECAA049CCaAA7B,131,Brady,Mckay,Decker Group,East Brady,Cape Verde,1934272027,+1-248-385-9619x891,travisfoley@brandt.com,2021-05-25,https://blake.net/
22-Jun-2021,Reversal,"17,502.40",00.00,"541,826.27",5a92768EE067db8,2383,Rick,Mclean,Frazier Ltd,West Walter,Turkey,+1-206-337-7450x7746,0350748018,brittanywarren@orr-lane.com,2021-11-23,https://mccullough.com/
22-Jun-2021,Reversal,16.10,00.00,"541,842.37",Ad89CaCdfDbCEbd,449,Ricardo,Pena,Kelly-Duncan,Port Marvinton,Saudi Arabia,5639394528,155-580-4863x3801,elizabethhobbs@parker.com,2021-08-21,http://cline.info/
22-Jun-2021,Transfer,"3,258.90",00.00,"545,101.27",ebbFFAC8F3BfEdF,8073,Preston,Hodges,Macdonald LLC,Nixonstad,Ecuador,+1-449-473-0553x83370,(204)230-9638x204,tatederrick@cohen.net,2020-12-28,https://farley.com/
23-Jun-2021,Bill,920.80,00.00,"546,022.07",aCf1FEdbb2Eb42f,2985,Corey,Price,"Wilson, Walter and Wiggins",Kerryview,Colombia,819-595-1517x78342,(194)638-6694x2749,apruitt@mayer-calderon.com,2021-08-29,http://www.lambert.net/
23-Jun-2021,Commission,00.00,"136,505.52","409,516.55",cB5bF4B1e78Ecda,412,Kevin,Munoz,Knapp-Bernard,Castanedamouth,Seychelles,(858)198-9773x6361,020-176-9382,eboyer@hebert-rosario.info,2021-02-13,https://www.cohen.com/
23-Jun-2021,Commission,00.00,"45,501.84","364,014.71",A33AcFF8Cf1e9a3,2762,Jeffrey,Barnett,"Ashley, Proctor and Howard",Solisberg,Tajikistan,001-575-187-8720x0807,001-261-313-6689x9102,ghuynh@wood.org,2020-08-14,http://costa-orozco.org/
23-Jun-2021,IMPS,00.00,"91,003.68","273,011.03",E9D6db133f3890C,1235,Raven,Bell,"Harding, Mcpherson and Montgomery",North Cody,United Arab Emirates,882-717-3473x56100,(415)270-8564,carpenterjeff@gomez.net,2020-12-19,http://www.warner.org/
23-Jun-2021,Cash,00.00,"136,505.52","136,505.52",dcCbdebbfedbf5E,8653,Lance,Brown,Santiago Ltd,New Derekport,Tajikistan,306.206.6517,772.985.2111,bellbryan@watson.net,2021-10-10,https://contreras.org/
23-Jun-2021,Tax,00.00,"22,750.92","113,754.60",9Af09EA67ba07B6,9963,Mitchell,Hatfield,Guzman-Parker,Isaiahberg,Algeria,(374)371-7289x560,866-207-3765x11824,hulltheodore@morton.com,2021-02-01,http://flores.net/
23-Jun-2021,Miscellaneous,333.61,00.00,"114,088.21",1B439BE4d8bb9E1,5055,Shawna,Hull,Blankenship-Santana,Joyfurt,France,495.743.2987,160-628-5818x800,marcuspineda@benson.info,2020-07-28,http://cuevas.biz/
23-Jun-2021,Bill,00.00,"38,029.40","76,058.81",9eF9f441eA9FD8c,5497,Denise,Estes,Reynolds Ltd,North Kristenton,South Africa,976.083.8808,+1-980-880-7444x88942,eugene10@henson.com,2021-01-08,https://www.montgomery.info/
23-Jun-2021,Transfer,"2,261.38",00.00,"78,320.19",40CDdF3bAAAE4fE,5983,Sergio,Trujillo,Lewis-Hawkins,Deannahaven,Nauru,+1-149-359-2309x99905,3509150420,stephensonkent@sharp.com,2020-02-17,http://wiley-barr.com/
23-Jun-2021,RTGS,"30,531.90",00.00,"108,852.09",6F3e21A305fd1b9,3733,Helen,Ho,"Holden, Dawson and Whitney",South Tristan,Luxembourg,3716399654,+1-023-756-3769x01058,kylezimmerman@adkins.com,2021-03-16,https://turner.com/
23-Jun-2021,Reversal,58.80,00.00,"108,910.89",eEaA6F9Fd9D1cd6,1914,Darin,Frederick,Wilkerson and Sons,East Grant,Niger,(753)711-9659,685-940-4112x795,tannerseth@hughes-hawkins.com,2020-02-08,http://www.valdez-carr.org/
23-Jun-2021,Interest,00.00,"21,782.18","87,128.71",df9e60a1F833b8c,8457,Tamara,Wells,Espinoza and Sons,Port James,Turkey,243.169.1647,281.641.6910x0329,dennis24@morris-black.com,2022-02-11,http://www.cisneros.com/
23-Jun-2021,RTGS,02.90,00.00,"87,131.61",03dDeF0a6206bCd,1506,Jermaine,Hayden,Carr-Chung,Jorgefurt,Libyan Arab Jamahiriya,+1-794-570-4578x177,723.774.6444x37947,lsimmons@chavez-silva.com,2021-03-24,https://ellis.com/
23-Jun-2021,RTGS,04.00,00.00,"87,135.61",B7A38CEFF3c04F6,9960,Carl,Lin,Chapman Group,Timothychester,Antigua and Barbuda,001-054-077-3590x9538,4210511927,stevensonstuart@leon.com,2022-02-28,https://sandoval.com/
23-Jun-2021,RTGS,00.00,00.00,"87,135.61",6E2f5f6cdBBfD6E,6696,Gregg,Ritter,Evans Inc,Ronnieshire,Cambodia,924.099.7533x486,303-112-5557,jade57@sullivan.com,2020-12-15,http://www.johnson.biz/
23-Jun-2021,Commission,"8,517.60",00.00,"95,653.21",b7eD7a2dBd4Fb3D,7701,Karla,Williamson,Nash-Randall,Rosarioborough,Macedonia,6320459118,7027311866,tony97@carson.biz,2022-04-19,https://zhang.com/
23-Jun-2021,Interest,00.00,"15,942.20","79,711.01",4bb7da595370acF,5455,Alejandro,Avila,Figueroa-Finley,North Lawrence,Myanmar,001-676-546-9252x8454,001-055-817-8171x0182,kellishaw@valenzuela-trujillo.com,2021-07-25,http://www.santiago-rios.info/
24-Jun-2021,Purchase,139.29,00.00,"79,850.30",ce7F17704E5f091,9964,Robin,Kidd,Flowers and Sons,Marissaberg,Ecuador,001-578-577-3426x08518,711.403.6167x237,fgill@cline-perkins.com,2020-03-26,https://www.oneal.info/
24-Jun-2021,Transfer,07.00,00.00,"79,857.30",5449Aca30d9dC19,8928,Phillip,Li,"Choi, Lamb and Campbell",Lake Travisfurt,Yemen,+1-026-220-6575,001-656-274-7440x0630,kerry80@marquez.com,2022-03-18,https://www.dyer-sharp.com/
24-Jun-2021,Transfer,00.00,"13,309.55","66,547.75",D9544D1Ba89D1c8,2545,Perry,Moody,Evans Ltd,North Susanmouth,Israel,943-114-1789,049.390.4695x7828,harperalfred@ford.info,2021-03-25,https://www.roberts.com/
24-Jun-2021,Miscellaneous,00.00,"8,318.47","58,229.28",B6a7d1dC7c7Fc4A,1501,Oscar,Dorsey,Jennings Inc,Port Kellie,Kuwait,(119)524-0104x8633,024-317-7794,landrymakayla@moran.com,2020-08-17,https://www.cortez.biz/
24-Jun-2021,Reversal,00.00,"14,557.32","43,671.96",01958cCCe8aB8A8,6815,Julie,Moore,"Raymond, Juarez and Werner",Port Lacey,New Zealand,+1-397-794-8374x7296,+1-581-548-0899,michelle32@reese-marshall.com,2021-08-09,https://pena-mclean.com/
24-Jun-2021,Miscellaneous,00.00,"5,459.00","38,212.96",DA362AFEB5E6491,7274,Mackenzie,Harrington,"Fritz, Valdez and Nixon",Stephensontown,Israel,509-370-5178x95198,+1-602-084-2455x0375,bethanyweaver@vasquez.info,2020-05-19,http://villarreal.org/
24-Jun-2021,Interest,00.00,"9,553.24","28,659.72",CB0BdebF3523bA0,4384,Annette,Dunlap,"Santiago, Hess and Nelson",Brycemouth,United Kingdom,(397)125-9150,302-895-1975,cathymiranda@welch.biz,2022-01-17,https://douglas.info/
24-Jun-2021,Cheque,00.00,"4,776.62","23,883.10",F9fFdf3d33a36EB,9522,Toni,Johnson,Salas Group,New Taylorberg,Tanzania,+1-812-106-8469,845-438-7600x276,mckenzie58@hudson-woodward.net,2021-03-30,https://www.beard-vang.com/
24-Jun-2021,IMPS,88.93,00.00,"23,972.03",DE662Ecaa7A0cbf,8336,Lindsey,Benson,Mccoy-Weeks,Hooperbury,Latvia,301.026.7927x189,(497)678-6161x3375,jaclynchase@rangel.com,2021-07-17,http://www.pruitt.com/
24-Jun-2021,IMPS,146.20,00.00,"24,118.23",ebA778dc69aaF48,8889,Tim,Silva,Cantrell-White,Boltonside,Syrian Arab Republic,020-249-1615x7738,5394195194,dan16@stanley-dixon.com,2020-06-28,https://www.boone.com/
24-Jun-2021,Interest,00.00,"4,019.71","20,098.53",cC0cBBa88DEe269,8931,Grant,Frost,"Rodgers, Washington and Key",Joanmouth,United Kingdom,351-660-8868x687,001-704-828-7421,clementsleon@sexton.com,2020-01-28,https://www.boyle-barnett.biz/
24-Jun-2021,Bill,00.00,"10,049.27","10,049.26",CadF3E4Af2ea92e,2168,Joy,Lynn,"Brennan, Fox and Horn",Lake Lynn,Burundi,800-401-8785x595,700-573-1916,scarney@maynard.com,2021-06-01,https://barrett-lozano.org/
24-Jun-2021,Miscellaneous,00.00,"1,116.58","8,932.68",ff1a40cA96beB0F,7209,Sherry,Kent,"Craig, Herrera and Benton",North Johnathan,Reunion,699.766.2169x702,+1-761-068-9064x31331,egill@payne.com,2020-09-01,http://petersen.com/
24-Jun-2021,ATM,00.00,"1,488.78","7,443.90",0EEC67EE5de9DcA,9744,Selena,Hawkins,"Thornton, Schultz and Esparza",West Janice,Bangladesh,499-111-8087x211,001-194-341-1014,hollowayluke@craig-haley.com,2020-12-26,https://www.mayer-meadows.com/
25-Jun-2021,Tax,00.00,"2,481.30","4,962.60",DeF4B9e08eAE8a7,229,Olivia,Saunders,"Sanchez, Coleman and Leon",Lisaville,Korea,298.311.2706x59582,+1-498-562-7577x9389,triciarichards@shelton.net,2021-03-30,http://www.hurley.com/
25-Jun-2021,Tax,"4,090.60",00.00,"9,053.20",AEBc2cbC73AB569,8576,Todd,Pace,"Ibarra, Oconnor and Mcdaniel",East Brucemouth,Myanmar,(929)772-9780,644-161-2685,kcisneros@rosales-kirby.com,2021-10-08,http://may-stevens.com/
25-Jun-2021,RTGS,05.44,00.00,"9,058.64",0aB3b979af2d6D0,1904,Mckenzie,Jackson,"Mcgrath, Escobar and Cuevas",Henrymouth,Burkina Faso,299.348.8964x6462,(402)661-4214x6322,brosario@mercer.com,2021-11-30,http://foster.info/
25-Jun-2021,ATM,00.00,"1,509.77","7,548.87",F91a3190ff778F1,8150,Frances,Ray,Boyd LLC,Chambersshire,Vietnam,502.519.6316x597,(384)443-7156x5635,adrianamarks@mahoney.com,2020-11-01,http://mckinney.com/
25-Jun-2021,Commission,"32,518.23",00.00,"40,067.10",8CB58f03eFe6dDe,2461,Guy,Solomon,Huerta-Rivas,Lake Leonard,Syrian Arab Republic,001-457-175-0519x21265,+1-503-004-3154x96800,kgay@kelley.net,2020-09-22,https://www.weber.net/
25-Jun-2021,Commission,00.00,"4,451.90","35,615.20",f0d9CaAb9d8cfbe,4177,Danielle,Rocha,Flores-Scott,West Isaiah,Portugal,+1-078-800-5568x2810,(364)182-2597x901,raybrandt@meyer.info,2021-02-19,http://www.bonilla-hays.info/
25-Jun-2021,Reversal,"456,296.00",00.00,"491,911.20",427eC087b8aD8De,7774,Sheena,Knox,Herman LLC,North Regina,Anguilla,026.263.3719,544.904.1188x37868,mccalleric@castro.info,2020-01-22,https://peterson.com/
26-Jun-2021,Debit Card,00.00,"98,382.24","393,528.96",318C871DC39180F,7149,Kristina,Andrade,Mooney-Braun,South Brandi,Bahamas,001-476-620-0143x943,001-784-479-5295x4030,englishstephanie@cole.info,2020-02-14,http://mercer.org/
26-Jun-2021,Debit Card,00.00,"43,725.44","349,803.52",b5fceAA9bdFa8ed,6612,Molly,Moreno,Arias Group,Ginaborough,Ethiopia,4096378199,(959)437-7243x658,piercecharlotte@oliver-clayton.com,2020-10-20,http://kelley.com/
26-Jun-2021,IMPS,"2,764.20",00.00,"352,567.72",Db87b34F1c3Afe5,5124,Jeff,Martinez,Mccormick-Charles,North Mariah,Turks and Caicos Islands,001-417-065-5343x59012,(236)122-8942,reynoldshelen@duncan.com,2020-05-08,https://www.acosta.info/
26-Jun-2021,Commission,"2,715.30",00.00,"355,283.02",E4E877F2BBCc6bd,3931,Xavier,Nichols,Stein and Sons,Duncanside,Liberia,(284)769-4218,289.116.6092x01244,tcantrell@mills.com,2021-06-23,https://gill.biz/
26-Jun-2021,NEFT,00.00,"88,820.76","266,462.26",6b77bdcCA49b46A,7710,Jodi,Vega,"Pope, Mccormick and Potts",West Ethan,Singapore,080-665-9736x9961,(658)660-1176,moodybrent@todd-blair.net,2021-11-30,http://kaufman.com/
26-Jun-2021,Cash,"834,916.00",00.00,"1,101,378.26",b5988BAea396458,2306,Evan,Yu,Hines PLC,Fostermouth,Greenland,715.900.6400x3228,+1-431-302-0386,kaitlynstevenson@crane.info,2021-11-01,http://www.stevens.com/
26-Jun-2021,Miscellaneous,"113,116.20",00.00,"1,214,494.46",7FBAF8cF7bfCA28,8824,Jesus,Merritt,Mcneil PLC,West Summer,Reunion,+1-424-507-7659x498,994.486.2703,theresacampos@fry.biz,2020-07-15,https://thornton.com/
26-Jun-2021,Debit Card,00.00,"303,623.62","910,870.84",57A2eD6Ac5Fafc6,1071,Victor,Pacheco,Liu Inc,South Lawrence,Switzerland,(111)620-4826,(360)409-8871x57625,ocastaneda@webb.com,2020-01-31,https://clarke-beltran.net/
26-Jun-2021,Transfer,00.00,"130,124.41","780,746.43",dBDF0Bd0E6eedd5,7894,Gabriella,Ramsey,Powell PLC,Lake Joann,Norway,+1-127-978-7134x6546,589-175-0933,madison31@cohen-haney.biz,2020-02-24,http://pope.com/
26-Jun-2021,Transfer,"15,835.00",00.00,"796,581.43",d775FF99778369d,6473,David,Jefferson,Mckay-Moore,New Kayla,Sao Tome and Principe,5844265679,615-963-3116,jsimmons@stokes-avery.info,2021-07-30,http://reed.info/
26-Jun-2021,Debit Card,00.00,"132,763.57","663,817.86",edfB01F44A98A6F,4906,Kristina,Rice,Mooney and Sons,North Judithtown,Wallis and Futuna,284.521.5192,001-296-315-3444x400,nicholecombs@french.biz,2021-07-15,https://blanchard.com/
26-Jun-2021,Cash,07.40,00.00,"663,825.26",Be68a1f75F6cBCB,7681,Ross,Zimmerman,Dickson-Thompson,East Albertshire,Uruguay,304-826-2097x5386,001-750-249-2695x959,chelsea02@sharp-flynn.net,2020-12-22,http://www.holmes.com/
26-Jun-2021,Cash,243.00,00.00,"664,068.26",Af5cb1c65CEaaA0,3813,Don,Thompson,Clements LLC,New Max,Cambodia,255-615-1653x21995,9607537041,christinekrause@avery.com,2020-03-30,https://www.grimes.net/
26-Jun-2021,Miscellaneous,326.48,00.00,"664,394.74",CF04ed55A5EFF3E,9418,Nichole,Jackson,"Frazier, Hernandez and Bentley",Port Adam,Nepal,022-424-1498,772-764-7053x2941,stacie72@salinas-tucker.com,2022-01-08,https://carlson.org/
26-Jun-2021,Tax,00.00,"132,878.95","531,515.79",BBf829aFF7c28BA,3566,Charlotte,Melendez,"Friedman, Fernandez and Woodard",New Melindaburgh,Bulgaria,(035)005-1877,0092847651,faithclark@haney.org,2021-10-11,https://blanchard.info/
26-Jun-2021,Cash,00.00,"132,878.95","398,636.84",Ef922f8ac05E954,2065,Courtney,Stephenson,Mckay LLC,Contrerasview,Christmas Island,955-957-2546x0811,142-136-5775x06835,louis40@richards-oconnell.com,2020-12-11,https://wong-henson.net/
26-Jun-2021,RTGS,00.00,"79,727.37","318,909.47",dA23dA7eb28CCA9,458,Daniel,Charles,"Dorsey, Cook and Kaufman",Port Gilbertfort,Libyan Arab Jamahiriya,618.772.9522x892,001-047-754-2640,marvinwoodard@lam.biz,2020-03-07,http://braun.com/
26-Jun-2021,ATM,307.80,00.00,"319,217.27",F9Ca2c184437d03,6669,Carl,Gilbert,Crosby PLC,Skinnerburgh,Greenland,001-456-243-8798x75376,+1-670-095-0278,mhays@peterson-hull.com,2020-06-26,http://www.bates.com/
26-Jun-2021,IMPS,00.11,00.00,"319,217.38",6282f60feC4Da18,3719,Jane,Harrell,Donaldson-Garrison,Kelseyshire,Bahrain,+1-320-458-7908x790,(185)855-4199x23247,kenneth47@wells.net,2020-06-10,http://www.galvan.org/
26-Jun-2021,Tax,99.00,00.00,"319,316.38",d0D0F0b144d26DE,2038,Ashley,Massey,"Carson, Hopkins and Cunningham",North Janechester,Djibouti,919.255.0384,259-123-6072x16797,hensonzoe@gaines.com,2020-04-15,https://www.reilly-terry.biz/
26-Jun-2021,Commission,00.00,"31,931.64","287,384.74",624e2aEbFf6C72b,2504,Kristin,Hull,Aguilar-Zimmerman,Basston,Martinique,627-486-3182x6880,810-757-7863x6863,brucenancy@burke.com,2020-03-15,https://www.dunlap.com/
26-Jun-2021,Debit Card,00.00,"31,931.64","255,453.10",09dB4fA1a47f90a,6852,Bryan,Arroyo,Chung PLC,Elizabethmouth,Nigeria,323-597-9163,884.921.7945x21097,dramsey@ramos.com,2020-08-26,https://fuller-krause.com/
27-Jun-2021,Transfer,97.08,00.00,"255,550.18",04Daf5dc38672AC,6225,Roger,Meyer,"Conway, Elliott and Tate",Sheppardview,Netherlands,001-101-710-1157x7462,500.023.2929x5169,kristinagordon@hartman-merritt.com,2020-10-11,http://vaughan.net/
27-Jun-2021,Commission,"1,539,402.00",00.00,"1,794,952.18",3079eE405B9cC7f,1025,Chelsea,Cuevas,"Chen, Butler and Tapia",Russellfort,Wallis and Futuna,+1-073-936-9044x475,642.504.2102x457,bingram@horton-holder.com,2021-09-02,http://leonard-dudley.net/
27-Jun-2021,Debit Card,"1,450,597.80",00.00,"3,245,549.98",F3D4b4B8fEa3ad4,5988,Jade,Daniels,Blanchard Group,South Destinymouth,Belize,464-311-4296,001-775-052-5536,leonardbrady@hawkins-hill.com,2020-10-12,https://hess.biz/
27-Jun-2021,Cheque,00.00,"324,555.00","2,920,994.98",3484F53b119dFBd,9402,Shirley,Boyer,"Mathews, Newman and Aguilar",North Latoya,Chad,5208554746,(880)877-8246x40907,liujim@dunn.com,2021-08-25,http://www.potter-avery.biz/
27-Jun-2021,Purchase,230.00,00.00,"2,921,224.98",3487A48DBCEfCfC,6635,Edwin,Spence,"Skinner, Perez and May",Summersberg,South Africa,(192)993-8692x35970,(461)975-4555x69272,vincentkrause@fischer-brandt.com,2020-12-03,https://miles.net/
27-Jun-2021,ATM,22.80,00.00,"2,921,247.78",7aD4Fb91103a5eb,8215,Cole,Berger,Young Inc,New David,Sao Tome and Principe,(942)737-3002x661,+1-320-795-3165,wbender@flynn.org,2020-12-28,https://horton.com/
27-Jun-2021,Interest,701.42,00.00,"2,921,949.20",31C0ADfa5F40c40,465,Shirley,Anthony,Maxwell Ltd,West Tonistad,French Polynesia,+1-193-838-3198x1601,5959421166,phillipshayley@carr.com,2020-05-08,http://mcdowell-pugh.info/
28-Jun-2021,Reversal,00.00,"973,983.07","1,947,966.13",99e3711ba06B94A,1423,Timothy,Perry,Randall and Sons,Lake Cassandra,Togo,(801)315-8311x6874,685.879.0528x33358,malikbradley@pierce.com,2021-11-05,http://www.stokes-arias.info/
28-Jun-2021,Debit Card,00.00,"243,495.77","1,704,470.36",DB2C9D8cC75dd2d,1574,Jeremiah,Vang,"Serrano, Mills and Roman",Khanville,Turkey,+1-934-656-1056x70855,001-114-534-9654,patrickallen@sims-moore.com,2021-05-25,http://www.gillespie.com/
28-Jun-2021,RTGS,00.00,"852,235.18","852,235.18",cb74bb4Db79aF64,8298,Stephen,Woodward,Gates-Sweeney,Henryport,Comoros,7446547584,001-357-807-2461x5770,geverett@haas.com,2021-09-18,http://weaver-day.com/
28-Jun-2021,Cheque,00.00,"284,078.39","568,156.79",5CafBaecA4D78ea,4674,Darren,Dudley,"Bowen, Ho and Mays",South Dorisberg,South Georgia and the South Sandwich Islands,642-370-5582,(613)162-6050x25919,zoe41@bray.com,2020-03-11,http://www.grant.com/
28-Jun-2021,ATM,00.00,"113,631.36","454,525.43",15B4dFBCFFFe863,6892,Ross,Cross,Scott and Sons,Lynnbury,Lebanon,+1-440-680-0239x558,968.990.8519,holtfrank@hughes-newman.com,2021-09-30,http://www.duffy-estrada.com/
28-Jun-2021,Tax,00.00,"64,932.20","389,593.23",91Bd624Ea6Dd56D,8489,Lynn,Franco,Mahoney Group,Port Benjamin,Iceland,001-623-107-8577,9822264272,brandonweaver@hendricks.com,2020-07-23,https://www.blackwell.com/
28-Jun-2021,Reversal,00.00,"129,864.41","259,728.82",8FBbaF601F4EDbE,2635,Rachel,Yates,Short-Kim,Jeromefort,Bangladesh,(774)021-4092x105,(977)929-3235,vcurtis@rollins-dodson.com,2020-10-28,https://www.wilkins-brown.net/
28-Jun-2021,Transfer,42.00,00.00,"259,770.82",92cC1bEA51B1fdA,3905,Yolanda,Burton,"Blair, Hahn and Mcpherson",New Eddieport,Micronesia,675.506.9832x2301,001-007-313-9532x9738,pedrodougherty@ramos.org,2021-01-16,https://brennan.com/
28-Jun-2021,IMPS,"174,008.00",00.00,"433,778.82",672c631cdcbD6B7,3592,Sandra,Moran,"Morrison, Welch and Wyatt",West Erika,Morocco,(141)401-3428x5493,140.981.7765,ashleylindsay@bruce-hoover.com,2020-04-26,https://www.monroe.com/
28-Jun-2021,RTGS,00.00,"144,592.94","289,185.88",Ea7A6ebbdaDAc53,5336,Rick,Lewis,"Good, Cantu and Cunningham",Sergiohaven,Lebanon,(225)258-2241,+1-274-496-3398x7470,wardjade@howell.com,2020-07-22,https://www.scott.com/
28-Jun-2021,Reversal,00.00,"57,837.18","231,348.70",90bD72efe90B2De,3070,Claudia,Cunningham,"Coffey, Ibarra and Shepherd",Fishermouth,Lebanon,498.238.5011,(552)161-4324,pmartinez@faulkner.net,2020-09-18,https://www.lopez.com/
28-Jun-2021,Purchase,24.50,00.00,"231,373.20",578ebD0cfbefcd7,3828,Bianca,Hutchinson,Shah PLC,South Seth,Germany,8190244592,965.815.1973x439,msingh@olsen.com,2021-07-24,https://floyd.com/
28-Jun-2021,IMPS,00.00,"57,843.30","173,529.90",70F2d86fD499DD3,5931,Craig,Campos,Rowland-Macias,Lake Shaun,Bahamas,971-846-8719x3323,001-700-367-3481x027,moranalfred@bullock.biz,2020-11-26,https://www.michael-booth.com/
28-Jun-2021,Tax,"173,746.91",00.00,"347,276.81",34a85DCEA1F4792,6501,Bridget,Mayo,"Shah, Wilkins and Bean",Proctorport,Saint Barthelemy,+1-330-991-0805,+1-477-581-8367,kparks@chung.org,2021-07-28,http://www.franklin.com/
28-Jun-2021,Interest,00.00,"86,819.20","260,457.61",dB52fA7Bec665C1,19,Kristin,Valencia,Liu-Douglas,Martinezstad,French Southern Territories,443-671-1725x7073,6244311825,andrewsanders@marks.com,2021-04-17,http://www.myers.com/
28-Jun-2021,IMPS,00.00,"86,819.20","173,638.41",381C8D12FE2dAaE,9885,Ann,Kirk,Davies PLC,East Coreyberg,Nauru,(754)190-5780,+1-584-168-3401x576,zimmermanmackenzie@hughes-villa.net,2020-06-12,http://spence.com/
28-Jun-2021,Reversal,"25,992.29",00.00,"199,630.70",0fc2d2Ee22DFdBC,9320,Jose,Crawford,Vincent Inc,Lake Lisa,Mauritania,328-745-0380x49376,043-120-5422x2577,emilycamacho@brandt.com,2021-09-14,https://velazquez-watkins.com/
28-Jun-2021,Tax,00.00,"22,181.19","177,449.51",8Eed1CFcE915277,5452,Leah,Cross,Stone Group,West Kellymouth,Iraq,530-405-6674,+1-819-611-8467x359,bperez@ray.com,2021-04-16,https://www.cooper.com/
28-Jun-2021,Commission,"3,679.00",00.00,"181,128.51",03ca10Fd000ecee,145,Susan,Eaton,"Cummings, Lloyd and Price",Valdezfort,Benin,001-275-034-2623x632,063-805-8277x21263,daltonrangel@prince.biz,2021-04-27,http://www.elliott-tyler.org/
28-Jun-2021,Cheque,03.94,00.00,"181,132.45",4EdbcFcfdEEA1bf,7394,Alice,Flynn,"Sandoval, Riley and Blair",South Sharonshire,Ecuador,+1-418-528-0742x805,+1-362-609-1060x134,darylhogan@morrison.com,2020-10-09,https://jefferson.com/
28-Jun-2021,Purchase,15.03,00.00,"181,147.48",496Da7aEA5556ec,182,Courtney,Arellano,Mcconnell-Bell,East Daveview,Tuvalu,491-320-8110x76440,564.485.3698x25415,sandy44@thomas.com,2020-11-13,https://bradford.com/
28-Jun-2021,Reversal,00.00,"22,643.44","158,504.05",C3a39911dF168CC,4772,Natalie,Montes,Weeks-Oneal,Derekshire,Barbados,523-687-5310x76899,2044271951,alyssanielsen@baxter.biz,2021-06-10,http://barker.net/
28-Jun-2021,Debit Card,"65,875.00",00.00,"224,379.05",d78bDeD91FCD5Af,549,Janice,Hardin,"Boyd, Tran and Rodriguez",North Tanyabury,Saint Martin,(178)175-3576x5843,(998)696-7353x6637,huntkristin@woodard.com,2021-10-12,https://www.thomas.com/
28-Jun-2021,Transfer,"1,898.70",00.00,"226,277.75",Fe820D56DCCB580,5062,Amber,Sparks,"Dawson, Haney and Mathews",New Bernardton,Niue,744-420-0889x43813,668.796.9842,schultzdevon@gilmore.biz,2020-07-03,https://winters.com/
28-Jun-2021,NEFT,00.00,"28,284.72","197,993.03",B25FEe60b6ECc9F,9034,Jeanne,Stout,Garrison Group,Sosaview,Guatemala,552-546-8104x50352,001-971-183-8113x979,ischneider@decker-burns.com,2021-05-05,https://www.fry.com/
28-Jun-2021,Commission,00.00,"28,284.72","169,708.31",5fcECFab34da3f8,5959,Jonathan,Powell,Moss-Golden,Odonnelltown,Norfolk Island,700.745.5553x96349,059.534.8112,wperry@deleon-morris.com,2020-07-04,https://www.white-herman.com/
28-Jun-2021,Debit Card,"3,494.07",00.00,"173,202.38",8C748685c6027F5,6702,Destiny,Cabrera,Macias PLC,Port Maxville,Slovenia,001-554-052-4697x25951,001-303-609-1517,zpham@clayton.com,2021-12-20,http://nichols.com/
28-Jun-2021,RTGS,"9,630.00",00.00,"182,832.38",BED9e8A2122F5B6,2091,Kristina,Wilkinson,"Foster, Rose and Harris",Katrinahaven,Cuba,+1-514-799-4273x968,8582658943,bergdavid@lindsey.com,2022-04-10,https://www.carney.com/
28-Jun-2021,Cheque,00.00,"22,854.05","159,978.33",83BC5c5dDFb512c,7045,Nicole,Hicks,Juarez-Eaton,Eileenmouth,Belarus,387.012.2204x387,047-154-3706x6260,christie55@ramsey.com,2022-01-16,http://shah-mcdonald.com/
28-Jun-2021,Miscellaneous,"10,705.60",00.00,"170,683.93",B94E2c1610078D4,7453,Laura,Salinas,Humphrey-Avila,South Dalton,Turkmenistan,+1-649-950-8796x3368,(374)310-3046x73236,kristen45@richard.com,2020-12-28,http://pope.org/
28-Jun-2021,Commission,"4,541.20",00.00,"175,225.13",FcF85fAEd8F8df9,5152,Ronnie,Huerta,"Powell, Rodriguez and Lucero",Hendersonton,Tonga,001-335-210-7981,936-849-4331,levi01@bray-andrade.info,2021-06-04,http://www.mcbride-russell.com/
28-Jun-2021,NEFT,00.00,"43,806.28","131,418.85",3cAbe3aaCbc9eb9,1355,Suzanne,Landry,Pittman LLC,New Mario,San Marino,(640)966-8261,158-686-4225,tbowen@foster-soto.info,2022-01-19,https://www.paul.com/
28-Jun-2021,IMPS,"32,472.98",00.00,"163,891.83",BDA897F22d2cDa2,6913,Charles,Ibarra,Carlson PLC,South Tannerberg,Faroe Islands,267-186-8475,8842231926,melinda06@meyer.info,2021-01-10,http://gibson.com/
28-Jun-2021,Cheque,"3,207.00",00.00,"167,098.83",fA88e15C5f93faB,2969,Jill,Grant,"Hunter, Davidson and Boone",Gordonstad,Indonesia,001-706-313-8366x118,(648)629-5676x0894,allenmiranda@acevedo.info,2020-03-15,http://www.haas.com/
28-Jun-2021,ATM,00.00,"16,709.88","150,388.95",1dDAdaD79586b17,5522,Benjamin,Malone,Gordon-Hopkins,South Desiree,Taiwan,001-615-314-3507x3405,+1-904-756-2228,shelbylara@brady.com,2020-07-30,http://conrad.net/
28-Jun-2021,Bill,00.00,"18,798.62","131,590.33",AFb3dA721E03F48,2811,Karina,Charles,Lamb-Parks,North Gwendolyn,Ecuador,711-331-4378,(680)264-3276,ehaley@hampton.com,2021-02-20,https://phillips-summers.biz/
28-Jun-2021,RTGS,"3,279.17",00.00,"134,869.50",FEC87D790D6b9ee,8275,Kara,Welch,Donovan and Sons,Aliciahaven,Dominican Republic,001-543-806-6378x2539,(590)089-9213,nguyensuzanne@dennis.com,2022-05-02,http://www.kemp.com/
28-Jun-2021,Tax,00.00,"44,956.50","89,913.00",6EAdb6EEA6b4c8B,3349,Logan,Banks,Goodman-Davenport,Fryton,Jamaica,8850516578,747.355.3234x74469,alloyd@fox.org,2021-06-25,http://www.donaldson.org/
28-Jun-2021,RTGS,00.00,"29,971.00","59,942.00",e98652AD9E24eaD,9639,Whitney,Reid,"Hodge, Carson and Valdez",Omarchester,Slovenia,(918)168-6010x53414,040.584.6039x6762,kiddmelvin@mayo.org,2021-01-28,http://www.ali.info/
28-Jun-2021,Reversal,00.00,"7,492.75","52,449.25",2fCeD13B76f0A61,3306,Dwayne,Castro,Dean-Booth,Lake Stacyfurt,Sao Tome and Principe,(539)548-3488x5246,755-525-4328x1642,ravenbriggs@farmer.com,2021-02-26,https://www.farmer.com/
28-Jun-2021,IMPS,664.00,00.00,"53,113.25",229d6ABa96102AB,8069,Wendy,Cuevas,Jenkins-Hines,West Jamie,Colombia,001-037-799-4220x513,(944)939-0315x9191,ronald31@warren.net,2021-12-22,http://www.hanna-mendez.biz/
28-Jun-2021,Commission,"1,169,164.00",00.00,"1,222,277.25",aEFdfb74fd3C89d,382,Sierra,Roberson,Payne Inc,Carrieland,Fiji,+1-902-711-7691x7835,954.895.6041,cindymclaughlin@jackson.com,2022-04-30,http://parks-collier.com/
28-Jun-2021,RTGS,16.00,00.00,"1,222,293.25",7335A7a9c34cFcA,8434,Leslie,Mcmillan,"Randolph, Mcneil and Glenn",South Tyrone,Azerbaijan,3437387070,+1-804-482-3152,margaret56@green.com,2021-05-23,http://ray-herrera.org/
28-Jun-2021,Reversal,00.00,"1,222,293.25",00.00,bcE3Fbe7cfAfaFa,6621,Ronald,Pennington,Potts LLC,North Olivia,Madagascar,(279)295-1295,001-887-559-7046,dillon37@cruz-rosales.info,2021-03-05,http://acevedo.com/
29-Jun-2021,Bill,"3,004.72",00.00,"3,004.72",D9CDD5E18954C76,9205,Mariah,Chan,Mahoney Ltd,Morenohaven,British Virgin Islands,+1-736-830-7096,(426)133-3322x2451,katelynmoore@buck.org,2021-09-22,http://www.oconnell.org/
29-Jun-2021,Cheque,00.00,500.79,"2,503.93",8bEfF473c4b5C6f,7321,Desiree,Crane,"Johnson, Choi and Hinton",Reneeburgh,Ecuador,055-864-2672x243,8462917376,diamondpatterson@hardy-terrell.com,2021-07-18,http://www.morton.com/
29-Jun-2021,NEFT,00.00,"1,251.97","1,251.96",EbaE5b543ECEB18,4179,Travis,Estes,Durham-Lamb,West Tonya,Seychelles,(301)417-6480x626,(335)128-0914x363,martinweber@berry.biz,2022-02-12,http://www.castro.com/
29-Jun-2021,Tax,00.00,"1,251.96",00.00,4dCd4AaEAA60CfB,3668,Destiny,Bolton,Barnett Ltd,South Brucestad,Slovenia,639-221-9467x6901,668.502.2031x9165,adkinsregina@bishop.info,2021-02-05,http://www.robinson.com/
29-Jun-2021,Bill,372.00,00.00,372.00,Cd59F2dFBAd382f,5402,Latasha,Mason,Lamb PLC,Hornmouth,Korea,946-294-6443x3594,326-479-0224,jeanette88@walters.com,2021-12-22,http://www.poole.com/
30-Jun-2021,Interest,"168,254.28",00.00,"168,626.28",082Ee9dc4F8a2C3,9046,Jenny,Nichols,Wood Group,West Emilyburgh,Tunisia,3064300351,0584183756,vfranco@wade.com,2021-12-17,https://www.trujillo-huang.com/
30-Jun-2021,Tax,393.70,00.00,"169,019.98",b84BE9fA3aced95,3327,Denise,Newman,Diaz and Sons,North Bradystad,Saint Pierre and Miquelon,059-276-8026x77563,(464)995-7005,dhatfield@pena.net,2020-04-18,https://martinez-davies.org/
30-Jun-2021,Tax,00.00,"28,170.00","140,849.98",E14B3b8a2f83F60,7195,Kristine,Mason,"Beltran, Stark and Wolfe",Wolfestad,Pitcairn Islands,+1-865-153-8376x6969,001-084-335-1305x11196,zacosta@mccall.com,2020-03-17,https://delacruz.com/
30-Jun-2021,RTGS,00.00,"14,085.00","126,764.98",d4FdDfcC7c8DA05,8466,Clifford,Hutchinson,"Ferguson, Crosby and Collins",Dicksonland,Liberia,9714393670,(513)863-4404x782,gordonjade@gilmore-dougherty.org,2021-02-16,http://hooper.biz/
30-Jun-2021,Purchase,206.58,00.00,"126,971.56",C3f0Ea038d01696,6989,Elizabeth,Mooney,"Herrera, Bruce and Erickson",Mikemouth,Latvia,637-785-8393x5847,001-563-078-6075x606,jeffreylopez@vincent-mitchell.com,2020-12-20,http://moody.com/
30-Jun-2021,Purchase,"21,905.70",00.00,"148,877.26",8bebEEd1A3D8108,4065,Jesus,Marsh,Washington-Thornton,Lake Shawnamouth,Mauritius,(045)364-4689x018,709.091.2452x913,ana28@griffin.com,2020-07-09,http://www.graves-yates.com/
30-Jun-2021,Interest,00.00,"37,219.32","111,657.94",86DA925B478DB0f,1659,Jorge,Patrick,"Benton, Blair and Wolf",Chaseland,Poland,545.112.6471,(544)966-3686x6711,krystal75@ware.com,2021-12-26,https://murray.com/
30-Jun-2021,Reversal,00.00,"37,219.31","74,438.63",AeEaeDc36fAa1BC,6409,Jade,Sweeney,Rowe Ltd,Karenton,Cayman Islands,653-114-8608,(103)292-6514x7370,jose41@mora.com,2020-02-09,https://www.harmon.com/
30-Jun-2021,Reversal,00.00,"7,443.86","66,994.77",68BC2EE928C6D72,1400,Doris,Erickson,Zavala Group,North Hollyland,Albania,112-785-6392x47727,001-329-513-1977x82944,kcasey@logan.net,2021-03-27,http://www.woodward-espinoza.net/
30-Jun-2021,Interest,504.00,00.00,"67,498.77",3C577cf9153Ab1E,5439,Kellie,Andersen,Zamora-Macdonald,North Virginia,Bahrain,249-211-7480x4082,+1-353-023-4814x24877,joanne48@todd.info,2020-09-24,http://boyd-shepard.com/
30-Jun-2021,Reversal,09.70,00.00,"67,508.47",DB37af7BBDcEAd1,9346,Sara,Leon,Robbins PLC,New Shawnaville,Belgium,+1-101-400-1318,917-959-8496,lunderwood@acosta-ali.net,2020-10-17,https://barajas-richard.com/
30-Jun-2021,IMPS,19.00,00.00,"67,527.47",2Ecb1e766d1e64A,7630,Angela,Reilly,"Horn, Bowen and Simmons",East Yolanda,Cote d'Ivoire,(043)296-0737,(256)674-6412x15340,burchlaurie@barber.biz,2021-10-30,http://www.calhoun.com/
30-Jun-2021,Tax,00.00,"16,881.87","50,645.60",aF8D41f3c6D63B9,3482,Kristopher,Butler,Cervantes Group,Soniaside,Georgia,869.376.3007,009.925.7153,imorrison@krause.com,2021-02-26,http://hendrix.com/
30-Jun-2021,Miscellaneous,06.20,00.00,"50,651.80",CADdaCBCcFAd4fE,3584,Albert,Bridges,Villanueva-Chambers,Lukefurt,Bahrain,(529)429-4329x230,915.026.2040x1843,mariodean@mcintosh.com,2021-05-18,https://www.jefferson-nicholson.biz/
30-Jun-2021,Purchase,"3,659.50",00.00,"54,311.30",Da7D6678a14faff,2958,Seth,Day,"Olsen, Harris and Mack",Irwinfort,Indonesia,(293)026-6170x858,714.304.1658x327,kari88@rose.com,2021-05-06,https://www.wu-waters.com/
30-Jun-2021,Transfer,54.10,00.00,"54,365.40",E4d9b13346B5Bf6,8719,Krystal,Villa,Luna-Hunter,Burchport,Mongolia,285.281.0977x991,(833)073-0805,vickihoward@hardin.com,2020-06-26,https://wong-cole.com/
30-Jun-2021,IMPS,275.00,00.00,"54,640.40",9adB0599CaeCCDA,4598,Debra,Price,"Lester, Lucero and Alvarez",Lake Colin,Switzerland,001-942-146-6041,(575)263-2838,dominicsimon@villanueva.org,2021-03-10,http://www.rollins.com/
30-Jun-2021,Miscellaneous,"1,175,792.00",00.00,"1,230,432.40",35F1d7ACF1E98ee,2276,Omar,Holder,Meyers-Braun,Alisontown,Grenada,6336966007,+1-515-813-1908x210,isaiahduarte@buck.net,2020-06-20,https://www.juarez.biz/
30-Jun-2021,Cash,41.55,00.00,"1,230,473.95",C4cfE95C33f12EE,6352,Summer,Bowen,Rubio-Soto,Acevedoberg,Congo,072.361.7936x2866,+1-453-850-8293,prichardson@carson.info,2022-02-20,https://keller.com/
30-Jun-2021,Commission,00.00,"175,781.99","1,054,691.96",2eAD1E1Dbb2baeD,5805,Desiree,Bonilla,"Hanson, Gould and Oconnor",Sharonside,Sri Lanka,(134)407-7090x6721,001-751-917-0213x70119,guerrabonnie@duran-leonard.info,2020-09-14,http://www.spears.com/
30-Jun-2021,Debit Card,00.00,"351,563.99","703,127.97",BA426eD4e48da5d,2078,Johnny,Townsend,Booth and Sons,West Sallyfort,Djibouti,737.854.0642,3980420520,vfreeman@blackburn.com,2021-05-26,http://www.bernard-cantu.net/
30-Jun-2021,IMPS,00.00,"87,891.00","615,236.97",55e6FCbf0ed876d,6653,Shannon,Cortez,Giles-Le,Yustad,Slovakia (Slovak Republic),(293)395-2865x2251,+1-909-743-3165x993,rhays@house.com,2021-04-04,https://www.melton.info/
30-Jun-2021,Tax,"1,463.00",00.00,"616,699.97",60ab0ee3E4F6714,5502,George,Macias,"Vaughan, Krause and Wilkerson",Singletonmouth,Mongolia,+1-621-912-2987,001-249-250-1870x026,lynnhopkins@ramsey-matthews.net,2020-10-02,http://khan-weber.com/
30-Jun-2021,Debit Card,00.00,"205,566.66","411,133.31",544Fa7EEdfFa487,7890,Gary,Santana,Pearson PLC,Sawyerview,Somalia,860-815-6862,729-160-8978,beverly42@reyes.info,2021-01-01,http://www.moran.com/
30-Jun-2021,Tax,00.00,"45,681.48","365,451.83",b82cDFA96Cf8353,2396,Karla,Huffman,Wong-Kemp,Lake Patty,British Virgin Islands,4623703037,7620407960,fmartin@hanna.com,2021-11-06,http://www.clark-robbins.com/
30-Jun-2021,Interest,00.00,"73,090.37","292,361.46",BEeDBC92eFD6ee3,1197,Rick,Faulkner,Meyers Ltd,Jerrymouth,Turkmenistan,577-371-0397,495-549-2895,isaacduncan@blair.com,2021-02-23,http://hines.com/
30-Jun-2021,Bill,"1,165.00",00.00,"293,526.46",d1ea0a41F2aba42,1503,Damon,Pacheco,"Oconnor, Mooney and Chan",Kirkton,United States Virgin Islands,+1-511-019-8312x988,(130)109-0240x0993,bbond@hart.com,2022-02-02,http://www.owen.com/
30-Jun-2021,Purchase,"546,503.50",00.00,"840,029.96",F97B9cdFF3edaeD,3863,Beverly,Wheeler,Cameron-Salinas,New Paul,Monaco,(404)361-6049x07973,001-829-991-9399x3736,michelenewton@conway.com,2020-08-28,https://www.fuller-dominguez.com/
30-Jun-2021,ATM,"2,010,311.20",00.00,"2,850,341.16",4abAb4fb6Cd62ad,4808,Geoffrey,Odom,Ross PLC,Gabrielleland,Belarus,045.578.2616x45619,+1-626-318-2685x451,lrobertson@figueroa.biz,2022-01-19,https://mccarty.biz/
30-Jun-2021,Interest,"1,138.03",00.00,"2,851,479.19",3932C8cbB30Ed0a,2274,Felicia,Lucero,Avila Ltd,Osborneview,French Guiana,802.899.7840x51231,+1-640-667-9562,prattbryan@mack.com,2020-08-31,http://schwartz.org/
01-Jul-2021,Cheque,"137,955.00",00.00,"2,989,434.19",0eD1b0beBDf34fE,7619,Shelly,Collier,Gray-Golden,Isabeltown,Costa Rica,+1-912-978-6043x154,001-667-035-4586x028,lucerobobby@brooks.com,2020-03-19,https://massey.com/
01-Jul-2021,Commission,12.10,00.00,"2,989,446.29",7cfFC2180F9aC1E,4646,Rose,Sweeney,Shannon-Hancock,East George,Sierra Leone,612-563-6043x46161,428-447-5875x62935,cynthiachapman@duarte-evans.net,2022-03-27,https://hebert-guerrero.com/
01-Jul-2021,RTGS,36.00,00.00,"2,989,482.29",06FDFcE5ed1B60a,902,Alexander,Bowen,"Mccoy, Rosario and Sweeney",Madisonside,Brunei Darussalam,374.236.9373,+1-479-580-5341,candice02@mccall.com,2021-08-30,https://simpson-mcgee.biz/
01-Jul-2021,Reversal,"1,499,228.00",00.00,"4,488,710.29",6CFAA9f71E9423B,855,Judy,Rogers,Meyers and Sons,Cliffordborough,Saint Helena,(181)997-7317,+1-610-634-3284x8288,vernon50@dennis.biz,2021-04-10,http://davenport-jefferson.com/
01-Jul-2021,Miscellaneous,00.00,"748,118.38","3,740,591.91",C3cB4F0cA528f3e,5134,Jane,Skinner,"Cordova, Ochoa and Vaughn",North Sheliafurt,Togo,+1-070-331-6026x684,+1-630-089-4470x50169,bryce51@moss.com,2021-11-13,https://gaines.com/
01-Jul-2021,Interest,00.00,"534,370.27","3,206,221.64",fe8D20bAdFBBE8F,9257,Kristin,Downs,Collier-Graham,Lake Rodney,Greece,+1-441-040-9009,327.015.8719,ydudley@sparks.info,2022-03-13,https://bray-mayer.com/
01-Jul-2021,Cheque,00.00,"356,246.85","2,849,974.79",BBa1Fa9FfDC1D77,4657,Sonya,Cortez,"Richmond, Horton and Coffey",Rhondamouth,Congo,001-287-648-0358,383.958.3022,yschultz@gallagher.com,2022-03-14,https://www.neal.com/
01-Jul-2021,Bill,"1,224.90",00.00,"2,851,199.69",cC66f892bbaEC38,2450,Shelley,Bentley,Stafford-Cook,Dyerport,Pakistan,551-614-0350x511,9128676431,hannahgutierrez@barker.com,2021-03-03,http://shepard-ponce.com/
01-Jul-2021,Commission,00.00,"570,239.94","2,280,959.75",64E6decFC5F30A9,7717,Sabrina,Diaz,"Jackson, Chapman and Grant",Rayberg,Oman,(617)224-7244x527,674-886-6894x40367,cheyennewolf@cline.com,2020-04-25,https://www.dougherty.com/
01-Jul-2021,Bill,00.00,"253,439.97","2,027,519.78",c67A24bBdF7B3d7,9041,Dan,Blanchard,Romero-Le,South Debraland,Bermuda,576-466-1267,(763)637-7952x04286,eddiepotts@ayala-austin.com,2021-09-16,http://ayala-porter.com/
01-Jul-2021,Commission,00.00,"405,503.96","1,622,015.82",f8E73B1D8440aff,5099,Ronnie,Benton,"Underwood, Jensen and Ponce",East Anthonyborough,French Guiana,(886)996-4333,5926982824,mcphersonlydia@mcfarland.com,2022-03-24,https://rangel-hunter.com/
01-Jul-2021,IMPS,450.10,00.00,"1,622,465.92",B2193618C90eaBE,7164,Tony,Floyd,Ramos-Michael,New Joyville,Trinidad and Tobago,+1-131-367-9790x55336,+1-051-847-6629x04343,tiffanymcgrath@kemp-mendoza.info,2022-03-16,http://norman.com/
01-Jul-2021,Debit Card,422.70,00.00,"1,622,888.62",efec3aAbf0dC3cA,7451,Martha,Larsen,Wall Group,Lake Amber,Lithuania,940-838-6567x568,+1-224-913-9496,dclark@krause.com,2021-08-02,http://figueroa-hall.biz/
01-Jul-2021,Tax,231.78,00.00,"1,623,120.40",FB830f3D90cf4FA,2098,Norma,Powers,"Weeks, Ramirez and Decker",Lake Cameronborough,Falkland Islands (Malvinas),(794)043-4031x0702,809.912.4123x6195,bkaufman@richardson-rivera.com,2020-11-01,https://zuniga-ritter.com/
01-Jul-2021,IMPS,"758,675.25",00.00,"2,381,795.65",bfb8a8b41ddc8F9,7263,Rick,Schroeder,Kim-Galloway,Barrerafort,Iraq,(915)920-8541x597,588.004.7147x182,shelia91@frye-arellano.org,2022-01-25,https://www.mathis-ayala.com/
01-Jul-2021,RTGS,12.00,00.00,"2,381,807.65",18ba23fCa0e41Fe,2961,Alexis,Barajas,Solis-Bennett,North Allisonborough,Senegal,(532)437-2882,+1-059-532-3015x89497,maureenmckay@santos-ho.net,2021-08-28,http://forbes.com/
01-Jul-2021,NEFT,00.00,"396,967.94","1,984,839.71",f4beaFa9ff1ef6d,2928,Henry,Bates,"Avery, Young and Orozco",Larsenside,Gambia,(817)028-9790,001-865-334-6425x532,zhardy@bernard.com,2021-02-22,http://sheppard.info/
01-Jul-2021,RTGS,"1,264,366.50",00.00,"3,249,206.21",9622EB52Fc3FEbe,2041,Sue,Rodgers,Salinas-Barnes,East Max,Ukraine,001-598-830-7844x42547,+1-603-318-1786x1851,cooksierra@maxwell.net,2020-08-18,https://kerr.info/
01-Jul-2021,Commission,"3,324.00",00.00,"3,252,530.21",4ccf47c0B4Ada1a,1559,Sara,Oconnell,Nichols LLC,South Cameron,Isle of Man,100-627-8054x1413,5058523655,nancylutz@cooley.com,2022-05-26,https://www.mays-bass.com/
01-Jul-2021,IMPS,"1,206,728.00",00.00,"4,459,258.21",f575ca97eaB6e8C,835,Latoya,Floyd,Buchanan-Cervantes,South Brittney,Libyan Arab Jamahiriya,(892)350-5679,472.477.3220x1735,apotts@dalton-reese.com,2020-09-09,https://pollard.com/
01-Jul-2021,NEFT,00.00,"557,407.28","3,901,850.93",624e2aEbFf6C72b,2504,Kristin,Hull,Aguilar-Zimmerman,Basston,Martinique,627-486-3182x6880,810-757-7863x6863,brucenancy@burke.com,2020-03-15,https://www.dunlap.com/
01-Jul-2021,Commission,"24,372.00",00.00,"3,926,222.93",F8a905EbEE8cFCf,8848,Adam,Spears,Yu-Hahn,East Stephenstad,Comoros,9313302703,319.667.5392x145,luke67@garrett.com,2022-04-03,https://www.ball-sosa.org/
01-Jul-2021,Reversal,19.70,00.00,"3,926,242.63",B857d8f1A59DcfD,3808,Alfred,Chang,Schneider and Sons,Port Normafort,Bhutan,+1-798-050-1448x6510,987-337-3967,sellerssherri@pham.info,2021-11-26,https://mcintosh-bruce.net/
01-Jul-2021,ATM,40.00,00.00,"3,926,282.63",98bF938AbFa3Aab,3655,Candace,Gilmore,Esparza Ltd,Terryberg,Wallis and Futuna,2610336041,+1-001-883-0834x2378,elliottmichaela@jones.com,2021-06-03,http://www.delacruz.com/
01-Jul-2021,Debit Card,"1,057.00",00.00,"3,927,339.63",D85AE96aEfa3Aa2,7683,Alexander,Reese,"Ewing, Flynn and Hinton",North Michaela,Dominican Republic,+1-078-953-8185x0282,469.779.6977,salasclaire@moses-shaw.net,2020-12-20,https://www.hogan.net/
01-Jul-2021,Bill,00.00,"3,927,339.63",00.00,e5622Ca82aeF1E4,3476,Theodore,Daugherty,George-Manning,Wernerbury,Botswana,+1-632-118-1467x5191,183.831.6332x82580,jvelez@copeland.com,2021-08-15,https://ashley-hahn.com/
01-Jul-2021,Reversal,"29,265.00",00.00,"29,265.00",5e9bB94dAA30C1f,6090,Stacy,Meyer,Frye Group,South Donaldmouth,Argentina,428.422.8669,880-793-5055x0630,tanya55@lucero.com,2020-06-09,http://cooper.com/
01-Jul-2021,Cash,"23,648.97",00.00,"52,913.97",8EE813B2A9EFAec,872,Chad,Summers,"Weeks, Krause and Webb",North Jacquelinemouth,New Zealand,001-489-982-4461x518,001-148-500-0874x48530,marcomendez@turner.com,2021-09-19,https://mullins.com/
01-Jul-2021,Bill,00.00,"5,291.40","47,622.57",80a6ab7D70a4eE4,6988,Jake,Luna,"Gordon, Thomas and Dyer",Stacieshire,Central African Republic,+1-064-940-3352x92364,(311)831-2679x951,yucole@mcintosh.biz,2020-05-16,https://mueller.com/
01-Jul-2021,Miscellaneous,05.78,00.00,"47,628.35",Ad3475Ab9D57a21,9580,Blake,Cuevas,Tran-Ross,North Gabrielamouth,Northern Mariana Islands,997-016-2288x8233,500-431-2197x56505,beverlyhull@sims.info,2020-03-10,http://bradshaw.com/
01-Jul-2021,Interest,00.00,"6,804.05","40,824.30",9D9B2e5Be8847Df,6823,Bobby,Whitehead,"Allison, Goodman and Camacho",North Jaclyn,Antarctica (the territory South of 60 deg S),+1-471-424-7726,067-371-5960,rebekahlynch@gray.info,2021-10-12,http://www.mckinney.net/
01-Jul-2021,Miscellaneous,00.00,"10,206.08","30,618.22",c643FC3e4e0F3b5,9214,Meredith,Christian,Mccarthy and Sons,North Terri,Sweden,908-224-0368x67018,(353)058-9932x90966,pedro23@weaver.com,2020-04-28,https://gentry.com/
01-Jul-2021,NEFT,00.00,"6,123.64","24,494.58",270E139f371deD0,3720,Tony,Gould,Mack-Braun,Darrellstad,Vanuatu,006.409.4821,275-954-4639x8716,daltonalvarado@campbell-thompson.net,2022-04-10,http://www.marquez.org/
01-Jul-2021,IMPS,"1,949,978.00",00.00,"1,974,472.58",dbE4feB6DC8C8de,3099,Roberto,Miller,Buckley LLC,West Isabellaport,Ecuador,001-543-273-1750x5603,252-839-1555x104,iwalter@bender.com,2021-10-01,https://pitts.org/
01-Jul-2021,Commission,00.00,"493,618.15","1,480,854.44",ecBa8Cb9B6b7A8D,3503,Olivia,Hampton,Mosley Ltd,Salasfort,Togo,001-192-245-8043x525,+1-699-695-8279x406,lucerogwendolyn@reid-sutton.com,2022-01-18,http://www.gregory.com/
01-Jul-2021,Debit Card,00.00,"296,170.89","1,184,683.55",BCbB100AB438e1e,6076,Stephen,Wagner,"Bautista, Beck and Chavez",New Brian,Uruguay,(286)265-2443x734,101.010.5680,turnerbeth@reilly-jenkins.com,2022-02-24,http://www.ruiz.biz/
01-Jul-2021,Bill,00.00,"118,468.36","1,066,215.20",d2a9B85B4975E0C,1522,Reginald,Barnett,Allison-Clements,Port Julie,Switzerland,001-434-181-7364x2391,+1-063-713-1770x9580,michelebridges@zimmerman-leach.com,2021-05-16,http://delacruz.com/
01-Jul-2021,Debit Card,"3,557.00",00.00,"1,069,772.20",Fb24617FaC12275,596,Dakota,Daugherty,Baird and Sons,Alvaradoside,Gambia,001-390-044-6327x0751,544-297-6387x43350,davidmcconnell@wood.info,2022-01-22,http://www.wood-willis.info/
01-Jul-2021,ATM,00.00,"133,721.53","936,050.68",F51A2F1cD722fDA,4671,Shari,Patrick,"Reynolds, Hebert and Wilkinson",Port Amber,Ukraine,001-670-627-4583x887,+1-944-333-1020,karinahuynh@pollard.biz,2020-02-28,https://michael-barber.biz/
01-Jul-2021,Transfer,00.08,00.00,"936,050.76",22Db27d1A4622fB,8440,Reginald,Hurst,"Nunez, Pugh and Travis",Rivasmouth,Christmas Island,072.396.7117x201,(795)653-0560x0815,gregorymyers@odonnell-bryan.biz,2021-10-04,http://ward.net/
01-Jul-2021,Commission,00.00,"234,012.69","702,038.07",f80b8038baa9De3,5297,Meghan,Townsend,Bowman Group,Duaneton,Cocos (Keeling) Islands,(541)002-1423x916,358.581.4126x1627,hannahrobertson@leon-larsen.com,2020-12-27,https://www.navarro.com/
01-Jul-2021,IMPS,30.80,00.00,"702,068.87",c9c569C1FE7ACbf,7322,Andres,Reid,Campos and Sons,Lake Nichole,French Guiana,906.396.0856x04265,478.825.5725,jonathanedwards@kemp-werner.com,2020-02-19,https://lloyd.com/
01-Jul-2021,RTGS,79.00,00.00,"702,147.87",1d3749Dc7ADfa2F,1063,Tammy,Oneill,Pope-Mckee,Port Bethchester,Spain,301-747-2921x5938,378-571-8346,rickmatthews@bowen.com,2021-12-07,https://hill.org/
01-Jul-2021,Tax,00.00,"234,049.29","468,098.58",FD6Fe62ed5A02f1,6827,Ann,George,Brock Ltd,Lake Cynthia,Tajikistan,001-469-809-0412x62925,9841811306,warejeff@salas.com,2020-12-05,https://barry.com/
01-Jul-2021,Cheque,322.42,00.00,"468,421.00",e1B07addD3A0eea,9442,Elizabeth,Cooper,"Wilcox, Fuller and Sloan",North Lucas,Peru,(522)898-9494,(518)932-0605,alexandercisneros@wright.com,2021-07-18,https://www.lane.org/
01-Jul-2021,Interest,07.30,00.00,"468,428.30",72aDAE4eD831e48,6901,Patty,Li,"Webster, Hess and Clarke",Danielchester,Belarus,001-112-654-9388x49279,9608013336,barry47@blackburn.net,2021-04-05,http://donaldson-frederick.com/
01-Jul-2021,Reversal,09.90,00.00,"468,438.20",E5bfC2454F6878e,6867,Shelby,Rosario,Griffith PLC,Mccallport,United States Virgin Islands,(894)149-4310x5224,001-922-592-8481,abbottbrandy@sparks.net,2021-11-10,http://www.duke-braun.com/
01-Jul-2021,Cheque,00.00,"66,919.74","401,518.46",07b84cc0992C54D,3238,Rebecca,Harvey,"Baxter, Navarro and Good",Sallyhaven,Yemen,332.163.1031,360-390-1490x245,steelecurtis@chase-hurley.biz,2020-09-01,https://www.davenport-gonzalez.com/
01-Jul-2021,Debit Card,00.00,00.00,"401,518.46",9fb821FAC0BC4a9,2628,Paige,James,Norton Inc,North Victor,Angola,139-540-9443,559-588-4466x91092,summer43@ball.com,2022-05-05,http://mccann.com/
01-Jul-2021,Tax,00.00,"401,518.46",00.00,EAF26EBADD8bc90,5303,Jonathan,Irwin,Castillo PLC,Port Jim,China,001-725-591-2817x963,(440)070-5254,rayralph@french-duke.com,2020-11-18,http://www.cain.com/
01-Jul-2021,Cheque,02.90,00.00,02.90,3D1EBfbBF3fB0Bb,4968,Ariana,Cameron,Lawson and Sons,North Donnashire,Paraguay,(950)046-0612,912.467.6264x22516,amayer@mccormick-fritz.info,2021-01-05,https://cooper.net/
01-Jul-2021,ATM,00.00,00.36,02.54,32B7A0Fa103c698,1143,Earl,Ferguson,"Harrington, Carr and Stanton",Laurachester,Lao People's Democratic Republic,(555)257-9307,6161653556,beasleyjoel@rasmussen-guerrero.info,2021-06-01,http://www.pineda-davis.com/
02-Jul-2021,Transfer,06.00,00.00,08.54,6dD1659A6CDC3F7,1340,Joyce,Robles,Lane PLC,Silvaport,Iran,001-268-180-7682x2159,001-939-453-4769,rittermeagan@beasley.com,2021-12-19,http://www.salazar.net/
02-Jul-2021,NEFT,"1,753,186.00",00.00,"1,753,194.54",D3Ad7c5856dbEfd,5919,Rhonda,Lutz,Arnold PLC,East Erik,Uganda,(050)579-3402,800.156.9570,christensenmackenzie@gay-zhang.com,2022-04-18,http://hebert-mercer.info/
02-Jul-2021,Bill,00.00,"584,398.18","1,168,796.36",F22D1aab7F39F52,241,Dennis,Moran,"Velazquez, Heath and Adkins",South Gloria,Tuvalu,(549)544-4032x930,001-944-719-2188x6198,wcole@bell.info,2021-10-18,https://www.roth-haney.com/
02-Jul-2021,Reversal,00.00,"233,759.27","935,037.09",3f8d57E7ADc0453,3509,Herbert,Good,Brewer Inc,North Angelaton,Lithuania,+1-569-760-7285,+1-100-003-0727x79903,poncedarrell@austin.com,2021-05-14,http://klein-powell.com/
02-Jul-2021,Miscellaneous,"409,086.80",00.00,"1,344,123.89",4Ac3A6abABFfe59,9794,Evelyn,May,"Frank, Sosa and Khan",Kaitlynview,Saint Helena,834-204-3123,001-889-564-4683,hpace@yu.com,2020-10-08,http://www.david.org/
02-Jul-2021,IMPS,00.00,"672,061.95","672,061.94",8C755a6a73EBa00,4596,Vickie,Cabrera,Bailey and Sons,Port Marilyn,Djibouti,974-215-6764x5821,(107)001-0774,shahdominique@davila.org,2021-08-14,http://cummings-rangel.com/
02-Jul-2021,Debit Card,"782,036.20",00.00,"1,454,098.14",fA2Ac4C6a1e9cEd,9529,Terri,Knapp,Peterson-Hoffman,Pattonmouth,San Marino,(000)575-1644,001-919-710-8180,bradymora@esparza-gill.net,2020-01-02,http://www.pena.info/
02-Jul-2021,Debit Card,07.30,00.00,"1,454,105.44",ba2E28951F277dd,130,Kimberly,Gregory,"Ortiz, Cohen and Cross",Jennifermouth,Singapore,+1-088-229-1601x4905,727.071.3692x5483,lacey04@cross.com,2021-10-28,http://www.nguyen-curry.com/
02-Jul-2021,Bill,00.00,"181,763.18","1,272,342.26",FFefCdCB4F8Bc2B,6596,William,Bradford,"Farley, Dunlap and Sawyer",Penafort,Malaysia,872-803-1692x21963,(296)120-5603x019,coreydickson@escobar.com,2022-04-19,http://abbott-gill.com/
02-Jul-2021,RTGS,"227,630.90",00.00,"1,499,973.16",DADE73d661aac56,396,Erin,Boyer,Krause-Maldonado,Gallagherstad,Heard Island and McDonald Islands,(031)356-5581x111,(645)854-3522x9465,leslie12@pitts-holland.com,2020-03-16,https://www.meyer.biz/
02-Jul-2021,Cash,00.00,"299,994.63","1,199,978.53",6b2Ba7d88bDdA21,2275,Nicholas,Rasmussen,"Steele, Garner and Valenzuela",West Danielle,United Arab Emirates,584-794-1794,979-576-2154,fieldsjoanna@cantu.com,2022-03-10,http://jackson-huffman.com/
02-Jul-2021,Bill,00.00,"599,989.27","599,989.26",cc0ddAc3FBCE7D0,6701,Melvin,Key,Oconnor and Sons,Eduardofort,Kazakhstan,057.797.6613,442.938.0294x7730,luke40@holloway.info,2021-04-24,https://www.riddle.com/
02-Jul-2021,Cheque,00.00,"85,712.75","514,276.51",aE4B7E7a93Bd19d,414,Janice,Baldwin,"Greene, Novak and Flores",Bowersville,Liechtenstein,(034)640-6218x7316,662.603.4987,sbrooks@sloan.com,2021-07-06,https://fitzgerald-olson.com/
02-Jul-2021,Commission,00.00,"73,468.07","440,808.44",025143EB93d38DB,946,Kaylee,Brown,Cisneros-Castro,South Valeriemouth,Bahrain,234-954-9658,588.647.2134x26745,zgordon@jarvis.org,2022-03-05,https://copeland.info/
02-Jul-2021,IMPS,00.00,"48,978.72","391,829.72",EDC2853F4044a5A,5899,Victor,Cervantes,Church Inc,Mccartyhaven,Tunisia,577.255.0722,(010)334-8822x637,patricia58@berry.com,2020-01-29,https://www.olson.com/
02-Jul-2021,NEFT,06.66,00.00,"391,836.38",F86f7d49dbC8e1F,5692,Brendan,Saunders,Perkins-Rowe,Mcdonaldville,Trinidad and Tobago,710-293-2822,(345)125-9175,fryesamantha@golden.net,2020-05-09,http://www.mayer.net/
02-Jul-2021,RTGS,00.00,"48,979.55","342,856.83",4f44fe880bce4eE,7146,Alicia,Rich,Ingram-Richardson,East Javierburgh,Myanmar,330-246-1481,(606)388-0466,tyronebaird@griffin-barrera.com,2020-08-03,http://www.rollins.org/
02-Jul-2021,Cash,251.07,00.00,"343,107.90",B71708bD45E5F9b,6492,Jenny,Conley,"Bates, Rodgers and Robbins",Cantrellville,Albania,(964)998-4331,(645)342-9468x71032,bbriggs@vaughn.com,2021-03-13,https://odonnell-hutchinson.com/
02-Jul-2021,Tax,"238,020.00",00.00,"581,127.90",FaE1D17e7fC1dc8,2254,Breanna,Bryan,Barrera-May,Wendybury,Denmark,2381532229,(419)089-3355,jim48@bernard.com,2020-06-14,https://brandt-roth.com/
02-Jul-2021,Bill,00.00,"116,225.58","464,902.32",b086Cf491c40B4c,4708,Isabel,Williamson,Esparza-Griffin,South Sierrabury,Colombia,894.742.3667x90373,(065)611-6414x54608,alexa75@vance.com,2020-10-18,http://www.bean.com/
02-Jul-2021,Bill,274.69,00.00,"465,177.01",84eC0b6Ed3CF38f,1361,Tammy,Mckay,Caldwell-Friedman,Kirkfort,Central African Republic,386.260.3594x21460,(200)175-7165,theresa53@arellano.org,2022-03-25,http://www.rubio.com/
02-Jul-2021,Commission,00.00,"51,686.33","413,490.68",E93d3BA519EBAF1,6186,Alec,Morrow,Harvey Group,South Alison,Georgia,+1-416-938-3587,001-075-331-0341,samanthahubbard@branch-cline.biz,2022-03-19,https://potts.com/
02-Jul-2021,Purchase,00.00,"59,070.10","354,420.58",7Abf6B543B4b7a7,1789,Terrence,Avery,"Francis, Stevens and Stuart",East Omarton,Seychelles,714-503-6277x429,(587)075-2187,brady45@holland.net,2022-05-26,http://doyle-goodman.biz/
02-Jul-2021,Purchase,"31,326.03",00.00,"385,746.61",87E8bcaa763C106,6400,Cathy,Johnston,"Kane, Mercer and Mccall",Lake Shelleyside,Turkmenistan,991-190-3160x31545,585-904-4791,carly75@cordova.com,2021-03-19,https://ortiz.com/
02-Jul-2021,IMPS,00.00,"48,218.33","337,528.28",933bAd1cf4bc4eb,4548,Kathleen,Ewing,Benjamin-Hanna,East Kristinatown,Vanuatu,478-868-9725,(281)568-8990,deborah62@cordova-taylor.org,2021-01-19,https://strong.biz/
02-Jul-2021,Cash,"907,043.50",00.00,"1,244,571.78",acaF925796fe0EE,8955,Meredith,Lang,Watson LLC,West Baileyton,Cook Islands,(211)182-8110x55989,(119)980-3486x6895,rangeljordan@blake-brandt.com,2020-03-30,http://delgado.org/
02-Jul-2021,Miscellaneous,06.60,00.00,"1,244,578.38",8189CCE3385dffA,1059,Rodney,Blanchard,"Bruce, Delacruz and Freeman",Andreaview,Bulgaria,904-131-2076,351.181.4182,maureen28@gross.biz,2022-02-19,http://wallace.com/
02-Jul-2021,RTGS,00.00,"311,144.60","933,433.78",Eb379529B2C12cc,3864,Dennis,Beard,Bean-Madden,Jacobsfurt,Cook Islands,(211)000-9444x8711,875.681.2066,lwarner@powell.com,2021-11-10,https://rice.net/
02-Jul-2021,Transfer,00.00,"933,433.78",00.00,ffa51f5D9A3c1B6,8634,Alison,Khan,"Lynn, Curry and Soto",West Lorraine,Uzbekistan,(476)771-5493,4118695896,fbrock@turner-henson.biz,2021-12-19,http://www.king-luna.com/
02-Jul-2021,ATM,53.00,00.00,53.00,04A4BfE1a3E2cD5,1586,Sergio,Robertson,"Ayala, Obrien and Pennington",New Lindafurt,Papua New Guinea,(422)662-1344,(784)511-3949,drew52@barker.biz,2020-11-23,https://www.hawkins-hancock.com/
02-Jul-2021,Cheque,"3,776.50",00.00,"3,829.50",E65bAC9F22075AC,290,Damon,Stanton,Joyce Inc,Rubenstad,New Zealand,(311)420-8154x573,+1-962-050-4131x01819,yesenia49@lester-martinez.com,2022-03-06,http://villegas.com/
02-Jul-2021,ATM,"31,310.00",00.00,"35,139.50",2C2F56CBA561f67,5098,Nathaniel,Huynh,"Graves, Gonzalez and Gregory",East Timothymouth,Guyana,001-672-674-1220x42811,001-416-028-4215x921,gailjones@buckley.com,2020-11-17,https://larson-floyd.org/
02-Jul-2021,ATM,00.00,"5,856.58","29,282.92",83ce6DEadEf0bC5,618,Allen,George,"Wall, Armstrong and Schneider",Caitlynchester,Israel,077.633.7738,569-072-0443x34035,richardparks@anderson.com,2020-12-12,http://www.calderon-rojas.org/
03-Jul-2021,Transfer,00.00,"4,183.27","25,099.65",92E817f48CaE609,4116,Vickie,Holt,Dorsey-Klein,Lake Andre,Russian Federation,8035819501,001-364-205-3674x44600,gene05@bird.com,2021-03-08,https://www.walker-rice.com/
03-Jul-2021,Transfer,"212,541.00",00.00,"237,640.65",fc0a8E75AEdf7Ee,3450,Stephanie,Carson,"Jennings, Aguilar and Horton",Joybury,Korea,968.425.9014x200,001-588-366-1901x5282,wlester@farley.com,2020-03-30,http://sawyer.com/
03-Jul-2021,Cheque,00.00,"118,820.33","118,820.32",3480bb01BD55Bd8,9456,Brittany,Yu,Ashley-Tucker,Griffinbury,Tanzania,(003)664-9068x5018,477.803.7316,sergio88@sparks.info,2021-06-28,https://www.mills.com/
03-Jul-2021,Miscellaneous,00.00,"11,882.03","106,938.29",eef7fFC6C97FF25,2770,Tami,Pacheco,"Tyler, Clarke and Spencer",West Norman,Seychelles,(316)564-1835x084,215-834-5227x396,jasminchen@chaney.biz,2022-02-26,http://fry.com/
03-Jul-2021,Debit Card,"11,614.00",00.00,"118,552.29",C3BDE37E3CB58D4,3379,Barry,Pope,"Hanna, Gilbert and Zimmerman",New Mckenzie,Swaziland,+1-078-305-0614x5309,808.760.5066x009,wkrueger@coleman-reid.com,2021-12-04,http://fry-anderson.com/
03-Jul-2021,NEFT,00.50,00.00,"118,552.79",a46FFff90b0562a,2836,Tammy,Yates,"Higgins, Saunders and Curry",South Guy,Liberia,(483)929-8903x3430,527.306.6413x016,rbarker@mccann.com,2021-04-10,https://burns.org/
03-Jul-2021,Interest,00.00,"14,819.10","103,733.69",28c2eA0a1fEF5CF,3109,Miguel,Livingston,Garza PLC,Alejandrafurt,Vietnam,909-000-3528x28677,(919)787-1444,darrylhardin@bentley.com,2020-12-24,https://www.bennett.org/
03-Jul-2021,IMPS,00.00,"25,933.42","77,800.27",AcEaBbC6f554d0d,5744,Summer,Dorsey,"Shepard, Russell and Villa",Shawnaburgh,Bouvet Island (Bouvetoya),666.728.9792x579,+1-985-765-0077,ikrueger@stevens.com,2020-05-03,http://www.whitehead-church.com/
03-Jul-2021,Miscellaneous,"1,839.40",00.00,"79,639.67",979B5A2feBc92AE,8288,Jerry,Johnson,"Cline, Manning and Ingram",Jimenezhaven,Western Sahara,+1-742-160-6173,954.002.7986x04169,wgoodman@marquez.info,2021-03-27,http://bowers.biz/
03-Jul-2021,Transfer,00.00,"79,639.67",00.00,9BEcDe3EA3d5631,5770,Danny,Black,Key-Haas,Nicholsbury,Taiwan,654-036-5042x00021,875-647-1684x826,montgomerycolin@cox.com,2020-09-14,https://watson.net/
03-Jul-2021,Purchase,"969,625.00",00.00,"969,625.00",CD018Aea17ea073,3700,Philip,Lyons,"Davis, Chung and Ibarra",New Chelsea,Dominican Republic,(170)712-6785,+1-724-086-7821,sharonkemp@gaines.com,2020-02-21,http://www.riggs.com/
03-Jul-2021,ATM,"27,557.40",00.00,"997,182.40",2CD6A8fd5F1aAcf,7190,Kristopher,Donovan,Mcdaniel-Allen,South Sophia,Chile,(081)152-2488,324-541-9916x86686,brandon14@maxwell.com,2022-05-25,http://www.mata-fuller.com/
03-Jul-2021,Cheque,15.70,00.00,"997,198.10",bdD38eE4AD08eB2,9187,Leon,Russo,Hammond-Mccullough,Maciasside,Romania,303.439.4472x113,244.979.0731x070,vincentmichele@osborn.com,2022-03-11,https://mccarthy.com/
03-Jul-2021,Reversal,00.00,"142,456.87","854,741.23",b461884Af519dbA,8105,Ebony,Nicholson,Koch-Poole,Cervanteshaven,Nauru,749-788-0219,2071258062,ybean@pittman.org,2021-01-06,https://stuart.com/
03-Jul-2021,Reversal,00.00,"142,456.87","712,284.36",2F793FE9F443bDE,4146,Alexa,Espinoza,Lowe-Adams,Freemanhaven,Guernsey,001-219-060-0846x260,(713)737-3942x8748,aaron25@davis.com,2021-07-19,http://vang.com/
03-Jul-2021,NEFT,00.00,"101,754.91","610,529.45",7C75E31AdfB2D5f,3829,Chad,Sellers,Case-Rhodes,South Lindsayview,Cambodia,001-596-267-3328x191,(108)693-3600x840,nbrooks@moore.com,2021-08-17,https://medina.biz/
03-Jul-2021,NEFT,00.00,"203,509.82","407,019.63",f8CCf2BFf6AbEbb,2974,Dominic,Salas,Cobb Ltd,North Jerry,Palestinian Territory,441.295.7488x00063,603-385-8247x731,rodneylin@romero.com,2021-05-29,http://www.bolton.com/
03-Jul-2021,ATM,00.00,"407,019.63",00.00,8fDE40996eAc589,7013,Jack,Oneal,"Odonnell, Gilbert and Galloway",North Aimee,Guam,001-555-979-2140x594,001-515-884-5539,nfarmer@savage.com,2021-08-28,https://petersen-bond.biz/
04-Jul-2021,Debit Card,"56,271.00",00.00,"56,271.00",325fb3F3CdA64b7,5923,Victor,Kane,Branch-Holmes,Jesusmouth,India,0325740912,890.373.5845,craig49@marshall.net,2021-02-22,https://vance.net/
04-Jul-2021,Miscellaneous,"244,836.34",00.00,"301,107.34",c2f673Ea671be42,7748,Lauren,Arias,"Ball, Santiago and Larsen",Port Gina,Morocco,052.002.8746x688,6591790707,aguilarerik@rodgers.com,2021-03-27,https://pope-hanson.org/
04-Jul-2021,Tax,04.86,00.00,"301,112.20",BfaC9E4e9EbC5Da,7507,Jonathan,Fitzpatrick,Forbes LLC,Kyliefurt,Chile,+1-641-920-1366x749,489-905-6661x7115,marshallelaine@drake-rasmussen.com,2022-01-14,http://www.crane-floyd.com/
04-Jul-2021,Commission,00.00,"37,639.03","263,473.18",e3cCe82Fd0bF28f,4474,Julie,Wise,Skinner-Roberson,Lake Loriburgh,Guadeloupe,2797603677,135-291-3282x37225,dzuniga@donaldson.org,2021-07-07,https://andersen-walsh.com/
05-Jul-2021,Bill,00.00,"37,639.03","225,834.15",A597ef6924af151,3872,Jaclyn,Heath,Choi Group,New Jimmy,Dominican Republic,(793)677-2406x636,919.750.6267x63716,cblackwell@friedman.com,2020-09-03,https://www.knox.net/
05-Jul-2021,Interest,01.02,00.00,"225,835.17",86DA925B478DB0f,1659,Jorge,Patrick,"Benton, Blair and Wolf",Chaseland,Poland,545.112.6471,(544)966-3686x6711,krystal75@ware.com,2021-12-26,https://murray.com/
05-Jul-2021,IMPS,00.00,"28,229.40","197,605.77",cbEb6A3Fd9DE268,9370,Sierra,Gray,"Norman, Vasquez and Mcclure",Port Beth,Cook Islands,299.341.2734x155,001-759-991-8409x17388,kentkrystal@hodge.com,2021-09-09,https://www.villa.biz/
05-Jul-2021,NEFT,00.00,"49,401.44","148,204.33",Bdb678F3aA14C0B,4416,Wesley,Hart,Pearson-Soto,Villanuevaland,Niue,807.726.1331,369-736-6469x7161,deborah77@mendoza-fernandez.info,2020-08-27,http://hunt.com/
05-Jul-2021,Purchase,"3,681.00",00.00,"151,885.33",CDc86D423FbC582,7759,Marc,Bowen,Knapp PLC,Carmenview,Ecuador,+1-205-069-9186x7709,+1-508-427-2364x8218,pellis@hodge-wood.org,2021-07-18,https://werner.com/
05-Jul-2021,Bill,33.37,00.00,"151,918.70",beb2e3EcBEaCFce,1232,Geoffrey,Cunningham,"Cowan, Chen and Guerrero",New Brandonside,Mongolia,027.878.8740x321,+1-174-652-0401x4685,dominique08@atkinson.net,2021-10-22,https://www.horne.com/
05-Jul-2021,Reversal,00.00,"18,989.84","132,928.86",baF6d3EcDc12F47,4582,Ashley,Townsend,"Yang, Park and Klein",Alantown,Equatorial Guinea,765.659.1590,217.538.5435,whitneysanford@mclaughlin-perry.com,2022-03-23,https://mcgrath.com/
05-Jul-2021,IMPS,00.00,"44,309.62","88,619.24",dea3eFB3b564FEe,8238,Dean,Dyer,Ryan PLC,Chenfurt,Barbados,(093)320-7714,6264712740,marc69@duran.org,2020-04-19,https://johnston-wong.info/
05-Jul-2021,Debit Card,"26,897.00",00.00,"115,516.24",Ed3DDEE0De1b769,875,Becky,Obrien,"Dunlap, Page and Duke",North Billfort,Andorra,256.124.9882,+1-503-703-0457x21281,wileygordon@salinas.com,2020-05-02,https://merritt.com/
06-Jul-2021,Interest,00.00,"14,439.53","101,076.71",f5Ac0dF01cA4cDA,5902,Caitlyn,Charles,"Bush, Humphrey and Dillon",North Kelli,Guinea,782-838-3701,(385)657-3482x68980,kathleenfowler@holloway.biz,2021-06-17,http://ellison.com/
06-Jul-2021,Tax,00.00,"101,076.71",00.00,b33c57ff9eE1BdC,2430,Gail,Cain,Jacobson Ltd,Fowlermouth,Mauritius,(711)979-6572,762.148.5801,yhoover@lindsey-forbes.biz,2022-04-20,http://malone-kaiser.net/
06-Jul-2021,Miscellaneous,"3,004.00",00.00,"3,004.00",38baedECE07dA6A,272,Jesus,Haynes,Swanson-Glenn,Warrenhaven,Namibia,(592)022-9626,808.651.7562,zramsey@gallagher-briggs.biz,2021-11-13,https://watkins.com/
06-Jul-2021,Purchase,"1,520.00",00.00,"4,524.00",cf492E1eF7Cab9D,5504,Darlene,Hoover,Stout-Hanson,New Austinview,Peru,+1-728-566-2148x3585,+1-371-811-5720x2038,uhopkins@castillo.com,2022-05-26,http://www.todd-weaver.com/
06-Jul-2021,Commission,00.00,"2,262.00","2,262.00",eDc1236b33B5A6e,6534,Robert,Avila,Dudley Inc,South Marilynview,Northern Mariana Islands,026.779.2356x17201,(454)213-9709x74365,adamprince@middleton.com,2021-04-07,https://richmond-sampson.com/
07-Jul-2021,Interest,"1,699.90",00.00,"3,961.90",Aab2cCE3dA4489B,5406,Summer,Miller,Swanson PLC,Port Amyburgh,Puerto Rico,+1-865-251-5710x45002,(633)448-0205,powerscindy@chan.biz,2021-03-17,https://buchanan.com/
07-Jul-2021,Miscellaneous,"1,481,732.20",00.00,"1,485,694.10",dede2FAD5FE4Abe,6375,Patty,Nichols,Riddle-Mejia,Rubenborough,Spain,920.518.2671x0279,7108530627,christinetravis@goodwin.org,2020-06-20,https://woodard.com/
07-Jul-2021,Transfer,00.00,"148,569.41","1,337,124.69",1CB1953e9ea075A,4755,Isaac,Mccormick,Forbes-Barry,Gabriellamouth,Congo,(623)350-7487,780.207.3674x586,andrewsbarry@gomez.org,2020-02-14,http://weeks.com/
07-Jul-2021,Purchase,"2,647.30",00.00,"1,339,771.99",B2c9Fae7DfbE4cA,1520,Sandy,Carlson,"Berg, Miles and Gamble",South Melodyburgh,Marshall Islands,+1-266-483-6070,001-804-702-3280x77623,curtis04@gomez.biz,2021-04-20,http://www.sanders.biz/
07-Jul-2021,Cheque,00.00,"446,590.66","893,181.33",BCFFDCb9DdDECCF,8905,Dan,Glass,Melton-Copeland,North Nicolemouth,Austria,001-440-770-5539,001-627-353-9988x226,edward61@lawrence.com,2021-10-18,https://rasmussen.net/
07-Jul-2021,NEFT,00.00,"446,590.67","446,590.66",bdBa4AdEBCC4DF9,6911,Christina,Gallagher,Bullock Ltd,Deborahport,Canada,(083)324-5348,+1-225-992-4528x909,umarshall@miranda-camacho.com,2020-12-16,https://www.meadows.biz/
07-Jul-2021,IMPS,63.00,00.00,"446,653.66",2fC135381ccEebA,9551,Sherri,Riley,Frey-Sawyer,Calhounstad,Antigua and Barbuda,001-742-977-8039x76094,7933040978,juarezgabriel@patterson-bennett.net,2021-06-03,https://mcintyre.biz/
07-Jul-2021,Cash,"2,975.73",00.00,"449,629.39",79DBcd5b753Ab65,8533,Kelly,Sharp,Holland-Bruce,Rachelhaven,British Virgin Islands,027.793.1370x3799,652-323-5967,mhartman@holden.com,2022-01-10,https://www.wise.com/
07-Jul-2021,Reversal,20.56,00.00,"449,649.95",A87d6D772BcBF59,2153,Roberto,Lynch,Freeman-Owens,Glendafort,Bermuda,(425)266-2541,+1-048-783-3189x1191,gilesdominic@kelley-kaufman.com,2021-09-29,http://cox.com/
07-Jul-2021,Debit Card,00.00,"64,235.71","385,414.24",a71E3Bd4aFe30F8,8615,Sonya,Wagner,Giles-Jones,Jodybury,Zimbabwe,+1-368-283-6160,001-857-749-5033,suecarney@mueller-coleman.com,2022-02-04,https://www.martinez.biz/
07-Jul-2021,Reversal,00.00,"128,471.41","256,942.83",AfdEaacBc0C60b3,3988,Valerie,Mann,Novak Inc,South Samanthachester,Guinea-Bissau,+1-874-056-6004x68992,432-098-2847,cherrytim@meadows.com,2020-12-10,http://cunningham.com/
07-Jul-2021,Interest,00.00,"64,235.71","192,707.12",F7de3aFFbDcEA4D,944,Mikayla,Peters,Long Inc,Stevensonmouth,Kazakhstan,001-780-084-3924x01666,+1-933-918-7830x66759,reginashelton@forbes-gordon.com,2020-02-26,https://yang.org/
07-Jul-2021,RTGS,"222,967.70",00.00,"415,674.82",A34DfeaaaBdcA3F,724,Carlos,Strong,Lam-Ball,New Richard,Nicaragua,782-573-1710,6543807435,qhudson@wilkinson-rivers.com,2020-11-16,https://maxwell.biz/
07-Jul-2021,Tax,00.00,"41,567.48","374,107.34",bA939dE996CF4BF,1495,Ian,Pennington,Roy-Riggs,West Patrick,Algeria,+1-500-645-4371,999.108.0534x8807,danielewing@mcgrath-dunn.com,2021-05-09,https://bond.info/
07-Jul-2021,NEFT,"1,129,895.00",00.00,"1,504,002.34",3Dcfb28d95fC6cd,2936,Dawn,Hammond,Kaiser LLC,Stevefort,Cayman Islands,001-246-591-3131x7494,4750825431,lvillanueva@bowers.com,2022-01-25,https://www.summers.com/
07-Jul-2021,Purchase,00.00,"501,334.11","1,002,668.23",0AFbFCB4ce11B3d,2118,Frederick,Huynh,Phillips Ltd,Lake Spencerport,Trinidad and Tobago,556-206-5248x5864,001-323-973-3371x12697,garrett41@baxter-booker.com,2020-04-17,http://bender-daugherty.com/
07-Jul-2021,Interest,00.00,"143,238.32","859,429.91",7Dc9E4AD643af9e,7934,Debra,Curtis,"Gordon, Ramsey and Duke",Saundersberg,Micronesia,(285)009-3286x1348,001-200-409-9719x346,kellycoffey@fitzpatrick.com,2020-04-10,http://gregory.com/
07-Jul-2021,Cheque,"32,266.03",00.00,"891,695.94",2d2CaE9aaDebCcA,2359,Gregory,Finley,"Bernard, Kidd and Maldonado",North Stephaniefurt,Saudi Arabia,001-331-768-2677x2949,(766)787-2336x111,abernard@perkins.org,2021-07-08,https://www.harvey-franco.net/
07-Jul-2021,Interest,00.00,"891,695.94",00.00,cDCf3DDf4ccf7cb,2653,Brianna,Willis,Finley-Ibarra,Maryton,Qatar,052.865.4758,+1-408-631-0213x9932,skeller@leblanc-church.com,2021-08-26,https://colon.com/
07-Jul-2021,Miscellaneous,"2,087.00",00.00,"2,087.00",a89F0cf6EEfd8f4,1799,Dominic,English,"Mcclain, Klein and Chaney",Estradaville,Lesotho,431-046-3807x07034,4515683636,ksimpson@rosales.com,2022-01-27,http://www.rodriguez-reyes.com/
07-Jul-2021,IMPS,"1,364,436.00",00.00,"1,366,523.00",e9EDD08FE5Aa19E,9526,Loretta,Whitaker,Stokes and Sons,West Ariana,Uruguay,001-297-933-6429x601,096.407.2268x90676,melody68@key-burns.com,2020-11-16,https://www.dillon.info/
07-Jul-2021,Bill,"18,120.00",00.00,"1,384,643.00",F5d03148eb09e8C,6632,Nancy,Livingston,Stark Group,New Nicholas,Albania,444.275.2143,001-341-584-8992,downsjorge@osborne.com,2022-04-19,http://www.pacheco.com/
07-Jul-2021,Reversal,00.00,"1,384,643.00",00.00,57B6d3584aabffa,7457,Neil,Delgado,"Mathis, Bruce and Braun",Kaitlinfort,Martinique,512-630-2244x29031,(628)846-6260x7115,stacyduncan@boyer.com,2021-08-08,https://www.eaton-serrano.biz/
07-Jul-2021,Tax,25.60,00.00,25.60,5aFAEDB6FA9332E,8048,Karen,Fuentes,Mack-Weaver,East Anita,Senegal,+1-782-421-7657x0331,727-112-6472,terrenceacevedo@obrien.com,2021-04-18,https://mcgrath.com/
07-Jul-2021,Cash,00.00,03.66,21.94,e1Fd5F5eef4ce3D,731,Rachael,Gentry,"Bradshaw, Cooley and Martinez",Jenniferport,Jordan,820-110-7293x8051,001-593-704-3130x1384,jle@ewing.org,2021-03-18,http://greene.com/
07-Jul-2021,Commission,469.10,00.00,491.04,DeF4B9e08eAE8a7,229,Olivia,Saunders,"Sanchez, Coleman and Leon",Lisaville,Korea,298.311.2706x59582,+1-498-562-7577x9389,triciarichards@shelton.net,2021-03-30,http://www.hurley.com/
07-Jul-2021,Commission,69.80,00.00,560.84,031e4fa6ab0a228,4847,Nicholas,Ortega,Castro PLC,Marshview,Benin,001-126-447-4201x693,+1-957-881-8781x52507,stuartrice@berry.com,2021-08-20,http://gardner.com/
07-Jul-2021,IMPS,"26,162.50",00.00,"26,723.34",42CfACE21f9eb63,385,Damon,Daugherty,Galvan-Lloyd,Gabriellaborough,Macao,3153985378,2970579866,wbarton@orozco-banks.com,2021-08-27,https://harris-haynes.org/
08-Jul-2021,Cheque,"1,247,850.00",00.00,"1,274,573.34",8df0bc36DdEd85B,5657,Brianna,Garza,Oneal-Cohen,Burnsland,Fiji,(138)958-9282x703,+1-782-139-6618x1151,uhurley@graham.com,2021-03-03,https://www.higgins.org/
08-Jul-2021,Transfer,00.00,"159,321.67","1,115,251.67",AC8c81220eCdE45,7392,Meghan,Spence,"Mcbride, Barnes and Horton",Derrickside,Chile,(003)857-6952,068.655.2359x8834,ronaldacosta@lewis.com,2021-02-07,https://www.oneal.biz/
08-Jul-2021,Cheque,"3,578.80",00.00,"1,118,830.47",72EC0E37eb53cb2,8132,Kristin,Crosby,Ray-Newman,Bettyside,Kenya,001-508-104-0224x2123,001-450-651-3857x23568,alisonpotts@lamb.com,2020-11-24,http://www.parsons.com/
08-Jul-2021,IMPS,00.00,"139,853.81","978,976.66",D36DEE5D1Bcb9ae,5268,Perry,Bentley,Forbes-Pollard,Carlland,Equatorial Guinea,+1-516-165-6317x0239,291.510.2537x7923,qwarner@gill.info,2021-06-02,http://coleman.biz/
08-Jul-2021,Transfer,00.00,"978,976.66",00.00,EE30CA4AcE1f811,4827,Anita,Chaney,"Castro, Davies and Gay",West Breanna,Lesotho,292.222.9308,4402808156,alexandra72@chapman.org,2021-08-29,https://www.casey.net/
08-Jul-2021,Reversal,03.90,00.00,03.90,DABb9bD3CE75FF3,8388,Peggy,Holt,Fitzpatrick Ltd,Mortonside,France,434.173.9632x9161,(660)264-1581x0816,rfuller@torres.com,2020-04-09,https://www.marks.info/
09-Jul-2021,Bill,03.00,00.00,06.90,9a0BDf9cEf1f76d,379,Jim,Villegas,"Browning, Avery and Mercado",Emmaton,Ghana,525.864.9616,2353584783,fpope@buck-carney.info,2022-01-05,https://www.rocha.com/
09-Jul-2021,Transfer,00.00,01.73,05.18,CCcA061F30Bbf25,7865,Mallory,Frank,Randall-Solomon,Everettmouth,Kyrgyz Republic,408.778.4048,2178370932,chandlerangie@mathews.info,2021-10-18,http://www.rocha.com/
09-Jul-2021,Bill,00.00,00.52,04.66,38bfC93D5649816,7419,Sylvia,Roberts,"Hoffman, Robinson and Wade",Harpermouth,Uzbekistan,057-875-1917x1989,951-051-2972,katrinaharmon@rollins.com,2021-12-03,https://www.young-solis.com/
09-Jul-2021,Miscellaneous,00.00,00.67,03.99,aDdbd86Ca3B910D,6660,Kelly,Barber,"Alvarado, Quinn and Mercado",Phyllisberg,Kyrgyz Republic,250.349.0686x32396,(138)248-7926,vatkinson@collier-santos.info,2020-10-27,https://www.carr.com/
09-Jul-2021,Miscellaneous,00.00,00.80,03.19,2bDc6CCC0E51DD8,8354,Sara,Santos,Hickman and Sons,Lydiaport,Saint Lucia,789-927-6903x27088,+1-962-638-7180,tony87@douglas.com,2020-11-24,http://www.tapia.info/
09-Jul-2021,RTGS,"179,596.75",00.00,"179,599.94",fAB97e675E327F3,6395,Philip,Shannon,"Butler, Perez and Christian",Lake Danburgh,Saint Pierre and Miquelon,253.805.6031x67014,2509607820,schristian@frey.org,2020-09-06,https://hicks.net/
09-Jul-2021,Reversal,00.00,"25,657.13","153,942.81",b00fDE199d877CC,7853,Morgan,Mata,Neal-Singleton,Hannahmouth,Dominican Republic,001-187-862-6443,001-648-600-3084x4477,eduardodiaz@boyer.biz,2021-02-03,https://www.olson.com/
09-Jul-2021,Miscellaneous,00.00,"25,657.14","128,285.68",6bbd8ebF4A96Ad4,5188,Brett,Bender,Bishop-Hickman,South Judithside,Somalia,+1-281-150-8213x99443,(399)480-4960x192,bernard69@barnes.com,2021-11-12,https://armstrong.com/
09-Jul-2021,Reversal,"26,946.30",00.00,"155,231.98",39fDa82D3cdbbA4,4586,Julian,Mclean,"Mccann, Rose and Wade",North Eduardofurt,Seychelles,723-921-4888x675,(363)290-6025x1682,bartletttony@baldwin.com,2020-02-13,https://daugherty-sanders.com/
09-Jul-2021,Bill,304.00,00.00,"155,535.98",09BEad84b8Dd813,2569,Dean,Richards,Spencer-Jacobs,South Priscilla,Vietnam,001-420-266-2853x122,470.721.5593x5853,lortiz@chan.biz,2021-08-29,https://hess.com/
09-Jul-2021,Commission,00.00,"155,535.98",00.00,d8D8C1B71c70F1A,9465,Tami,Mooney,"Barnett, Harrington and Gregory",Haasburgh,Qatar,961-463-4454x11494,746.438.9509,aimee85@cross.biz,2022-05-09,https://peck.org/
09-Jul-2021,Tax,162.00,00.00,162.00,A8B3f3AB539AF11,7264,Ronnie,Bryant,Ali-Coffey,North Crystalfort,Dominican Republic,288.848.5745x9536,647-502-9617x337,sarah35@combs-krause.com,2021-08-09,http://www.pollard-jefferson.net/
09-Jul-2021,Commission,00.00,20.25,141.75,FcEfF23bf73fbf2,2837,Debra,Juarez,Erickson-Cook,Lake Anneshire,France,022-784-3257,+1-138-118-8731x43961,sheryladams@best.com,2021-08-05,https://www.davidson.com/
09-Jul-2021,Debit Card,00.00,47.25,94.50,E5afdBe3778c85a,1753,Madeline,Perry,"Jacobson, Salazar and Miller",Mariahmouth,Japan,(565)008-7256,566.625.1678,gordon61@marshall.biz,2021-12-11,http://massey.com/
09-Jul-2021,Commission,306.00,00.00,400.50,8401A221A66bB5A,1507,Tamara,Krueger,"Conley, Ford and Buck",West Lukeview,Timor-Leste,001-330-066-6063,762-960-5764,ghodges@morris-hayden.org,2020-08-29,http://wood.com/
09-Jul-2021,Transfer,39.00,00.00,439.50,D06FDEBbfef76e8,2444,Oscar,Snyder,Glenn-Hutchinson,West Arianaside,Qatar,312-672-0083x23519,8650843113,orrtodd@murray-mann.com,2021-10-30,https://dickson.com/
09-Jul-2021,Purchase,00.00,439.50,00.00,bfea3c1f5C1fAf0,5761,Pamela,Alexander,Pacheco and Sons,Bradleymouth,Tonga,001-396-511-6694x3974,001-489-983-1625x8286,erik39@waller.biz,2020-03-31,http://petersen.com/
09-Jul-2021,Commission,330.70,00.00,330.70,Ed753e4CcceEC7D,3757,Shawna,Odonnell,Wells Inc,North Phyllistown,Guinea-Bissau,(899)118-2294x13390,+1-978-682-9977,lorettanorman@hunter-mcdaniel.com,2021-06-21,http://pena-hayden.com/
10-Jul-2021,Debit Card,00.00,36.74,293.96,50eECbEfA50641C,8760,Traci,House,"Lewis, Newton and Boone",West Isaacchester,Afghanistan,286.500.3556,(946)914-1392x011,brandy61@cohen.com,2020-09-08,https://www.berg.com/
10-Jul-2021,Commission,"13,686.18",00.00,"13,980.14",bd1393D0a137698,7046,Riley,Castaneda,"Barnett, Chase and Clay",Lake Dominicton,Dominican Republic,9971917689,(376)212-8094x149,wmcconnell@johnson-macdonald.info,2020-04-24,https://www.crosby-whitehead.org/
10-Jul-2021,IMPS,00.00,"2,330.02","11,650.12",09AD0A5C12bC9Bf,3025,Sherry,King,Stephenson and Sons,Port Alexandra,Russian Federation,(433)031-0439,(158)118-2100x690,laceymiller@bray.com,2022-05-16,https://www.conrad-villa.info/
10-Jul-2021,Reversal,00.00,"2,330.02","9,320.10",a2CDAdD0645ffa2,4369,Monica,Tucker,Dillon Ltd,New Daleville,Macao,(236)597-4068x78812,001-667-581-0421x543,bentleycasey@reese.net,2021-05-27,http://sherman.org/
10-Jul-2021,Bill,00.00,"4,660.05","4,660.05",bB3c9f8F73377A5,5360,Alvin,Shelton,Woodward PLC,East Tylerton,Czech Republic,(484)268-5930,621-128-0859,vgreen@collins.info,2022-04-06,https://www.bishop-floyd.com/
10-Jul-2021,Debit Card,124.00,00.00,"4,784.05",C6bFB6789FA3da4,5828,Wyatt,Dodson,"Pugh, Le and Gordon",Duffyview,Lebanon,436-829-6249x77093,001-611-080-3753,owatson@herring-chen.info,2021-09-12,http://www.velasquez-tate.com/
10-Jul-2021,Reversal,41.70,00.00,"4,825.75",ED27Cf17C8eEA96,6138,Emily,Ferrell,"Vaughn, Hays and Gross",Audreyport,Saint Vincent and the Grenadines,001-077-665-7570x108,771-112-5156,jshelton@barajas.com,2021-12-11,https://osborne-edwards.com/
10-Jul-2021,Tax,00.00,965.15,"3,860.60",6C86aE28E42f652,4219,Gavin,Barry,"Bright, Foster and Mitchell",Connershire,Madagascar,+1-029-939-4567,387-269-2658,gmiles@mccarty-burgess.com,2020-11-09,https://benjamin.com/
10-Jul-2021,Transfer,00.00,"1,930.30","1,930.30",3F9241ebD6bA4af,9429,Tammy,Ayers,Dillon-Wilcox,Mollyland,Iceland,001-793-724-1718,854.490.6605x8736,glassdana@bernard-barker.com,2021-11-01,http://www.house.com/
10-Jul-2021,Debit Card,"21,994.80",00.00,"23,925.10",DA42554Deb61761,9662,Vernon,Cabrera,Bird Inc,East Sueville,Congo,+1-813-299-8995,001-252-506-4459x4305,julia20@michael.com,2021-11-30,http://www.prince-gonzales.com/
10-Jul-2021,IMPS,215.20,00.00,"24,140.30",d25fAABD069c567,3236,Leon,Hancock,Lawson-Ortiz,Ronniechester,Svalbard & Jan Mayen Islands,884.437.7839x29473,362-239-3753,danielleball@cabrera-bartlett.net,2020-12-04,http://landry.com/
10-Jul-2021,ATM,00.00,"6,035.08","18,105.22",4E06F1Ea7E072D2,9502,Ana,Dalton,Charles LLC,Rachaelshire,Cuba,(748)418-3424x5194,(862)493-9842x8218,weeksmercedes@stevens-turner.com,2022-02-27,https://www.powers-villa.org/
10-Jul-2021,Purchase,240.00,00.00,"18,345.22",248DFBD21eC1f73,450,Anne,Harper,Stevenson and Sons,Pruittfurt,Bhutan,246-514-2503x293,+1-720-685-6422x6584,josedudley@andersen.com,2021-04-03,https://walls.com/
10-Jul-2021,Miscellaneous,"228,646.53",00.00,"246,991.75",7D0cE91963E42Ec,2284,Misty,Barrera,Mcneil Ltd,Carterfort,Bosnia and Herzegovina,362-807-9323,(162)690-0327,duane54@klein-savage.org,2022-04-12,http://www.wyatt.com/
10-Jul-2021,IMPS,"149,966.75",00.00,"396,958.50",701EC3F3Aa5EA1b,7262,Arthur,Stokes,Boyer and Sons,Port Rebeccaport,Belarus,001-981-864-7055x101,+1-671-645-9797x29905,clayton77@gilmore.com,2022-05-26,https://www.pollard.com/
10-Jul-2021,RTGS,00.00,"198,479.25","198,479.25",6Ab34FdcE8E5e02,2566,Brandy,Ferrell,Bishop and Sons,Janicemouth,Spain,8696057153,049.867.1095,cameron24@blanchard.info,2020-02-26,http://ford.com/
10-Jul-2021,NEFT,"1,223.42",00.00,"199,702.67",eCe8bebEC08ab45,7653,Cory,Buckley,Lowe PLC,North Suzanne,Bulgaria,568.494.9181x96635,001-518-000-5400,cervantesbrooke@davenport-chen.com,2020-06-19,http://www.ewing.info/
10-Jul-2021,Interest,"184,919.00",00.00,"384,621.67",04f89Bf8eA46Bfb,4491,Tammie,Tanner,Burgess-Franco,Lake Carlaside,Pakistan,426-508-8846,001-914-203-4357,loretta51@cook.info,2020-11-13,https://www.riggs.com/
10-Jul-2021,Transfer,00.00,"48,077.71","336,543.96",923001BEefd95c5,660,Ralph,Singh,Ramos-Alvarado,Rossmouth,Puerto Rico,001-659-763-3705x650,0311554992,scook@gill.com,2020-12-22,http://www.ramirez.org/
10-Jul-2021,Cheque,00.00,"48,077.71","288,466.25",E4B6Ba2F9b8358D,5225,Collin,Sweeney,"Sexton, Krueger and Levy",Rosemouth,Benin,(624)273-9813x89833,(191)925-5904,franciscovargas@wilkerson-ryan.biz,2022-03-18,http://foster.com/
10-Jul-2021,Miscellaneous,00.00,"288,466.25",00.00,Aaf2D8fF5edeD6F,281,Evelyn,Huynh,Parrish-Simmons,South Sheila,Saint Helena,001-650-421-0322x71656,224.261.4291,jmullins@craig.com,2022-03-23,http://www.ellison-hobbs.com/
10-Jul-2021,Transfer,72.10,00.00,72.10,0F0c5EBcCe5FBbc,3493,Roberto,Craig,"Barber, Price and Woodward",Maddenfort,United Kingdom,696.067.8606,183.371.5943x416,ninamcdowell@solomon.com,2022-01-25,https://gutierrez-frost.com/
10-Jul-2021,Tax,"2,033,004.00",00.00,"2,033,076.10",224da01988c71a9,8821,Fernando,Livingston,"Ibarra, Ward and Mcdonald",Knightmouth,United Kingdom,971-068-8115,359-724-2876,olsenmario@fernandez-wheeler.com,2021-06-07,http://bentley.info/
10-Jul-2021,Tax,00.00,"1,016,538.05","1,016,538.05",AFDBA1d51C9560f,1615,Wendy,Berger,Boone-Tanner,Isaacside,Papua New Guinea,001-281-674-5905x623,(289)674-6338x5596,mcoleman@parks.com,2021-02-22,https://www.marshall.com/
10-Jul-2021,Transfer,"22,906.00",00.00,"1,039,444.05",D3c3bcBEeD5FFFe,3638,Fernando,Hogan,Young-Boyle,East Darrellbury,Vietnam,+1-381-509-8285,+1-390-729-4715x650,unolan@white-key.biz,2020-09-13,https://www.mitchell.com/
10-Jul-2021,Transfer,"1,950,845.20",00.00,"2,990,289.25",0afAA5D950e833c,2605,Caroline,Rivas,Randolph Ltd,Richmondborough,Malawi,7763494220,+1-653-804-6493,phillip19@robbins.biz,2022-01-09,http://christian.com/
10-Jul-2021,Purchase,00.00,"747,572.31","2,242,716.94",E0319dcEabEDE3d,1579,Connie,Welch,"Fields, Rivers and Horton",Carolynborough,United Kingdom,163-267-1325x663,+1-122-175-1023x8927,grossjaime@combs.com,2020-05-08,http://www.lowery-morrison.info/
10-Jul-2021,Purchase,00.00,"373,786.16","1,868,930.78",8bFE9aaDFdbfB59,5542,Jesus,Chaney,"Odonnell, Knight and Wu",South Mathewside,Guernsey,(304)133-2020x2431,883.746.2369,kaylee52@sloan-huang.info,2021-12-24,http://www.bennett-roy.com/
10-Jul-2021,Purchase,00.00,"622,976.93","1,245,953.85",2374F8ff43fa006,1927,Marilyn,Conrad,"Jennings, Wall and English",Tammyville,Cook Islands,001-570-521-9370x898,(704)604-4413,parkershields@navarro.com,2022-05-25,https://www.henderson.net/
10-Jul-2021,IMPS,00.00,"124,595.39","1,121,358.47",3668D9C0dCFf8eF,3355,Virginia,Matthews,Wall PLC,Roblesberg,Botswana,+1-647-637-7196x9733,716-658-9298x2143,grant17@lopez.com,2022-02-10,https://www.robinson-jennings.com/
10-Jul-2021,Reversal,00.00,"373,786.16","747,572.31",9D4bE5a541DE155,6082,Angela,Zavala,"Barrett, Ryan and Duffy",Lake Casey,Cuba,236.146.3716x973,001-242-668-3982x9471,bryce95@black-harris.com,2020-10-14,https://www.skinner-grimes.biz/
10-Jul-2021,Cheque,"1,176.10",00.00,"748,748.41",aC8CD2781df6638,9541,Jeanne,Hamilton,"Young, Ferguson and Mcgrath",Peggyhaven,Saint Pierre and Miquelon,743-771-1064,(185)407-1941,justin62@steele.com,2021-05-26,https://andersen-miles.com/
10-Jul-2021,RTGS,01.00,00.00,"748,749.41",ebbFccF9776b1C5,2269,Clarence,Dean,Hampton Inc,Trevinoview,French Southern Territories,1315794276,818.933.7944x0279,hannahbranch@miranda.org,2022-02-09,http://dodson.com/
10-Jul-2021,RTGS,00.00,"93,593.68","655,155.73",FefddFAd7a6AfD1,4806,Geoffrey,Hammond,Oneill-Lawson,Bridgetton,Nepal,(653)031-5183x20332,+1-975-216-7757x950,shari49@mason-floyd.com,2021-04-05,http://www.black-mercado.com/
10-Jul-2021,Tax,"7,608.20",00.00,"662,763.93",5aDcF9C8dbAd83D,7515,Ashley,Tyler,Calhoun Inc,West Corey,Bangladesh,001-950-701-2057x47608,001-350-148-2596x493,paula93@hodges.biz,2020-07-11,https://christensen.com/
10-Jul-2021,Cheque,00.00,"132,552.79","530,211.14",C6bFB6789FA3da4,5828,Wyatt,Dodson,"Pugh, Le and Gordon",Duffyview,Lebanon,436-829-6249x77093,001-611-080-3753,owatson@herring-chen.info,2021-09-12,http://www.velasquez-tate.com/
10-Jul-2021,ATM,00.00,"265,105.57","265,105.57",Fb6Da7d46CE88e3,217,Eric,Mitchell,Shannon-Valencia,East Jo,American Samoa,(880)412-2558x97593,692-203-8338,lauren64@faulkner-hood.info,2020-12-05,http://mckee.com/
10-Jul-2021,Debit Card,199.20,00.00,"265,304.77",DA40F8e70BE5DdA,2713,Raven,Ortiz,Trujillo-Spears,Samuelshire,Gibraltar,+1-075-427-3050,214-641-0933x37181,woodardmarcia@mack.com,2020-12-26,http://www.salinas.net/
10-Jul-2021,Debit Card,00.00,"132,652.39","132,652.38",CdDfBead33aE32C,6655,Joshua,Butler,"Glover, Hammond and Garner",Rojasbury,Australia,(262)388-6312x0382,257-364-4947x69050,nyoung@osborn.net,2021-08-12,http://rivers.com/
10-Jul-2021,Bill,00.00,"26,530.48","106,121.90",80A2005f3FeEeac,6284,Tim,Wells,"Blanchard, Hernandez and Lawrence",Collinmouth,Zambia,(678)327-2767x18036,001-011-275-6858x6719,dean58@boone-cunningham.com,2021-06-07,http://www.chapman.biz/
10-Jul-2021,Debit Card,00.00,"17,686.98","88,434.92",d0813Ac7Ece4c58,431,Herbert,Tran,Mcintyre-Gaines,West Gerald,Bolivia,415-536-8137x415,307.873.0334x73452,meadowsmandy@baker.info,2020-11-22,https://www.bell.com/
10-Jul-2021,Miscellaneous,764.14,00.00,"89,199.06",f838D73a1AcA4dd,2257,Anita,Marquez,"Reilly, Andrews and Roman",Matthewsville,Papua New Guinea,466.697.1387x099,001-238-614-3180x99888,jackson10@suarez.info,2020-08-12,http://reeves-valencia.info/
10-Jul-2021,ATM,06.10,00.00,"89,205.16",B50b5B8dD474B29,5057,Leslie,Hodge,Rios Ltd,East Sharonmouth,Malaysia,7517658154,(999)728-3930x890,phillip19@villegas.net,2021-08-28,https://lee-cain.com/
10-Jul-2021,NEFT,00.00,"12,743.59","76,461.57",F94ccf63A85D6a9,7602,Sally,Harper,"Rodriguez, Decker and Huffman",Millsbury,Egypt,+1-564-319-9997,128-813-8032x026,leroy37@sutton.com,2021-06-09,https://luna.info/
10-Jul-2021,Debit Card,01.00,00.00,"76,462.57",ec75Fb9C6A0DcF1,39,Joyce,Foster,Randolph LLC,Nataliestad,Korea,655.928.6486,+1-966-669-6464,samuel97@wyatt.com,2020-10-29,https://www.schmitt.com/
10-Jul-2021,Commission,00.00,"8,495.84","67,966.73",BD051Dffc6E47Cb,9314,Maxwell,Carson,Sloan and Sons,New Terriside,Monaco,+1-584-009-6430,+1-559-035-6950x8562,diana67@church.org,2021-12-27,https://www.best.com/
10-Jul-2021,Miscellaneous,00.00,"13,593.35","54,373.38",1Ce2be60037801a,9943,Kenneth,Lewis,"Kirby, Hill and Eaton",Oliviaborough,Philippines,115-344-6682x307,556-988-4476,lmelton@kim-cox.net,2021-01-01,https://skinner.com/
10-Jul-2021,Tax,"25,607.15",00.00,"79,980.53",816ACBaD7DABb1f,7950,Christie,Cohen,Bright-Thornton,Masseybury,Thailand,307.303.8839,+1-928-505-1505,darryl99@park-hicks.com,2020-03-02,http://key.biz/
10-Jul-2021,Miscellaneous,"3,856.70",00.00,"83,837.23",Ca83aa93393309B,3470,Brandy,Weeks,Chen-Atkins,New Darylville,Oman,+1-398-016-8211,156.667.7689x9032,brookechapman@roberson.com,2021-09-11,http://grimes-frederick.com/
10-Jul-2021,RTGS,"12,264.00",00.00,"96,101.23",FF905eA354CB8d5,5894,Sierra,Edwards,Franco-Horn,New Marie,Peru,596-226-1357x04873,749.872.1777x2982,mcmillanautumn@nash-nunez.com,2020-11-12,https://www.hebert.info/
10-Jul-2021,ATM,00.00,"19,220.25","76,880.98",7Fd0edb39Ac22a3,9503,Julia,Leach,Singleton-Moses,Raymondstad,Equatorial Guinea,579.978.7691,(089)805-2886x09461,spencergeorge@pham-lynn.com,2020-09-03,http://patrick.com/
10-Jul-2021,Transfer,00.00,"25,626.99","51,253.99",F322eAEeDeA6caC,6751,Abigail,Mueller,Armstrong and Sons,Lake Faith,Burundi,(162)018-7142,914.658.3788x747,sylviamoody@farmer.info,2020-12-21,https://www.doyle.com/
10-Jul-2021,Interest,00.00,"17,084.66","34,169.33",8CA866F85c97Ea1,5016,Catherine,Gillespie,"Wagner, Wheeler and Sims",North Tiffanyside,Canada,+1-166-249-7741x708,100.752.2115x46235,zmaynard@chan.net,2020-04-18,https://santiago-buckley.net/
10-Jul-2021,Cheque,00.00,"34,169.33",00.00,740FAC486dfA13f,1250,Ronald,Larson,Beard PLC,New Kellistad,Serbia,570-320-8921x519,572-764-1244x016,smallscott@moss.com,2020-08-05,https://turner-sutton.com/
10-Jul-2021,Cheque,"926,276.00",00.00,"926,276.00",addBFAA20bb2800,3296,Kurt,Fitzpatrick,"Schmitt, Wilkerson and Wilson",East Ralphland,Finland,671.575.5388x89273,1724751768,ogarner@stevens.biz,2021-12-03,https://osborne-church.com/
10-Jul-2021,Tax,"26,233.00",00.00,"952,509.00",7a2cD31f7A2c545,1072,Norma,Medina,Marquez-Faulkner,Gallowaymouth,Solomon Islands,001-298-685-5257x47766,(724)785-0802,caitlinhubbard@proctor-mullins.com,2020-11-28,https://www.chandler-henderson.com/
10-Jul-2021,Commission,00.00,"190,501.80","762,007.20",d0C6c7A3081aa4d,7012,Rebecca,Mayer,Oconnor LLC,Chelseyland,Bosnia and Herzegovina,001-508-405-2380x611,702-432-8792x17217,vangronald@chang.org,2021-11-24,http://www.moss.com/
10-Jul-2021,RTGS,00.00,"127,001.20","635,006.00",e1bc8dfACAD5Abc,5754,Riley,Cain,Best-Thompson,Rachelborough,Slovakia (Slovak Republic),001-854-447-3498x2544,863.066.0668x22891,peter16@wu.com,2020-09-22,http://hogan.net/
10-Jul-2021,Debit Card,"185,135.00",00.00,"820,141.00",b397feF01C510a1,3753,Bryan,Wang,Sexton-Wise,Shawmouth,Ecuador,999-851-3675,528-974-4750x55810,sierra88@schultz.com,2020-01-17,http://www.williams-conley.com/
10-Jul-2021,RTGS,00.00,"410,070.50","410,070.50",C1E9Abf3AF2Ae02,2341,Misty,Galvan,Fields-Hodge,Pughborough,Montserrat,159-009-8051,001-789-318-0063x05794,troberson@soto.com,2020-11-02,https://www.montoya.com/
10-Jul-2021,Interest,00.00,"82,014.10","328,056.40",5f4f221a9055EAC,5070,Luis,Pitts,Rasmussen PLC,Lake Charlotte,Jamaica,+1-911-026-4019x617,390.191.7852,susanpotts@bridges-howell.com,2021-12-02,https://ochoa.com/
10-Jul-2021,Reversal,"1,760,280.20",00.00,"2,088,336.60",5b0E47FbaaFBc07,3319,Dennis,Dickson,Mays-Henderson,West Kelliestad,Mali,+1-473-592-5124x06090,309.312.2166x5489,dariusschmitt@moyer.info,2021-04-18,http://sweeney.org/
10-Jul-2021,RTGS,00.00,"417,667.32","1,670,669.28",8aedA4145da6782,2840,Suzanne,Simmons,"Ayers, Austin and Castaneda",Barbaramouth,Haiti,368-461-6723,(092)929-3855x9656,isharp@hull.info,2020-02-21,http://www.pugh.com/
10-Jul-2021,Cash,00.00,"835,334.64","835,334.64",edCbEc43f18cEbC,6672,Kathy,Norris,Beard LLC,Lake Karla,Qatar,+1-636-224-2030,524.157.9472x6644,tracey71@lynch.com,2021-09-18,https://ortega-olsen.org/
10-Jul-2021,Cheque,"45,755.40",00.00,"881,090.04",37d28BD81d9f425,8611,Natalie,Wallace,Duke PLC,West Brandi,Malawi,021-542-5662x400,+1-784-356-6967x158,blogan@hudson-dickson.info,2021-07-20,http://www.rasmussen-chavez.info/
10-Jul-2021,Cash,01.40,00.00,"881,091.44",1BdfeCFF1584a3A,9287,Maureen,Johnson,Vaughn PLC,Aliciaberg,Romania,529-723-6871x9311,001-385-542-6250,isaac80@mack.org,2020-03-05,http://www.meza-gentry.com/
10-Jul-2021,Purchase,"2,960.95",00.00,"884,052.39",8fE8cBA8df40AC7,8333,Patty,Faulkner,Underwood-Simmons,South Derrick,Saint Helena,+1-210-276-0652x9103,(642)753-6431,vancericardo@cross-osborn.org,2021-12-26,http://www.bradley.net/
10-Jul-2021,Transfer,06.00,00.00,"884,058.39",f8e9987B620cCcb,4247,Amber,Simon,Lynch-Wilcox,North Meganview,Guinea-Bissau,855.449.4884x5481,001-934-722-7319,mitchellvernon@wilkins.org,2021-10-21,http://www.boone.com/
10-Jul-2021,Miscellaneous,00.00,"442,029.20","442,029.20",d328C5c6A8D84D0,1051,Garrett,Baird,David LLC,Hessport,Azerbaijan,9047667176,001-854-689-4427,lorraine34@burgess.com,2021-12-22,https://walls.com/
10-Jul-2021,RTGS,00.00,"110,507.30","331,521.90",1Ce2be60037801a,9943,Kenneth,Lewis,"Kirby, Hill and Eaton",Oliviaborough,Philippines,115-344-6682x307,556-988-4476,lmelton@kim-cox.net,2021-01-01,https://skinner.com/
10-Jul-2021,IMPS,"74,486.00",00.00,"406,007.90",2f9991CfE9c2Ff2,6873,Holly,Finley,Ellison-Hutchinson,Joanneport,Bhutan,+1-582-086-3133x755,(852)329-8904x65732,wrowland@leon.biz,2021-04-28,https://www.hester-ellison.org/
10-Jul-2021,Reversal,"3,599.40",00.00,"409,607.30",DD0caa06ebf217c,9996,Meghan,Cline,Richardson LLC,Petersport,Cote d'Ivoire,001-270-136-4738x419,001-349-692-1755x055,nicolasandrade@bates.info,2022-04-27,http://thomas-ramos.com/
10-Jul-2021,NEFT,00.00,"102,401.83","307,205.47",16e30af2efbd892,5559,Neil,Castro,Perry LLC,Kimborough,Hungary,+1-838-474-6768x6751,789.948.2000x10108,inorris@crane.com,2020-10-03,https://www.floyd.com/
10-Jul-2021,ATM,271.00,00.00,"307,476.47",C2378a0b119b425,40,Marc,Medina,Pearson PLC,New Petershire,Japan,1874666215,237-063-6496x65292,karlgarrett@fischer.biz,2020-03-02,http://www.nicholson.org/
10-Jul-2021,NEFT,00.00,"43,925.21","263,551.26",B8b23AFcf2aC211,1331,Bruce,Daniels,Valdez-Paul,Sellersview,American Samoa,9991408435,360-226-2807x7173,xperry@rich.net,2020-08-07,https://www.landry.com/
10-Jul-2021,ATM,00.00,"43,925.21","219,626.05",dB4CeA43f03C4E8,5127,Cristian,Chung,Kennedy Ltd,Robinview,Swaziland,(733)239-7458x5518,406-434-6293,eclarke@hanna-curry.com,2020-09-18,https://salazar-burke.com/
10-Jul-2021,Bill,268.59,00.00,"219,894.64",8AE5128FB69f3f1,3888,Xavier,Mcclain,Grimes Ltd,Hessmouth,Northern Mariana Islands,(879)605-7498x1357,514-422-3997,mbrown@callahan-moon.info,2021-07-31,https://www.arroyo-beard.com/
10-Jul-2021,ATM,00.00,"24,432.74","195,461.90",FEaeE7bC7Df7ea5,4852,Kellie,Singleton,"Olsen, Calderon and Mccoy",Jacobsonmouth,Nepal,389-948-3741,985.573.9734x40778,christie03@compton.net,2022-03-13,https://www.black-hurst.com/
10-Jul-2021,ATM,372.00,00.00,"195,833.90",Ae241447ccECDAc,1804,Erica,Walter,Cole-Gould,South Manuelfurt,India,+1-992-604-9326x50451,221.569.2289,kaitlin56@sosa-thomas.net,2020-03-16,https://www.wells.com/
10-Jul-2021,IMPS,01.00,00.00,"195,834.90",F899c0eB5F9f113,3875,Nicole,Levine,Odonnell Group,Cherylmouth,Gibraltar,799.729.8394x2456,(448)522-5524x20937,tomreynolds@pope.com,2021-11-12,http://www.arias.com/
10-Jul-2021,ATM,00.00,"97,917.45","97,917.45",7baBEE7a9B959cA,4962,Corey,Rush,Carr LLC,Lake Terry,Mongolia,+1-991-035-1347x22446,(569)458-0860x905,brian28@trevino.com,2021-09-29,http://nielsen.net/
10-Jul-2021,Reversal,00.00,"32,639.15","65,278.30",af70bc9D99DE9aD,8697,Hector,Hubbard,Wall LLC,Tapiafort,United Kingdom,2659846705,+1-938-297-5537x551,nedwards@jennings.net,2020-06-18,https://www.molina-weaver.net/
10-Jul-2021,RTGS,"104,538.00",00.00,"169,816.30",C5EBbE976cDa63B,8083,Ana,Yu,"Winters, Holmes and Jones",South Angiefurt,Namibia,125.010.8339,(206)401-7441,mcguirelee@lowery.biz,2020-08-29,http://gardner.com/
10-Jul-2021,Cheque,"2,067.92",00.00,"171,884.22",BDd397f32325492,7708,Mitchell,Todd,Ryan Group,West Yvette,Guadeloupe,(868)706-6893x920,8906340980,daryl81@delgado-nielsen.com,2020-08-23,https://www.stout.com/
10-Jul-2021,Cheque,00.00,"17,188.42","154,695.80",03dDeF0a6206bCd,1506,Jermaine,Hayden,Carr-Chung,Jorgefurt,Libyan Arab Jamahiriya,+1-794-570-4578x177,723.774.6444x37947,lsimmons@chavez-silva.com,2021-03-24,https://ellis.com/
10-Jul-2021,Reversal,00.00,"77,347.90","77,347.90",7F7bf23100cefd8,2963,Sabrina,Everett,Melendez-Robertson,Spencertown,Seychelles,001-864-186-5164,401.748.8852,leerojas@martinez.com,2020-03-22,http://www.eaton.com/
10-Jul-2021,Interest,"32,412.40",00.00,"109,760.30",E0CcAC9Ea5Ee656,6888,Philip,Bennett,Sims-Bishop,West Rossville,Bahrain,156.510.9933x270,238-959-9906x531,aherman@cline.com,2021-12-30,https://johns.net/
10-Jul-2021,IMPS,02.04,00.00,"109,762.34",dD48fEb68fAf9BA,6439,Catherine,Martin,Dennis-Pena,Mcleantown,Taiwan,+1-118-938-8437x06247,9079916515,yvette29@santana-solomon.com,2022-04-04,http://jefferson.org/
10-Jul-2021,Miscellaneous,"75,037.50",00.00,"184,799.84",92bFddD0C16C99c,342,Brent,Maldonado,English and Sons,New Darren,Puerto Rico,665-732-3833x685,+1-194-449-2684x4178,phillip17@wade.net,2020-02-02,https://www.dominguez.biz/
10-Jul-2021,Commission,07.02,00.00,"184,806.86",F1e30bEF6a380B0,4261,Jasmine,Wright,Davies-Gilbert,East Abigail,Papua New Guinea,(940)069-3200x0402,+1-782-588-3096,dominicbooth@savage.net,2021-09-21,https://holt.com/
10-Jul-2021,Cash,00.00,"23,100.86","161,706.00",16E4eEF96bb4AE7,9437,Dominique,Perkins,"Hughes, Richmond and Roberson",North Ivan,Iceland,983-310-8861x3767,549.819.0873,dustinduke@hammond-porter.com,2021-06-05,https://www.ayers-lin.com/
10-Jul-2021,Tax,301.20,00.00,"162,007.20",b3d8DBfAE0EA8ED,1901,Kristie,Tapia,"Hammond, Shepard and Wilkerson",Port Michael,Estonia,277.988.9460x01512,022.539.1624,imann@blackburn.biz,2020-02-07,https://www.knapp-callahan.org/
10-Jul-2021,Cheque,00.00,"18,000.80","144,006.40",08758848B79B0F9,7318,Latoya,Bailey,Yang and Sons,West Danielle,Micronesia,062-685-2032,207.753.4163x025,pwilkins@blankenship.com,2020-02-16,http://rodriguez.net/
10-Jul-2021,Cash,"20,310.03",00.00,"164,316.43",13fc1339AB7BA79,3616,Francis,Montoya,"Pollard, Decker and Young",New Kerri,Saudi Arabia,8324909128,796-533-2047x7347,vbuck@guerrero.com,2022-01-05,http://rocha.net/
10-Jul-2021,Transfer,31.00,00.00,"164,347.43",5A1b35Aee4B14a2,7939,Jared,Mahoney,Blackburn-Vaughn,Bentleystad,Morocco,374-159-3193x694,+1-138-531-5949x571,paulneil@rodgers.com,2020-04-13,http://www.black.com/
10-Jul-2021,Bill,00.67,00.00,"164,348.10",feFBbFbF14FDaaf,448,Sherry,Vincent,Stephenson Inc,Randyhaven,Nauru,(532)910-1621,3707135701,zdaniels@tate.com,2020-10-02,https://humphrey-jacobs.com/
10-Jul-2021,Interest,"3,283.60",00.00,"167,631.70",Ee2c1D4eE3bA381,7665,Carmen,Mullins,"Moreno, Valencia and Ellis",Hughesport,Austria,001-053-714-6157,879-397-1976x38047,autumn02@gillespie.net,2020-09-24,https://mcintyre.info/
10-Jul-2021,RTGS,00.00,"27,938.62","139,693.08",e3c45E3E4FcCeA0,1185,Frederick,Fletcher,Frey-Reynolds,West Guy,Tonga,813.229.9757x58288,0775767643,matthewmccann@santos.com,2021-06-01,http://gallagher-sanford.net/
10-Jul-2021,Commission,00.00,"15,521.45","124,171.63",8A2aCE0aD4EFDae,8031,Melissa,Fry,"Bradford, Stevens and Mathis",Port Anitatown,Guernsey,674-161-5214x7434,001-070-8106,sean72@harrington-snow.info,2022-03-05,https://davidson.com/
10-Jul-2021,IMPS,09.64,00.00,"124,181.27",FccE8Bf3cecdBEb,175,Monique,Ewing,"Lester, Ayala and Harmon",East Maxborough,Antigua and Barbuda,972.635.8026,332.322.2094x970,evansstuart@griffin.org,2021-12-16,http://mata.com/
10-Jul-2021,Purchase,00.00,"62,090.64","62,090.64",6EAaAe4DBBC5c7F,1805,Adriana,Obrien,Herrera-Conner,West Leeborough,Bolivia,001-919-381-2791,405-739-8290x2064,claudiaberry@bender-gillespie.net,2021-08-23,https://www.mahoney.com/
10-Jul-2021,Miscellaneous,47.72,00.00,"62,138.36",f7499ED48026efa,1141,Christopher,Douglas,Riddle Inc,Hunterborough,Panama,3840922823,+1-052-483-7675x4287,epierce@ray.com,2022-02-12,https://www.landry.com/
10-Jul-2021,ATM,00.00,"6,213.84","55,924.52",E4d9b13346B5Bf6,8719,Krystal,Villa,Luna-Hunter,Burchport,Mongolia,285.281.0977x991,(833)073-0805,vickihoward@hardin.com,2020-06-26,https://wong-cole.com/
10-Jul-2021,Debit Card,"17,143.81",00.00,"73,068.33",f6cB5a2541093e6,7847,Gwendolyn,Cabrera,Mills Group,East Jonathonberg,Bangladesh,544.286.9626x49968,370-076-6791x44281,nathaniel72@copeland-reynolds.com,2021-02-21,https://tyler.com/
11-Jul-2021,Debit Card,00.00,"18,267.08","54,801.25",882b7fdfBfBE5e3,8722,Malik,Strickland,Obrien-Rowe,West Rodneyfurt,Kuwait,001-885-519-8775,+1-075-008-3982,joycerobles@green.biz,2022-05-09,http://decker-cain.org/
11-Jul-2021,Interest,"1,965.90",00.00,"56,767.15",5Ef3A983bDdBBEB,9853,Aimee,Barnett,Berry-Huff,South Bonnie,Malta,1771102499,522.377.7061,franciskristi@walsh-shaw.org,2022-02-22,https://parsons.com/
11-Jul-2021,Cash,"3,374.47",00.00,"60,141.62",592e432eBdCaa33,75,Taylor,Kemp,"Webb, Bauer and Mcknight",Port Charlene,Tuvalu,001-768-645-9632x3754,+1-671-771-9340x9839,michaela80@russell.com,2020-07-21,http://www.terrell.com/
11-Jul-2021,Commission,"1,606,310.75",00.00,"1,666,452.37",6F5Fff931dbC1b0,9722,Allison,Powell,"Wilcox, Strickland and Zimmerman",West Kristaville,French Guiana,718.736.7449,491.883.9187x333,claudia76@navarro.org,2021-07-17,http://www.hutchinson.org/
11-Jul-2021,Bill,37.14,00.00,"1,666,489.51",c9fcEe4acE76E14,5477,Javier,Brandt,Ware Ltd,Chavezland,United States Virgin Islands,152.277.8766,001-180-716-4168,qsmith@newton.com,2021-09-20,http://mclaughlin-meyers.com/
11-Jul-2021,Transfer,00.00,"277,748.25","1,388,741.26",35A70afdCF0bFe1,3077,Sherri,Dominguez,Rosales PLC,Kurtmouth,Ethiopia,819.440.6540,144.091.9104x0514,zavalamary@house.com,2021-03-09,https://beck-randall.org/
11-Jul-2021,Commission,"4,412.00",00.00,"1,393,153.26",5bcD12cf1A055C2,5734,Paige,Becker,"Avery, Weiss and Vazquez",East Scott,Estonia,059-010-6905x823,442-507-6131,osullivan@vaughan.biz,2021-12-16,https://www.mcfarland.org/
11-Jul-2021,NEFT,00.00,"174,144.16","1,219,009.10",fBE68ee9EFcCd1B,3595,Nicolas,Hood,Russell-Velez,South Vincenthaven,Estonia,+1-896-444-7307,322-274-6630,blake37@craig.biz,2021-04-21,http://www.wolfe-wood.net/
11-Jul-2021,Miscellaneous,03.80,00.00,"1,219,012.90",bc2Ec6d0D50Cb6E,6204,Sydney,Small,"Boyle, Li and Watson",Lake Robertchester,Bulgaria,(351)120-2655,671.506.1812,ernestcarlson@madden.biz,2020-06-23,http://pruitt.info/
11-Jul-2021,Tax,22.50,00.00,"1,219,035.40",c0b8e6254F657B2,6847,Molly,Beck,Ray Inc,Shawland,Norfolk Island,231-385-7521x6416,+1-363-564-9606x1648,kelliereese@love.info,2021-03-07,https://stanton.com/
11-Jul-2021,Cash,"692,905.00",00.00,"1,911,940.40",9205EEf516cB8Cb,9715,Kaitlin,Nguyen,Willis-Frye,Fischerfort,Bangladesh,+1-645-599-9063x0146,554-909-4318,vblevins@washington-weaver.net,2021-06-03,http://duffy.com/
11-Jul-2021,Miscellaneous,00.00,"637,313.47","1,274,626.93",F806889ebb2aBdc,2494,Fred,Glass,Duncan LLC,East Ariana,Uruguay,7337179645,825-493-2388x08116,derrickmcbride@marsh.com,2021-11-05,https://www.griffin-phillips.net/
11-Jul-2021,Tax,"1,831,898.00",00.00,"3,106,524.93",de6128c5B23ca48,8013,Melvin,Payne,"Bridges, Holt and Mcdonald",Murphyview,Morocco,+1-116-179-2969x05408,001-648-331-0560x60402,martha05@larsen.com,2022-04-24,https://www.briggs-boone.info/
11-Jul-2021,ATM,591.94,00.00,"3,107,116.87",EcF859343EEBaB7,388,Todd,Quinn,"Woodward, Lutz and Orr",North Maxwell,Cyprus,2598721399,001-453-275-6105,roberthenry@davenport-middleton.org,2021-11-30,https://www.barnett.com/
11-Jul-2021,RTGS,00.00,"776,779.22","2,330,337.65",Fd8CD3d6946EE58,4748,Virginia,Baird,"Powers, Jarvis and Carpenter",West Robynmouth,Hungary,608.539.3742x01943,(607)144-2981x66078,marvincordova@buck.com,2020-10-05,http://www.chandler.info/
11-Jul-2021,Cash,00.00,"776,779.22","1,553,558.43",2fEAcdbcC15cc74,247,Renee,Serrano,"Phillips, Hutchinson and Walter",West Erika,Ethiopia,501.240.0629x1686,684.959.9553x518,tammyspence@day.org,2020-03-28,https://www.haley.info/
11-Jul-2021,ATM,00.00,"517,852.81","1,035,705.62",bBB50aAC7eFA813,4989,Jaime,Sampson,Jefferson-Delgado,Port Isaacmouth,Montserrat,256-928-6970x9868,515-068-5441x855,spearstheresa@bowen.org,2020-10-03,https://warren-herrera.biz/
11-Jul-2021,Tax,00.00,"129,463.20","906,242.42",bc1beCbCcF20CDB,1912,Felicia,Schroeder,Stafford-Arias,South Dwayneview,Gambia,067.957.5321,001-726-945-6083x431,foxjoan@guzman.com,2022-02-20,http://choi.info/
11-Jul-2021,Cheque,00.00,"453,121.21","453,121.21",9bF48C9e6a3f09D,919,Marcus,Petty,Guerrero and Sons,West Caleb,Mongolia,+1-880-702-9167x002,9553307016,holdenraven@carpenter.com,2022-05-10,https://www.roman.com/
11-Jul-2021,Reversal,00.00,"56,640.15","396,481.06",C3EfcED8116f39B,7153,Andre,Carney,Figueroa-Galloway,Conradmouth,New Zealand,(913)260-8838,(698)478-7432,rebekahphillips@conrad.com,2021-11-23,http://mays.com/
11-Jul-2021,Cash,"353,456.50",00.00,"749,937.56",39DF405BEb911f1,3318,Toni,Craig,"Rangel, Dominguez and Mcgee",Carolineshire,Congo,(745)343-9552,345.372.9844,allen95@yu.biz,2020-12-23,http://gould.com/
11-Jul-2021,Bill,00.00,"187,484.39","562,453.17",3deF6B4Db3908f2,8005,Penny,Hayden,"Wallace, Brown and Norton",North Franklintown,Northern Mariana Islands,402-309-7946x4651,994-869-2910x111,sergiojames@christensen-cohen.com,2020-09-17,http://www.burnett-murphy.com/
11-Jul-2021,IMPS,00.00,"56,245.32","506,207.85",4Ff30dd4F3e1e80,3980,Crystal,Maldonado,"Mcclain, Casey and Little",Lake Jose,Northern Mariana Islands,757-444-7658x661,+1-514-091-5514,gardnerlawrence@austin-barr.com,2020-12-27,http://warner-stephenson.com/
11-Jul-2021,Cash,05.90,00.00,"506,213.75",Ee3fE66eb3aff9D,6058,Aaron,Key,Woods Ltd,Michelechester,Reunion,013.270.6637,804-360-6578x7222,amy67@roberts.com,2021-03-04,https://www.skinner-may.com/
12-Jul-2021,ATM,"24,194.18",00.00,"530,407.93",B26fA9cF14Aa65F,5862,Bonnie,Graham,Rowe-Gates,Quinnbury,United Arab Emirates,001-021-184-4884x907,402.848.8587x4544,durhamsonia@acosta-sheppard.net,2020-07-28,https://adams.com/
12-Jul-2021,NEFT,00.00,"75,772.56","454,635.37",B4eFdBA1FdCba01,2754,Bailey,Taylor,Cannon LLC,Bassmouth,Pakistan,(372)542-3749x02429,(614)501-3894x922,chasemeredith@grimes.biz,2020-08-23,https://mann-martinez.com/
12-Jul-2021,Debit Card,140.00,00.00,"454,775.37",fCe7Ef600b7ab06,4189,Arthur,Hartman,Long PLC,Jacksonfurt,Lebanon,(896)579-6572x13914,684-604-1497x35637,dunnjohnny@pearson.com,2021-01-30,http://fitzgerald.info/
12-Jul-2021,Miscellaneous,00.00,"90,955.07","363,820.30",f2AF1ECB3F7E5DA,4460,Jonathon,Glover,Kelley PLC,Nguyenport,Marshall Islands,063.375.9723x160,2526554719,treeves@cervantes-houston.com,2022-05-25,http://petty.info/
12-Jul-2021,Commission,00.00,"40,424.48","323,395.82",777bfa4d8EeEAF6,3446,Erin,Welch,Salazar Ltd,Xaviershire,Senegal,261-235-2396,916.294.8091,pgrant@nolan.info,2020-12-08,http://www.mercer.com/
12-Jul-2021,NEFT,"14,900.72",00.00,"338,296.54",d9D59fdEcaa88AD,5164,Teresa,Drake,Clements Ltd,South Mistyshire,Trinidad and Tobago,495-142-2335,622.485.0591,kara79@stein.com,2020-09-28,http://www.hernandez.org/
12-Jul-2021,Purchase,00.00,"42,287.07","296,009.47",CFc2E3fBb2cc695,8042,Katherine,Weaver,Barnett-Blackburn,Kathleenville,Saint Pierre and Miquelon,024.864.8424x80179,+1-112-847-0042x73388,poolekerri@johnston.com,2022-03-18,http://www.gilbert.com/
12-Jul-2021,NEFT,00.00,"148,004.74","148,004.73",285767fa959679c,4697,Jordan,Singh,Andrews PLC,West Wandabury,Mozambique,5913132282,979-849-3514,whoward@frazier.org,2021-04-24,https://www.myers.com/
12-Jul-2021,RTGS,"1,917.57",00.00,"149,922.30",4D7FAdF824CaCa8,3811,Tami,Harrell,"Randall, Marquez and Mcgee",Bobbyside,Cote d'Ivoire,789.921.8792,(875)321-6055x27241,karileonard@hobbs-harmon.com,2022-03-12,http://estes.com/
12-Jul-2021,ATM,00.00,"14,992.23","134,930.07",c9766eAfa9900F0,3694,Hailey,Fischer,"Bullock, Rowland and May",Ashleyland,Morocco,(385)520-8598,9108721944,kristopher60@choi.com,2021-12-07,http://www.garner-welch.net/
12-Jul-2021,IMPS,"12,121.40",00.00,"147,051.47",9C0B5dAEDDA1C7d,1732,Mason,Mccann,Contreras-Avila,East Coltonhaven,Mauritania,001-922-755-5590x059,782.089.6909,garciajerry@francis-barry.com,2020-01-15,http://www.leblanc.info/
12-Jul-2021,Commission,00.00,"14,705.15","132,346.32",27414EBC4AA02E5,7924,Shelly,Rogers,Stanley Ltd,Banksland,Saint Helena,269.355.0963x58953,509-339-1978,orrmindy@bowen.com,2022-03-03,https://erickson.com/
12-Jul-2021,Miscellaneous,27.90,00.00,"132,374.22",C6b2AB869fE4E77,4701,Theresa,Graham,Arias LLC,North Kimchester,Uzbekistan,309.133.1891,574-015-8225x9971,bassphillip@chambers.com,2020-09-23,https://baird.net/
12-Jul-2021,Commission,00.00,"18,910.60","113,463.62",7A06684bC0bfbFa,441,Chelsey,Tapia,"Long, Terry and Garner",South Laurachester,Moldova,001-607-068-6950x55174,4282991256,wallacekristy@cross-oconnell.com,2020-05-17,http://www.david-huff.com/
12-Jul-2021,Purchase,"14,119.34",00.00,"127,582.96",35B456fFf617075,8553,Lisa,Hester,Fitzgerald PLC,Lake Blake,Turkmenistan,811-079-9113x952,573-672-9255,ralph11@soto.com,2021-08-13,http://chavez.com/
12-Jul-2021,ATM,05.00,00.00,"127,587.96",a17Fc98B86Db6F5,5946,Kim,Perkins,Bray PLC,Bryanchester,Malawi,(946)071-0993x860,(422)580-9394,schwartzjessica@quinn-mayo.com,2020-04-09,https://terry.net/
12-Jul-2021,Commission,349.26,00.00,"127,937.22",98Af09C3BfCe2c3,239,Sheri,Arnold,Warren Ltd,Dorothymouth,Haiti,001-959-964-0415x510,881-870-7916x29626,walterfrye@good-boyer.com,2020-04-12,http://christian.com/
12-Jul-2021,Tax,"17,794.90",00.00,"145,732.12",d5BbcEE7E4da8ae,7343,Cheryl,Meza,Thomas-Perry,East Feliciaview,Guadeloupe,(971)398-3742,(918)085-6470x6678,alexamiddleton@golden.org,2020-07-24,https://weiss.info/
12-Jul-2021,Commission,"32,554.00",00.00,"178,286.12",8Eed1CFcE915277,5452,Leah,Cross,Stone Group,West Kellymouth,Iraq,530-405-6674,+1-819-611-8467x359,bperez@ray.com,2021-04-16,https://www.cooper.com/
12-Jul-2021,Cash,00.00,"59,428.71","118,857.41",DEf74cab7e8a373,1969,Jenna,Cameron,Pitts and Sons,North Brittany,Saint Barthelemy,3317664189,770-640-2124x608,jasminepetersen@simon.net,2020-06-21,https://www.gillespie.com/
12-Jul-2021,NEFT,00.00,"13,206.38","105,651.03",13bDCB4C94342fA,2951,Tabitha,Maynard,Bennett LLC,North Brad,Macedonia,(046)638-2955x623,(435)615-1815,uprice@christian.net,2020-12-23,http://www.bonilla-rodgers.com/
12-Jul-2021,Commission,"3,154.20",00.00,"108,805.23",dE1Ae4fea53eaC2,1890,Sarah,Leblanc,Ashley-Melton,Daltonville,Sudan,317.783.1164x385,2227393195,jimbailey@hays.org,2020-02-07,http://www.acevedo-allison.biz/
12-Jul-2021,Cheque,00.00,"27,201.31","81,603.92",c4Bac924cC7dAB0,669,Vincent,Barber,"Burnett, Sullivan and Salazar",Sosaborough,Chad,001-581-206-0504x3376,153-897-9782x5956,alyssagraham@singh.net,2021-04-15,http://santos.com/
12-Jul-2021,Interest,"1,292,183.80",00.00,"1,373,787.72",eB286eFAd2e38ba,8178,Javier,Pugh,"Goodwin, Parrish and Huff",New Desiree,Paraguay,+1-340-936-1428x8937,(433)648-4568,alextodd@barron.com,2021-02-11,https://www.blankenship.info/
12-Jul-2021,NEFT,"225,657.69",00.00,"1,599,445.41",d0Ca394F8A5bf8c,4417,Kristy,Salas,Owen Group,South Marchaven,Tunisia,(458)666-2004x550,(125)744-9881,chrishays@fisher-yates.com,2022-01-27,https://www.dudley.com/
13-Jul-2021,Miscellaneous,"3,197.43",00.00,"1,602,642.84",54Ca8Aaf6F23aF5,4496,Joann,Delgado,Lutz LLC,Benjaminside,United Arab Emirates,714.843.5914x616,+1-122-225-7387,thoover@acevedo.info,2021-07-14,http://www.mason-willis.net/
13-Jul-2021,Miscellaneous,00.00,"160,264.28","1,442,378.56",7B0CCfAbfC9f2AE,8470,Krystal,Summers,"Mcfarland, Mitchell and Yoder",North Terranceside,Estonia,001-231-095-0722,(421)083-1666,dustin31@herrera-avila.com,2022-02-24,http://www.werner-gardner.net/
13-Jul-2021,Commission,00.00,"480,792.85","961,585.71",bcEaA988648d3E3,3251,Traci,May,Harris-Anthony,New Frankton,Kenya,986-340-0253,+1-061-966-9225x64166,alexandra21@kemp.biz,2020-05-24,https://www.dudley.com/
13-Jul-2021,RTGS,00.00,"320,528.57","641,057.14",9df1C51847107D8,5176,Briana,Romero,"Wiley, Lucero and Delgado",New Jack,Turkmenistan,(230)019-6120x01529,214-947-3393,hallann@wilkerson.com,2021-12-11,http://www.owen-chandler.com/
13-Jul-2021,ATM,00.00,"106,842.86","534,214.28",1c550d3C2a6CaFE,1823,Allen,Gordon,"Turner, Wagner and Gould",South Feliciaborough,Sweden,496.404.8958,+1-460-270-0834x42768,nmontgomery@singleton-hodges.com,2020-09-16,http://joyce-sampson.com/
13-Jul-2021,Debit Card,"202,184.00",00.00,"736,398.28",1DF7EEa5FDbA75b,2397,Ebony,Ray,"Singh, Benson and Mercado",Hurstchester,Sierra Leone,+1-005-480-3950x959,001-799-374-8584x11288,elane@phelps-spears.org,2020-12-22,http://weiss.com/
13-Jul-2021,Bill,461.00,00.00,"736,859.28",ec33A8bC91BDeE4,2622,Ronnie,Vazquez,Smith LLC,Collinfort,Colombia,397.647.5403x467,001-245-793-9435,dmcconnell@bowman.com,2021-02-05,https://sullivan.info/
13-Jul-2021,ATM,05.88,00.00,"736,865.16",f8Fe7d62aAeB27e,7346,Adriana,Spencer,Hardin Group,North Hayden,Saint Vincent and the Grenadines,+1-244-433-7300,(817)460-1943x557,wmorton@wells.com,2022-04-19,http://www.alvarez-schneider.com/
13-Jul-2021,Bill,"4,670.05",00.00,"741,535.21",04A4BfE1a3E2cD5,1586,Sergio,Robertson,"Ayala, Obrien and Pennington",New Lindafurt,Papua New Guinea,(422)662-1344,(784)511-3949,drew52@barker.biz,2020-11-23,https://www.hawkins-hancock.com/
14-Jul-2021,NEFT,"1,748,333.00",00.00,"2,489,868.21",8be11C537ec6EBe,5000,Dominique,Schmidt,"Khan, Carey and Haynes",Carmenborough,Romania,(161)951-6303,106-446-8928,elaineashley@guzman.info,2022-03-31,https://www.guzman.com/
14-Jul-2021,RTGS,"1,199.00",00.00,"2,491,067.21",8BD947727bAe5dA,2740,Judith,Love,Barr-Sexton,Lake Ernest,Saint Helena,(119)749-6980x0344,+1-073-682-0734x0254,cesarburns@mays-mcdonald.com,2021-10-08,https://strong.com/
14-Jul-2021,Cash,"225,868.00",00.00,"2,716,935.21",635De41f687c324,478,Lacey,Levy,Gilmore and Sons,Lake Warren,Belarus,(401)895-1449,(050)395-2080,houstondesiree@neal-combs.org,2020-08-26,http://garner-conway.com/
14-Jul-2021,NEFT,01.00,00.00,"2,716,936.21",75BAb44deF68C0d,5422,Lynn,Mcintyre,Gibson PLC,Port Phillip,Macao,518.249.1014x108,604-913-9977x706,susan23@griffin-willis.com,2022-01-08,https://www.savage-bolton.org/
14-Jul-2021,Transfer,"126,791.00",00.00,"2,843,727.21",D4BfFDF256D03e7,220,Cassandra,Keith,Landry-Kaiser,Jacquelineville,Armenia,+1-371-829-3846x49770,(378)349-6076,yolanda40@rhodes.com,2020-05-03,http://www.murray-woodard.net/
14-Jul-2021,Reversal,00.00,"710,931.80","2,132,795.41",EcdF6A25cAdbD64,7388,Mandy,Soto,Carey-Morgan,West Lori,Belgium,001-622-694-2181x120,354.830.4221,dwayne39@bell-stein.biz,2022-02-12,http://www.choi.net/
14-Jul-2021,Transfer,00.00,"710,931.80","1,421,863.61",8FD1fC4aDFaEA7c,9407,Alvin,Weber,Bartlett-Blankenship,Robintown,Mongolia,2878427621,001-692-667-9675x6845,albertbarron@brock-wilkinson.com,2022-05-17,http://berg.com/
14-Jul-2021,Cash,00.00,"355,465.90","1,066,397.71",abcBd0FbBcA2F4c,6958,Roger,Haney,"Wilkerson, Anthony and Hatfield",West Pamela,Lesotho,(337)094-5325x2413,814-355-2494x398,kathleen90@vaughn.com,2020-08-07,https://mullen.com/
14-Jul-2021,Interest,00.00,"1,066,397.71",00.00,aF2F7d88788cc7E,8605,Daniel,Neal,"Merritt, Little and Potts",Leefort,Albania,2395655515,+1-893-727-8174x7692,derek31@parrish.biz,2021-03-14,http://gilmore.net/
14-Jul-2021,Miscellaneous,"8,919.00",00.00,"8,919.00",D2FbAeD7Ba92C14,2405,Abigail,Irwin,"Cross, Faulkner and Gross",Troyfort,Israel,4397995127,+1-809-338-4344x3263,bethanyestes@peck.com,2021-05-30,https://www.schaefer-rivera.com/
14-Jul-2021,IMPS,00.00,"2,229.75","6,689.25",64619Ffb49EcFcf,4863,Jeff,Bolton,"Duke, Fritz and Elliott",East Mikaylaberg,Malawi,625.357.5746,001-582-662-6994x687,watsonsarah@tucker.com,2021-01-15,https://chan-rodriguez.biz/
14-Jul-2021,Cash,00.40,00.00,"6,689.65",533e78d7a02026D,7126,Brady,Morris,Church Group,West Erikville,Mayotte,001-804-189-6214x32790,122.804.8582,newing@dawson.com,2020-08-30,http://orozco.org/
14-Jul-2021,Cheque,00.00,"1,672.41","5,017.24",DcA6bB841e11f1F,1551,Jeffrey,Munoz,"Green, Russo and Brady",West Dominic,Australia,249.725.1094,+1-562-837-9040x55026,hernandezcharlene@ayers.com,2022-02-07,https://www.gallagher.org/
14-Jul-2021,Commission,143.00,00.00,"5,160.24",bef44fcAA087848,9849,Troy,Sweeney,Newman-Daniels,Avilafurt,Kiribati,(640)564-5121x35365,+1-041-182-7685x1199,samanthawatson@deleon.com,2022-01-16,http://www.wade.com/
14-Jul-2021,Bill,00.00,645.03,"4,515.21",bbF53eAFa3fc07c,3302,Shelia,Wagner,Humphrey and Sons,Port Jimview,Gibraltar,(620)981-1444x754,108.991.0585,huffmanmichele@kent.com,2021-07-21,http://www.dominguez.net/
14-Jul-2021,Purchase,00.00,752.54,"3,762.68",FB857e7Ead761Cd,551,Hector,Sloan,Hoffman Group,West Joy,Croatia,001-748-784-1312x97719,050-795-0298x2325,lwhitehead@suarez.com,2020-04-29,http://www.owens.info/
14-Jul-2021,Cash,71.00,00.00,"3,833.68",0ca826f0ab0baA9,5214,Thomas,Chung,Dodson PLC,Shermanville,British Virgin Islands,(195)060-3690x9690,902.658.8926,darryl22@jones.biz,2021-01-11,https://www.terry.com/
15-Jul-2021,ATM,"48,964.00",00.00,"52,797.68",a18b1Fe5D8E0FFE,2523,Jeff,Reeves,Mercado-Lowe,Torreschester,Cuba,3009822298,001-344-063-0061x39993,stokestimothy@beltran.info,2020-12-08,http://www.daniels.com/
16-Jul-2021,Bill,"21,058.20",00.00,"73,855.88",e010b9FAAFa6366,8315,Chloe,Anderson,Rhodes-Durham,Mosesstad,Brunei Darussalam,001-486-712-6029x6810,(110)537-0452,karinacaldwell@hull.biz,2020-02-14,http://www.thomas.com/
16-Jul-2021,IMPS,00.00,"9,231.99","64,623.90",3ae9E4EA802d8Ef,1978,Alexander,Mcmahon,Osborne-Crosby,Hannahville,Egypt,565.703.6722x9988,7658708300,desireelam@bradshaw-melton.biz,2020-10-02,http://www.francis.com/
16-Jul-2021,ATM,00.00,"10,770.65","53,853.25",ACe423C3Ba715dD,1963,Neil,Morris,"Rice, Mcclain and Anthony",South Seanview,Serbia,1733386399,+1-750-790-1198x697,isaiah50@jenkins.com,2021-02-27,https://www.medina.com/
16-Jul-2021,Miscellaneous,00.00,"53,853.25",00.00,0fD1c65a1abF091,2853,Vicki,Logan,Roberts PLC,West Joannamouth,Germany,684.504.6094x1033,987-687-7123x338,claudia88@morrow-coleman.info,2022-02-08,https://www.harrell.info/
16-Jul-2021,Transfer,297.70,00.00,297.70,808B25ECacf2FB0,9276,Elijah,Huerta,Yoder-Bartlett,West Chasemouth,Christmas Island,318.090.5271x76935,001-467-134-4481,katelynrobinson@mayo.com,2021-04-25,http://www.mckay.net/
16-Jul-2021,NEFT,430.78,00.00,728.48,106027EF3688844,3666,Tristan,Farmer,Francis Ltd,South Gabriellatown,Saint Kitts and Nevis,150-687-4659x3786,3500906497,chamberstraci@cardenas-haney.com,2022-02-28,https://ferrell.com/
16-Jul-2021,Tax,00.00,80.94,647.54,Fa89D800E2dC257,9229,Lydia,Lara,Reynolds Group,Buckport,Australia,+1-212-085-1429,(021)632-5179,dquinn@banks-stout.org,2022-04-12,http://graves.com/
16-Jul-2021,IMPS,58.50,00.00,706.04,EDcadC8d54B521a,9166,Mallory,Lee,Dunn-Mcguire,Port Tylerburgh,Norfolk Island,376-607-0099,(647)320-7042,hmarsh@snow-sherman.com,2022-01-26,http://www.clarke.biz/
16-Jul-2021,Miscellaneous,383.00,00.00,"1,089.04",291128A1bBDCBe5,6814,Becky,Mckenzie,Brennan-Cooke,Gordonport,Bahrain,(197)423-8196x13259,990-095-5413x691,robynpeck@austin.com,2021-09-03,https://gordon.com/
16-Jul-2021,Cheque,00.00,363.01,726.03,Ce24Bc9Ded4b17A,6353,Elaine,Barry,"Fields, Deleon and Davis",Frankfurt,Finland,+1-233-544-4972,104-719-7916x1695,calebvelasquez@dennis-mathews.com,2021-03-26,https://www.cherry-ryan.com/
16-Jul-2021,ATM,00.00,121.01,605.02,ba854ec0BBefac8,8779,Helen,Oconnor,"Compton, Nash and Hubbard",Lake Kristieport,Guinea,001-021-827-2590,790.978.4970,alanmendoza@booth-wolfe.com,2020-08-11,https://mendoza.info/
16-Jul-2021,Miscellaneous,"1,297.00",00.00,"1,902.02",baBDfE3ACE109be,8924,Mikayla,Roach,Yang-Alvarado,East Karen,Chad,(287)827-6054x274,7878571847,dpowers@wolfe.org,2020-12-18,https://caldwell.com/
16-Jul-2021,RTGS,00.00,317.00,"1,585.02",Ae4d3ad361d40FC,7986,Levi,Coleman,"Cordova, Rollins and Henderson",South Samuelport,Macao,054.312.3945,(769)427-8490x86414,claire48@campos.com,2020-08-28,http://mata.com/
16-Jul-2021,ATM,00.00,176.11,"1,408.91",3Fa1C1c98cCC3bA,8391,Margaret,Coleman,Vaughn-Meza,East Marciashire,Lebanon,067-424-9888,510.050.8826,kellivasquez@buckley.org,2022-05-14,http://bass-hatfield.com/
16-Jul-2021,Transfer,00.00,469.64,939.27,5bC414D7cEab2ed,6087,Meghan,Munoz,Archer Inc,New Joseburgh,Sudan,+1-127-950-0257x85014,(362)397-9321x4204,carlos55@soto.com,2022-01-27,http://reeves-crawford.com/
16-Jul-2021,Interest,04.00,00.00,943.27,bCa8C6E1FBaeB5E,5585,Christy,Donaldson,King Inc,South Rebekahfort,Solomon Islands,+1-252-540-3864x364,603.319.5916,rtanner@mullen-wright.com,2021-06-26,https://conway-christian.biz/
16-Jul-2021,ATM,00.00,943.27,00.00,f8EC3ABe3D2D49d,4820,Tammy,Curry,Moyer-Kerr,Lake Caitlyn,Kazakhstan,625-677-7485,269-111-1970x672,kfry@krause.com,2022-01-29,https://prince-moyer.com/
16-Jul-2021,Tax,43.80,00.00,43.80,67d64Af2c6802dC,3230,Angie,Solomon,"Robertson, Hoover and Zavala",Lake Misty,Swaziland,(434)902-6292x856,549-652-8728,herbertbarrera@merritt.biz,2021-09-03,http://www.marsh.com/
16-Jul-2021,Cash,07.60,00.00,51.40,eb18D93CB584Db7,445,Jay,Bright,"Ford, Ellis and Kelley",North Carlastad,Portugal,661.407.1869x140,551.003.0510,dan44@chan.org,2022-03-29,https://bryan.com/
16-Jul-2021,Commission,00.00,25.70,25.70,a1AafDCBeE510A3,2017,Sara,Nunez,Adkins Group,Ronaldfurt,Australia,(816)647-1929,649.657.7469,eatoncurtis@gamble.net,2020-09-21,http://www.alvarez.com/
16-Jul-2021,Bill,00.00,04.28,21.42,852EcBb482A8d11,9531,Ariel,Cline,"Diaz, Kirby and Mathis",East Feliciaville,Cote d'Ivoire,360-507-4139x546,+1-312-291-6585x47109,pattykey@simmons.com,2020-04-23,https://shepard.biz/
16-Jul-2021,Debit Card,"476,225.20",00.00,"476,246.62",5Cf2DCACBF9bDEd,7767,Lorraine,Edwards,"Harmon, Roberts and Mcguire",Janiceport,Lithuania,001-859-829-0219,6230623365,harmonsarah@zavala-solis.com,2020-06-10,https://www.donovan-sandoval.org/
16-Jul-2021,RTGS,"2,551.00",00.00,"478,797.62",7C75E31AdfB2D5f,3829,Chad,Sellers,Case-Rhodes,South Lindsayview,Cambodia,001-596-267-3328x191,(108)693-3600x840,nbrooks@moore.com,2021-08-17,https://medina.biz/
16-Jul-2021,Transfer,"144,862.00",00.00,"623,659.62",0B5b43F7a9C25EC,8465,Isabella,Manning,Mayo LLC,Nguyenmouth,Azerbaijan,(875)367-3648x2498,001-100-494-5599x78753,pkeller@jimenez-becker.com,2020-10-10,http://white.org/
16-Jul-2021,Bill,"354,956.00",00.00,"978,615.62",F007dBb1E03d6A7,784,Evan,Benjamin,Rich and Sons,New Sonyaside,Libyan Arab Jamahiriya,+1-995-672-5779x921,845-061-9498,lkerr@gibson.biz,2020-12-03,https://terry-west.com/
16-Jul-2021,Bill,00.00,"244,653.91","733,961.72",dd8fAF875cea349,9355,Candice,Cross,"Newton, Reed and Silva",East Ethan,Saint Lucia,077.466.8023x17278,046-579-4704x21236,rileysnow@gilbert.com,2022-01-02,http://www.grant-russell.com/
16-Jul-2021,IMPS,"1,439,622.00",00.00,"2,173,583.72",A7734c4626ab39e,9784,Kristen,Clark,"Pierce, Dillon and Rubio",East Clayton,Trinidad and Tobago,191.482.5890x9523,(000)577-1550,drakealexis@yang.com,2021-02-23,http://knight.com/
16-Jul-2021,Miscellaneous,38.70,00.00,"2,173,622.42",84cA8Cda4232c01,3855,Heidi,Stafford,"Campbell, Moon and Pacheco",Howellview,Argentina,+1-670-923-7301,790-306-9599x8279,dwilkinson@weeks-bautista.biz,2020-05-09,https://www.strong-wyatt.com/
16-Jul-2021,Cheque,00.00,"217,362.24","1,956,260.18",fDC75Da8D4fD288,4879,Rebecca,Mccarty,Everett Inc,Ronniehaven,San Marino,394-691-5482x52053,1433112455,paynetony@evans-marsh.com,2021-08-28,https://hodge.com/
16-Jul-2021,Cheque,41.00,00.00,"1,956,301.18",A7270caeB967E28,4457,Jennifer,Hill,"Moreno, Cook and Hendricks",Eddiefurt,Saint Helena,287.653.4069,+1-868-103-4051x546,devon49@gallegos.com,2020-07-15,http://www.parker-prince.info/
16-Jul-2021,Transfer,04.10,00.00,"1,956,305.28",b0A0e04fFcaEdbc,9686,Alexandra,Davis,Mora-Haley,South Mary,Congo,001-081-784-7107x67946,3513395676,josborne@huffman.com,2020-01-25,http://durham-drake.com/
16-Jul-2021,Cheque,"28,224.80",00.00,"1,984,530.08",5df40AfE84eCDE5,2644,Darryl,Craig,Mcneil Group,Tylerview,Equatorial Guinea,(051)618-5198,(461)876-5979,ahull@jennings-golden.biz,2021-01-02,https://www.short-knox.com/
16-Jul-2021,RTGS,00.00,"198,453.01","1,786,077.07",4A1DaFdd15ecF6C,1619,Alan,Harrell,"Werner, Sparks and Harrell",Goodwinhaven,Senegal,7531543408,001-030-384-3274,feliciablake@oconnell.com,2021-09-30,https://www.rojas.com/
16-Jul-2021,Interest,00.00,"178,607.71","1,607,469.36",0eb2454e99Efdfe,6139,Jim,Evans,Blankenship Group,West Lauren,Sri Lanka,001-493-688-7804x39398,001-103-466-4389x89823,harriskathleen@salazar.org,2020-09-13,http://www.baker-henry.com/
17-Jul-2021,Bill,"1,952,380.00",00.00,"3,559,849.36",5118ccfEcCFf92F,2447,Joanna,Salas,Morris-Brown,West Angel,Tuvalu,629-652-7192x06828,096-007-8323,vdyer@vega.com,2022-01-17,http://www.king-rivera.org/
17-Jul-2021,Commission,00.00,"1,186,616.45","2,373,232.91",4D8Bbc3f79e2cB1,6337,Lonnie,Marquez,"Ferguson, Brock and Patel",Chungberg,Comoros,001-355-443-3539x157,067.171.4242,kaylacallahan@oconnell.com,2021-03-19,http://www.hammond.com/
17-Jul-2021,Cheque,00.00,"1,186,616.46","1,186,616.46",46e7Ae11DABf3cF,1147,Candice,Patterson,Floyd-Acosta,West Michealport,Philippines,466-282-4922x396,3209994408,stevensonsteven@day-middleton.com,2020-01-14,https://www.carey.net/
17-Jul-2021,RTGS,00.00,"169,516.64","1,017,099.82",cca2E284AcF90d9,7503,Chelsea,Mcguire,"Shah, Mcpherson and Shaw",Dylanhaven,Morocco,001-780-078-8637x7339,692-642-8262x6092,zcaldwell@reeves-sheppard.com,2020-11-30,https://www.english-flowers.net/
17-Jul-2021,Transfer,00.00,"127,137.48","889,962.34",A3F42f897DBa3A8,8216,Dominique,Bolton,Bright PLC,East Christineland,Uzbekistan,001-282-122-0237x95007,(594)524-4865x704,brettbeltran@brady.biz,2021-11-12,http://www.cruz-cardenas.com/
17-Jul-2021,Cheque,"1,074,171.00",00.00,"1,964,133.34",0Dff6c27C8049C4,5539,Chris,Buck,Bowman-Bowen,South Edgarberg,Gambia,948.512.2454x11348,001-472-421-9145x827,damon10@clarke.com,2020-09-29,http://www.santos.biz/
17-Jul-2021,Bill,00.00,"392,826.67","1,571,306.67",7ffCda3eDA162b5,7912,Sarah,Chaney,"Gross, Tran and Chang",Juarezland,Cape Verde,+1-115-554-6345x011,657-244-1986x887,rdunlap@parker-webb.net,2021-04-24,http://walter-cooley.com/
17-Jul-2021,Commission,"94,370.03",00.00,"1,665,676.70",95Cae6FE89D9fB8,3524,Xavier,Horne,Mata Inc,East Tammyburgh,San Marino,(999)260-2620x825,950.918.2964x433,jane42@bartlett-irwin.com,2021-06-30,https://www.byrd.info/
17-Jul-2021,NEFT,00.00,"832,838.35","832,838.35",3D837E82E9ebA1c,574,Patty,Cherry,Watts-Schmidt,Parkborough,Cook Islands,102-099-8616,+1-768-306-5987x569,bradpacheco@bradford.org,2020-06-28,http://www.berger-blanchard.info/
17-Jul-2021,Cheque,47.18,00.00,"832,885.53",7FF7d0Ce1a5f462,7844,Casey,May,Huerta Group,New Kurt,Palau,200-136-5181x58215,001-655-826-8822x1299,huntertasha@li.com,2020-11-05,http://gray.com/
17-Jul-2021,Commission,00.00,"83,288.55","749,596.98",57B6d3584aabffa,7457,Neil,Delgado,"Mathis, Bruce and Braun",Kaitlinfort,Martinique,512-630-2244x29031,(628)846-6260x7115,stacyduncan@boyer.com,2021-08-08,https://www.eaton-serrano.biz/
17-Jul-2021,Reversal,214.92,00.00,"749,811.90",6Ae684fcC61bfC4,1788,Kaitlyn,Howe,Mcdowell-Wade,Castanedaport,Isle of Man,+1-378-929-0747,106.085.8771,qbray@wiley.biz,2021-03-05,http://knox.com/
17-Jul-2021,Debit Card,00.00,"249,937.30","499,874.60",4cAAecCc469aaE9,4167,Drew,Crane,Sawyer and Sons,West Kirsten,Brazil,3566371811,867.085.8119,kristenmurillo@serrano.com,2021-08-02,http://www.hoover.com/
17-Jul-2021,Cash,53.08,00.00,"499,927.68",EB9Bf46a74aBacE,5136,Louis,Deleon,Jacobs LLC,East Alanton,Martinique,(131)857-4732,(595)141-5230x054,uchung@burnett-collier.biz,2020-02-26,https://moyer-skinner.net/
18-Jul-2021,Reversal,00.00,"249,963.84","249,963.84",a4Be3A89f99E12E,6316,Catherine,Mcneil,Andrews Group,East Sethport,Mauritius,+1-975-615-4584,+1-443-464-6108,vsimmons@garrett.com,2022-02-21,https://lucero-moran.org/
18-Jul-2021,Debit Card,00.00,"31,245.48","218,718.36",EEFFadD6a7715de,6301,Chelsea,Harmon,Gaines and Sons,New Ronaldberg,Christmas Island,001-263-428-4287x56687,245-948-7845x82875,sara14@crane.org,2021-04-17,https://www.mcbride.com/
18-Jul-2021,Purchase,"227,453.00",00.00,"446,171.36",ce9549Aa59E2F5A,2602,Joy,House,Weiss-Stanton,Port Philipview,Malta,+1-602-156-3950x5462,+1-468-399-0727x840,ginabauer@armstrong.com,2021-05-04,http://pugh.org/
18-Jul-2021,Commission,00.00,"446,171.36",00.00,38C4ab36bbDffcE,9926,Alejandra,Mendez,Horton-Ferrell,North Laurie,Palestinian Territory,783.780.6390,+1-293-726-8000x82793,mbruce@lawrence.net,2020-10-15,http://www.esparza-santos.com/
18-Jul-2021,Reversal,"41,125.19",00.00,"41,125.19",24f2cB08785b6bB,3159,Joann,Bullock,Munoz-Gomez,Colliershire,Pitcairn Islands,(450)258-8188x79632,697.832.7502x05859,shirleyriddle@huynh.biz,2022-02-07,https://huang.com/
18-Jul-2021,Transfer,91.10,00.00,"41,216.29",CA35Ba6BDE3ef18,5348,Ashlee,Giles,"Lin, Barrera and Ortega",North Garrett,Kenya,234-165-0180x95290,+1-219-914-9872x10004,uvelazquez@pratt.biz,2020-05-03,https://www.moon-bolton.org/
18-Jul-2021,ATM,00.00,"8,243.26","32,973.03",FaD7BcB59a69F04,5344,Cole,Mcdowell,Martinez-Casey,Dillonview,Reunion,091.366.5461,+1-173-411-6745,drewknight@mckenzie.net,2021-06-01,https://silva-gates.com/
18-Jul-2021,Tax,00.00,"8,243.26","24,729.77",e1701dDc89cdDef,8736,Alexander,James,Goodman-Meyers,Lake Jane,Italy,352.377.9718x21501,145.815.9582x6612,tannermoore@cabrera.biz,2020-09-15,http://green.org/
18-Jul-2021,Cash,00.00,"4,121.63","20,608.14",1Cc705Efc19c52f,6324,Ana,Carpenter,"Andrade, Kidd and Rasmussen",New Cynthia,Iran,(853)107-6370x53034,(508)243-3126,foxbeth@castaneda.net,2020-11-19,https://rush.com/
18-Jul-2021,Debit Card,00.00,"5,152.04","15,456.10",43f683C3361eb65,62,Doris,Drake,"Rich, Edwards and Miranda",Lukemouth,Indonesia,184-508-9386x4549,+1-839-084-8619x4015,carpentergary@vance-weeks.com,2022-03-03,https://www.snow.org/
18-Jul-2021,Miscellaneous,597.00,00.00,"16,053.10",5820deAdCF23EFe,5,Kathleen,Mccormick,Carson-Burch,Andresmouth,Macao,001-184-153-9683x1497,552.051.2979x342,alvaradojesse@rangel-shields.com,2021-01-17,https://welch.info/
18-Jul-2021,IMPS,"80,907.22",00.00,"96,960.32",F4D501A7FB6E5B3,2894,Wayne,Meyers,"Meyers, Lara and Ibarra",Port Catherine,Iraq,+1-764-385-7672x61829,(821)120-9278x90487,roy90@richard-travis.com,2022-05-28,https://www.collins.com/
18-Jul-2021,Transfer,00.00,"48,480.16","48,480.16",8DeB4bA63fFEd69,9486,Harold,Klein,Pennington-Zimmerman,South Jimmyfort,Bahrain,891.782.4316x400,(212)209-8589x2749,helenbaker@dickson.com,2021-06-29,http://irwin.info/
18-Jul-2021,Cheque,59.37,00.00,"48,539.53",dFCce1be917852C,4081,Cynthia,Phelps,Gamble-Eaton,South Kristin,Togo,206.621.4114x2887,015.960.9695x16853,alejandrabaldwin@boyle.com,2021-10-21,http://yoder.com/
19-Jul-2021,NEFT,"3,569.00",00.00,"52,108.53",DbCdEc4b7aa13e3,7174,Deborah,Bush,Webb LLC,Sweeneychester,Falkland Islands (Malvinas),(716)311-5808,(940)279-7031x73044,gstafford@kline-shepard.com,2020-12-26,http://leon.com/
19-Jul-2021,Commission,00.10,00.00,"52,108.63",56c0FFdA30AA2B4,9976,Damon,Steele,Barnes-Wiggins,Doughertystad,Swaziland,+1-124-543-5317,1998011698,bmayer@thornton.net,2020-12-31,https://collins-woods.org/
19-Jul-2021,Tax,00.00,"8,684.77","43,423.86",5Cbf937eAF42AAC,1681,Sophia,Scott,Bartlett-Hardin,Port Sheryl,Bahamas,(245)790-6293x875,789-274-6413x999,tbishop@diaz.com,2022-04-07,https://www.chan.com/
19-Jul-2021,Purchase,00.00,"43,423.86",00.00,9c1d6AE7E1bAE3b,5879,Nathan,Skinner,Evans-Lawrence,Brandtville,Hungary,020-248-9522,+1-918-222-3477,summersperry@davis.com,2021-09-21,http://oconnor.com/
19-Jul-2021,Cheque,00.80,00.00,00.80,191C1f9FFD29C2b,2831,Lance,Moses,Norris-Bender,North Julie,Bolivia,(666)725-1078x87138,4629706749,kdudley@edwards.com,2020-03-10,http://sullivan.com/
19-Jul-2021,Cheque,00.31,00.00,01.11,3Fece5dEfBdeAcC,3228,Kathy,Hogan,"Benitez, Wolf and Mccann",Lawsonborough,Hong Kong,556-471-6461x8936,672.991.0423x009,mason78@washington.com,2021-04-11,http://farrell.biz/
19-Jul-2021,NEFT,00.00,00.28,00.83,f57eDD9101aD737,1332,Mikayla,Lutz,Herman Ltd,Vickieside,Kenya,001-256-524-7975x8997,467.801.8833x67445,ocombs@peck.com,2020-11-11,http://www.higgins.com/
19-Jul-2021,NEFT,00.00,00.08,00.75,5528A944EebE3b8,8670,Jon,Goodman,"Harvey, Barr and Sexton",East Christopherland,Ghana,458.022.8529x285,001-140-741-8271x110,kvillegas@woods-parks.com,2020-11-23,http://www.stuart.com/
19-Jul-2021,Commission,00.00,00.25,00.50,Fcd97F87Bd9d9a6,7005,Maxwell,Kidd,Huffman-Lynn,Hermanshire,South Georgia and the South Sandwich Islands,736-203-8124x4364,1441592621,gileselijah@arnold.com,2020-04-27,http://navarro.info/
19-Jul-2021,Reversal,00.00,00.06,00.44,EDb0DCAaf614c22,801,Daryl,Reid,Winters-Sandoval,Bullockborough,Taiwan,3105048938,(039)191-1383,markcamacho@hooper.com,2020-02-26,https://www.carr-mendez.biz/
19-Jul-2021,NEFT,01.50,00.00,01.94,38bfC93D5649816,7419,Sylvia,Roberts,"Hoffman, Robinson and Wade",Harpermouth,Uzbekistan,057-875-1917x1989,951-051-2972,katrinaharmon@rollins.com,2021-12-03,https://www.young-solis.com/
19-Jul-2021,NEFT,00.00,00.32,01.62,811c27Cadfc7114,6833,Joanne,Frost,"Fisher, Jennings and Travis",New Ricky,China,(116)814-8212x017,827.477.7138x36932,perry27@york-burch.com,2021-05-17,http://www.moreno.com/
19-Jul-2021,Cheque,"338,634.00",00.00,"338,635.62",32B7A0Fa103c698,1143,Earl,Ferguson,"Harrington, Carr and Stanton",Laurachester,Lao People's Democratic Republic,(555)257-9307,6161653556,beasleyjoel@rasmussen-guerrero.info,2021-06-01,http://www.pineda-davis.com/
19-Jul-2021,Reversal,"3,737.95",00.00,"342,373.57",eE7C23425307971,2677,Blake,Liu,"Benton, Combs and Butler",Port Alecbury,Taiwan,+1-013-093-1269x0126,752.321.1665,horndevon@fletcher.com,2020-04-10,http://www.horne-evans.info/
19-Jul-2021,Miscellaneous,00.00,"57,062.26","285,311.31",11e2aCe35D7d03C,7882,Kylie,Hale,"Wallace, Brock and Ayala",New Jared,Micronesia,(978)671-6472,(952)037-3429,zoeroman@mills.com,2022-05-26,https://www.stanley.info/
19-Jul-2021,NEFT,"22,889.00",00.00,"308,200.31",9da5AeE2646eB34,5701,Joyce,Oneill,Arroyo PLC,Ninatown,Zambia,5234175843,+1-154-404-5274,lee82@ferguson.info,2020-05-06,http://www.johnson.com/
19-Jul-2021,IMPS,00.00,"44,028.62","264,171.69",881e35bac03aC94,7130,Francis,Esparza,Chang-Mcguire,Bethmouth,Sao Tome and Principe,(257)822-5470,3531277188,costacassidy@dunn.info,2021-09-25,https://schmitt.net/
19-Jul-2021,IMPS,00.00,"26,417.17","237,754.52",981dCC429fB53a5,3000,Angie,Evans,Wright-Skinner,Normanbury,British Virgin Islands,001-236-548-9153x13926,890.724.9862,wbeltran@green.biz,2021-03-03,http://strong.com/
19-Jul-2021,Debit Card,00.00,"23,775.45","213,979.07",13810fE15c9c801,4375,Diane,Barnett,"Terrell, Meadows and Sandoval",Coltonmouth,Belize,001-201-325-8499x95357,001-658-942-8653,marcford@hurley-grimes.biz,2020-04-14,http://rubio.info/
19-Jul-2021,Purchase,00.00,"21,397.91","192,581.16",8c16D1cee97F4bd,5650,Walter,Watts,"Newton, Stewart and Maxwell",Allisonberg,Lesotho,+1-691-439-5069x7634,2893500582,katiemendez@gaines.com,2020-01-26,https://www.patrick-rose.com/
19-Jul-2021,Cheque,00.00,"19,258.12","173,323.04",fadfD51c8fAf80a,1750,Ryan,Caldwell,Curry-Burgess,Howardville,Sudan,+1-816-562-0779x4639,001-288-379-8576x3668,peggy73@kidd.com,2021-04-04,http://campbell.info/
19-Jul-2021,Bill,"28,869.70",00.00,"202,192.74",0D8ddA3FEC39Dad,242,Karl,Stephens,Christensen-Gibbs,Horneton,American Samoa,516.383.5282,521-217-9034x306,miguelmathis@crawford.info,2022-05-03,https://burnett.com/
19-Jul-2021,Bill,"2,924.00",00.00,"205,116.74",045ACDE7B2c6f7f,2373,Deanna,Acevedo,"Avery, Larson and Weber",Daleview,Sri Lanka,676-402-9608,001-332-843-2867x120,bobby62@cochran.com,2021-03-10,http://www.gonzalez.com/
19-Jul-2021,Reversal,"4,068.00",00.00,"209,184.74",57D8eeDBCEC5915,1757,Eugene,Lucas,Miller-Wu,Kerryberg,Faroe Islands,148-360-6577x347,449.716.8233,jowall@gallagher-george.com,2022-02-18,http://www.mcdonald.net/
20-Jul-2021,Tax,03.00,00.00,"209,187.74",48aFE66C2B48b37,6984,Mariah,Alexander,Ochoa-Stokes,East Alexandria,Ecuador,098.228.3878,+1-005-517-4027x8693,carolyn61@preston.net,2020-12-13,https://aguirre.info/
20-Jul-2021,Interest,02.06,00.00,"209,189.80",AC659ad8401f270,1315,Chelsey,Anderson,Tanner-Hickman,North Arianatown,Kiribati,6181150128,+1-565-941-7439x5162,louis05@jackson.org,2020-09-09,https://www.bailey.info/
20-Jul-2021,Purchase,136.00,00.00,"209,325.80",ccAC41c6bb5EDbf,857,Brandy,Barr,Stafford LLC,Lake Morgan,Libyan Arab Jamahiriya,971.249.1728,(925)210-7631x9326,steven08@pineda.org,2021-12-28,https://www.leblanc-farley.com/
20-Jul-2021,Interest,06.80,00.00,"209,332.60",18EC22b40be4f24,8030,Isabel,Humphrey,Vance-Ford,West Kathryn,Russian Federation,089-851-2862x322,9737557872,curtisalexandra@vasquez.com,2020-09-22,http://www.bender.org/
20-Jul-2021,Bill,"1,033,526.00",00.00,"1,242,858.60",BAdfDb35D161f0A,3342,Edward,Humphrey,"Preston, Johnston and Levine",Frederickside,Turkey,(093)014-7355x6581,+1-908-140-0063,damonjarvis@rojas.com,2021-05-19,https://www.marks-hooper.info/
20-Jul-2021,Tax,"4,677.80",00.00,"1,247,536.40",B2770ADC46Ac8f4,4689,Wendy,Roth,Castillo LLC,South Jakemouth,Comoros,5969232121,(932)016-5186,jacquelinehull@brady.com,2020-07-06,http://www.wall-figueroa.com/
20-Jul-2021,Cheque,01.20,00.00,"1,247,537.60",3A0AbFFB99A3ACB,2330,Jackson,Donaldson,"Branch, Pittman and Vaughn",Molinahaven,Sri Lanka,8637129327,737-287-5526,destinybullock@avila.com,2020-04-29,http://david.com/
20-Jul-2021,Debit Card,00.00,"138,615.29","1,108,922.31",eDc1236b33B5A6e,6534,Robert,Avila,Dudley Inc,South Marilynview,Northern Mariana Islands,026.779.2356x17201,(454)213-9709x74365,adamprince@middleton.com,2021-04-07,https://richmond-sampson.com/
20-Jul-2021,Cheque,491.60,00.00,"1,109,413.91",0Df13a2dCeCF9CF,8411,Kristopher,Mcgee,"Green, Cardenas and Mayo",Moraburgh,Sao Tome and Principe,(551)640-3344,7312767380,stefaniegray@cowan.biz,2020-12-20,http://valentine.com/
20-Jul-2021,Cheque,00.00,"277,353.48","832,060.43",AeB8D236777AFbA,8909,Vicki,Manning,"Stewart, Hurley and Gilmore",Penningtonchester,United Kingdom,(461)625-2889,001-204-079-3794x24434,amckinney@york.com,2021-06-13,http://www.gutierrez.com/
20-Jul-2021,Commission,"280,466.50",00.00,"1,112,526.93",20A6c8bF97eB4CD,8390,Jenna,Fields,Osborn-Estrada,Goodmanton,Heard Island and McDonald Islands,+1-330-136-7399x927,2454729957,joan27@dean-hall.com,2020-06-27,https://french-rios.com/
20-Jul-2021,Tax,00.00,"139,065.87","973,461.06",4049da80BA00C74,2795,Sheena,Martinez,Burch-Blackburn,Mayerside,India,650.011.5715x248,041.343.7921,eduardo96@best-sheppard.net,2021-04-04,https://hahn.com/
20-Jul-2021,Cash,436.80,00.00,"973,897.86",F4DE3fFc9dadB0D,289,Ray,Yu,Vaughan-Wyatt,South Clayton,French Polynesia,5471798652,001-361-871-8894x96041,zfigueroa@cummings.com,2021-04-01,http://www.white-vargas.com/
20-Jul-2021,Purchase,601.98,00.00,"974,499.84",6f0c451d95cD6be,2042,April,Gardner,"Pham, Koch and Harper",Shellyfort,Bolivia,001-111-310-5141x5762,+1-574-694-7020x2711,patrickfrank@costa.com,2020-08-09,http://mcfarland.com/
20-Jul-2021,NEFT,00.00,"97,449.98","877,049.86",961cFe3BBa7eFbE,5468,Elaine,Howell,Bird Inc,Lake Jacobmouth,Malta,961-336-9313x0559,(454)802-1525,bryansharp@ferguson.com,2021-04-22,http://www.peterson-grant.com/
20-Jul-2021,RTGS,"1,880.60",00.00,"878,930.46",Bbd9cBc4177C31A,523,Adam,Davenport,Gill-Snyder,Port Olivia,Marshall Islands,164.438.9583x14077,250.588.7898x682,terrence66@holder.com,2021-01-29,http://www.pham.com/
20-Jul-2021,Interest,"6,560.40",00.00,"885,490.86",BEeDBC92eFD6ee3,1197,Rick,Faulkner,Meyers Ltd,Jerrymouth,Turkmenistan,577-371-0397,495-549-2895,isaacduncan@blair.com,2021-02-23,http://hines.com/
20-Jul-2021,Cash,"1,806.00",00.00,"887,296.86",4cb9D11EFCD696D,5496,Leroy,Burgess,Atkins-Zamora,New Ricky,Macao,8249238804,001-287-712-2670x73729,antoniovargas@franco.com,2021-06-28,http://nolan.com/
20-Jul-2021,Bill,00.00,"126,756.69","760,540.17",1DA67cc7379B24d,6296,Linda,Jones,Reid and Sons,Lake Reginaldton,Kenya,001-140-360-1618x1370,7113488786,joycepreston@black-warner.com,2021-08-14,http://valencia-horton.biz/
20-Jul-2021,Debit Card,00.00,"152,108.03","608,432.14",Bff26846aE2ceab,6550,James,Mcknight,"Stanton, Paul and Cameron",West Terry,Venezuela,001-737-137-4822x228,5032427085,petersenterrence@charles.com,2021-06-25,https://meza-macdonald.com/
20-Jul-2021,Cash,"126,772.25",00.00,"735,204.39",bd95732d1D00b0c,194,Angel,Velez,Boone-Humphrey,New Priscilla,Botswana,(345)836-1290,(462)027-4722,pcannon@choi.com,2021-04-17,http://www.pacheco.com/
20-Jul-2021,Transfer,00.00,"122,534.07","612,670.32",AE43d41d4baCDC7,2093,Tiffany,Madden,Turner-Cortez,Conradfurt,Holy See (Vatican City State),(416)835-7633x4564,109-924-1848x258,jharding@neal.biz,2020-09-09,http://www.fischer-prince.biz/
20-Jul-2021,Bill,00.00,"153,167.58","459,502.74",d96fC3DcBb6BCcA,6881,Cristina,Ellis,"Barron, Ayala and Hicks",West Fernando,Uruguay,653.027.2134x2981,742.760.3607x87914,watkinsbreanna@eaton.org,2021-12-03,https://www.blankenship.com/
20-Jul-2021,NEFT,00.00,"91,900.55","367,602.19",AdBEd475eB1a2aC,8918,Alvin,Montgomery,Spears-Anderson,Kristopherside,Bermuda,786-149-6443x946,081.345.8564,tbraun@brown.com,2020-09-13,https://valdez.org/
20-Jul-2021,IMPS,"36,249.62",00.00,"403,851.81",a467BebB5becedf,5234,Andre,Best,"Franklin, Holder and Bauer",East Gina,United States Virgin Islands,308.751.2134,836-649-9262,jburns@schwartz.com,2021-10-22,http://www.gould.com/
20-Jul-2021,ATM,"3,115.22",00.00,"406,967.03",A77fc8e7C585cCf,4388,Mary,Stein,Henderson-Duran,Lake Matthew,Barbados,+1-119-575-2988x057,(516)713-0024,odunn@haley.com,2021-10-03,http://patterson.com/
20-Jul-2021,Reversal,"15,224.00",00.00,"422,191.03",5C4Fb6f1184e16F,8745,Jerry,Sweeney,Mccarty PLC,Mossshire,Samoa,154.442.9260,+1-591-085-1250,mcdanielmelvin@jacobs.biz,2022-01-01,https://beard-maldonado.com/
20-Jul-2021,Purchase,00.00,"105,547.76","316,643.27",bbF53eAFa3fc07c,3302,Shelia,Wagner,Humphrey and Sons,Port Jimview,Gibraltar,(620)981-1444x754,108.991.0585,huffmanmichele@kent.com,2021-07-21,http://www.dominguez.net/
20-Jul-2021,Commission,"13,747.00",00.00,"330,390.27",8686ca97e587BA7,7254,Kent,Lucas,Potter-Murphy,Kelseyburgh,Liechtenstein,708-746-6809,001-798-125-6678,victor30@solis.info,2021-03-14,https://www.dudley.biz/
20-Jul-2021,Transfer,00.00,"66,078.05","264,312.22",8c293db36f8c733,1173,Mallory,Nguyen,Ball and Sons,Lake Tashaport,Indonesia,761.869.2824x718,543-782-2970,klawson@newman.com,2021-12-30,http://craig-barton.org/
20-Jul-2021,Bill,00.00,"264,312.22",00.00,395bC0f068bcbE3,8690,Helen,Foster,Williamson PLC,North Zoetown,Cayman Islands,1549836779,001-574-814-8059x644,tracy70@dalton.info,2021-05-30,https://www.mayer-rollins.net/
20-Jul-2021,RTGS,03.40,00.00,03.40,fC9B1bB207d6F73,9411,Arthur,Strong,"Pennington, Whitney and Hendricks",Jillianhaven,Sri Lanka,(580)051-4111x216,304-792-2245,buckleykatie@patel.net,2020-02-06,https://rubio.com/
20-Jul-2021,Interest,00.00,03.40,00.00,8FBbaF601F4EDbE,2635,Rachel,Yates,Short-Kim,Jeromefort,Bangladesh,(774)021-4092x105,(977)929-3235,vcurtis@rollins-dodson.com,2020-10-28,https://www.wilkins-brown.net/
20-Jul-2021,Transfer,"239,718.84",00.00,"239,718.84",5Ebc4d6E605A329,5619,Lynn,Petersen,Salazar-Lamb,New Ethan,Christmas Island,322.301.9253,+1-027-257-7119x313,jeanchavez@knight.net,2021-09-03,http://www.costa-kim.com/
20-Jul-2021,Interest,00.00,"239,718.84",00.00,A61F5cBF8Baf106,4985,Stefanie,Baker,"Sanford, Casey and Castro",North Aimee,Central African Republic,492.401.5682x785,372.684.8586,tommy90@berry-lane.com,2021-05-06,http://www.sellers.biz/
20-Jul-2021,Debit Card,"1,130,636.00",00.00,"1,130,636.00",fe51ef5bEcb9B3a,9553,Breanna,Moran,"Maddox, Cabrera and Donaldson",Oscarburgh,Honduras,073.104.4157,367.206.8377x7278,jilliandoyle@bridges-walker.biz,2021-08-18,https://www.salinas.com/
20-Jul-2021,ATM,00.00,"226,127.20","904,508.80",5dbb4Afcb541F5b,3268,Damon,Singh,"Lara, Dorsey and Horne",Marissaburgh,Papua New Guinea,525-210-9357,(118)695-2962,sydney74@douglas.com,2020-08-21,http://www.buchanan.com/
20-Jul-2021,Commission,00.00,"100,500.98","804,007.82",DF42EfcdACF9952,6808,Carly,Wheeler,Stokes Group,New Colebury,Montenegro,920-235-9919,001-777-288-4224,bernardhowe@schultz.com,2020-12-23,https://www.fuller.org/
20-Jul-2021,Cheque,"82,397.90",00.00,"886,405.72",719CAD2fc78D6ee,2829,Breanna,Hubbard,"Haley, Bauer and Mullen",North Bradville,Palau,3812036106,(233)213-0706x2389,dbeard@gordon-lewis.com,2021-06-19,http://www.montoya-serrano.biz/
20-Jul-2021,ATM,00.00,"147,734.29","738,671.43",15ffA1e0cC8cAf3,6986,Stephen,Farmer,Woodard-Salas,East Breanna,Saudi Arabia,677.912.7740,(459)762-2207x616,lewisallison@fields.net,2022-02-02,http://www.norris.com/
21-Jul-2021,Cheque,271.60,00.00,"738,943.03",dcD492fA78e8Dd0,4778,Adam,Rasmussen,Rojas and Sons,Gavinview,Slovakia (Slovak Republic),+1-186-788-3741x145,+1-009-016-9189x958,kmays@vincent.info,2021-08-07,https://mcdowell.info/
21-Jul-2021,Tax,00.00,"92,367.88","646,575.15",d3f3DCE6AC8C9cA,3758,Joel,Young,Montoya Inc,West Stacieborough,Mauritius,8809752212,3145185212,douglasstout@mccann-gutierrez.com,2020-01-15,https://valdez.net/
21-Jul-2021,Tax,33.00,00.00,"646,608.15",84fdf20935c4D8e,7417,Allison,Winters,Lucero-Parks,Chanville,Saint Barthelemy,+1-405-027-0302x666,+1-935-418-5073,qmiles@baxter.info,2021-04-21,http://www.eaton.com/
21-Jul-2021,Interest,425.22,00.00,"647,033.37",ef9FaB7288481Fe,1576,Shannon,Garza,Mack-Sullivan,East Veronica,Equatorial Guinea,001-476-427-6163x48148,4886643413,paulaperez@hahn.com,2021-09-25,http://www.gibson-savage.biz/
21-Jul-2021,NEFT,"3,796.50",00.00,"650,829.87",45c6AB9eF9d8ADd,80,Sherry,Cantu,Everett and Sons,Younghaven,Kiribati,001-273-927-5314x56481,3058537703,meghanfernandez@patel-todd.com,2020-11-02,http://schaefer.com/
21-Jul-2021,Transfer,03.00,00.00,"650,832.87",fEe4dEAAdbFf32d,3024,Alexis,Barnes,"Austin, Gross and Lin",West Lindamouth,Tonga,(157)161-2183,901-684-1930,jesus38@spears.com,2021-10-26,http://www.cohen.biz/
21-Jul-2021,Miscellaneous,00.00,"92,976.12","557,856.75",6de09ab5dE8e6B8,1993,Fred,Taylor,Cordova Inc,West Joann,Ethiopia,858-569-1816x84261,8168211377,roberto35@forbes-liu.com,2022-05-15,https://espinoza.biz/
21-Jul-2021,Tax,00.00,"55,785.68","502,071.08",d802d1B1cacfaAC,602,Kyle,Hutchinson,"Gould, Sloan and Schneider",Marciabury,Poland,001-635-555-5708x679,+1-884-356-2658x622,xjensen@stokes.info,2021-07-07,http://villarreal.com/
21-Jul-2021,Bill,00.00,"125,517.77","376,553.31",8cc8cBE18EaaC05,7110,Caroline,Dunlap,"Bailey, Anderson and Porter",Joview,Andorra,(656)891-0080x410,001-306-014-8564x977,sonia95@bartlett-macias.net,2020-04-24,https://hubbard-crawford.com/
21-Jul-2021,RTGS,00.00,"125,517.77","251,035.54",e0A95AAc175f189,847,Margaret,Norton,"Blackwell, Marshall and Summers",Lake Caitlinport,Comoros,521-727-6174x36953,+1-706-892-6648,ucoffey@hoffman-russo.biz,2021-03-18,http://wise.com/
21-Jul-2021,Cash,00.00,"50,207.11","200,828.43",31CbaDAbc189B20,979,Mindy,Sutton,"Carey, Clay and Bryan",Port Randallmouth,Uruguay,903.642.6066x5869,+1-414-232-6722x943,averyjeffery@webb.info,2020-07-31,http://malone.com/
21-Jul-2021,NEFT,00.00,"200,828.43",00.00,8CB58f03eFe6dDe,2461,Guy,Solomon,Huerta-Rivas,Lake Leonard,Syrian Arab Republic,001-457-175-0519x21265,+1-503-004-3154x96800,kgay@kelley.net,2020-09-22,https://www.weber.net/
21-Jul-2021,Miscellaneous,"1,716,346.00",00.00,"1,716,346.00",fe8D20bAdFBBE8F,9257,Kristin,Downs,Collier-Graham,Lake Rodney,Greece,+1-441-040-9009,327.015.8719,ydudley@sparks.info,2022-03-13,https://bray-mayer.com/
21-Jul-2021,NEFT,00.00,"286,057.67","1,430,288.33",BC4E5ded790cf5B,4223,Traci,Hendrix,"Matthews, Medina and Fowler",West Hunterchester,Haiti,(539)846-0835,323-838-2618x7724,osanders@trevino-mora.com,2020-05-26,http://www.ross-beck.com/
21-Jul-2021,Bill,"3,520.30",00.00,"1,433,808.63",d5A99Eb3AC6F6ca,5782,Jonathan,Cohen,"Barr, Mcgee and Archer",Lake Cesarburgh,Nauru,424.665.2177x40509,(442)095-8222x98019,lozanoisabella@little.com,2020-01-25,http://www.hatfield-golden.org/
21-Jul-2021,Purchase,146.59,00.00,"1,433,955.22",abDcdBea7514C4C,179,Tanner,Lopez,Griffith-Brandt,Coreyville,Guatemala,001-953-876-9288,420.220.5122x17134,cowandeanna@house.com,2020-11-24,http://frye.com/
21-Jul-2021,Miscellaneous,00.00,"286,791.04","1,147,164.18",C55290972eAFA23,9143,Aaron,Cooke,Ochoa Ltd,Sethside,Marshall Islands,734.289.4618,977.606.7226,tmooney@ferrell.net,2020-09-18,http://www.diaz.com/
21-Jul-2021,Interest,00.00,"127,462.69","1,019,701.49",e248d5E89BC5Cea,4038,Faith,Boyer,Jimenez and Sons,Douglasburgh,Mauritius,(607)550-6938,(001)803-1119,zwalls@kerr.org,2021-03-13,https://hull-townsend.com/
21-Jul-2021,Tax,00.00,"254,925.37","764,776.12",D06FDEBbfef76e8,2444,Oscar,Snyder,Glenn-Hutchinson,West Arianaside,Qatar,312-672-0083x23519,8650843113,orrtodd@murray-mann.com,2021-10-30,https://dickson.com/
22-Jul-2021,Reversal,00.00,"191,194.03","573,582.09",fCA2DadDeA0FdDe,7944,Angie,Stanley,Lucero Ltd,Beckybury,Northern Mariana Islands,611-927-2651x693,+1-204-779-2090x4058,bobchambers@mendoza.com,2020-09-04,https://velazquez.com/
22-Jul-2021,RTGS,00.00,"63,731.34","509,850.75",4F7AaD80D78Fe78,7873,Tracie,Sampson,Oconnell-Morse,Wileyfurt,Slovenia,789.936.6553,001-269-103-1458,beanmathew@mccormick.com,2020-05-29,http://www.simon.com/
22-Jul-2021,Bill,00.00,"101,970.15","407,880.60",664C8C7c9aDEDd3,8056,Grace,Hull,"Paul, Murray and Morgan",Bradview,Benin,(539)023-6000x7869,492-623-6360x33769,monica15@vance-padilla.info,2021-04-29,http://chan.com/
22-Jul-2021,Bill,"1,718,065.50",00.00,"2,125,946.10",E495619Ee377dce,5293,Deanna,Waters,"Nash, Haley and Watkins",Lucasstad,Puerto Rico,001-279-844-7636x762,(658)092-8640,gnixon@clark.com,2020-02-27,https://www.may.biz/
22-Jul-2021,Bill,00.00,"708,648.70","1,417,297.40",0027bD1919b8266,3041,Brandy,Clayton,"Preston, Francis and Hughes",Tylerville,Barbados,+1-290-867-4564x1931,+1-777-582-6465,norma31@castaneda.net,2022-03-16,http://www.vang.com/
22-Jul-2021,Cheque,"9,943.00",00.00,"1,427,240.40",6b86dEADBadfEb1,2346,Tyrone,Beck,Fry-Chung,New Tanyaton,Singapore,857-043-4246x917,287.864.3414x71217,darin53@tucker-meyers.net,2020-11-07,http://torres.com/
22-Jul-2021,Cheque,439.65,00.00,"1,427,680.05",5d1EE3d1aa1bad0,8186,Loretta,Hardy,Haas-Glenn,Donnafort,Azerbaijan,556.270.3200,(546)220-4717x77491,pamboyle@munoz.org,2020-05-21,https://www.hammond.com/
22-Jul-2021,Commission,00.00,"178,460.01","1,249,220.04",EcdaeCb557446ab,6933,Lee,Mayer,Zhang-Conley,Port Alexfurt,Holy See (Vatican City State),001-549-358-4184x84280,044.087.9552,steven50@cowan.com,2021-12-30,http://escobar.biz/
22-Jul-2021,Debit Card,00.00,"624,610.02","624,610.02",570Aec1b5ce3aDb,2854,Kathryn,Pruitt,Howe and Sons,Port Tammie,Bosnia and Herzegovina,673-947-7785x0417,586-588-5700x460,qnewman@little-hayden.org,2022-01-04,https://www.bautista-pollard.com/
22-Jul-2021,Cash,00.00,"69,401.11","555,208.91",1b3eBF8F4dbBDa1,740,Jeffery,Snow,"Leach, Lam and Medina",Jillberg,Isle of Man,001-549-566-5006,+1-327-520-8770x14450,wcervantes@barron.info,2020-09-02,https://www.holt.com/
22-Jul-2021,Cash,13.00,00.00,"555,221.91",0a9fe7D01D7628a,9838,Cheryl,Melendez,Ritter-Pratt,Moodyberg,Bangladesh,+1-221-543-2886,001-879-494-0698x40554,holderruth@nash.com,2020-01-24,https://www.vaughn.com/
22-Jul-2021,Tax,00.00,"69,402.74","485,819.17",B14E9F56e7a9ccd,3299,Theresa,Moody,Colon Ltd,East Stuartborough,Slovakia (Slovak Republic),971-417-0679x89840,354-166-9297,luceroalice@barron.com,2021-08-05,http://www.crane.com/
22-Jul-2021,Reversal,"25,497.10",00.00,"511,316.27",273d64b6f27874A,9458,Robyn,Gilmore,Ritter-Montgomery,East Cassandrastad,Panama,(205)459-4166,+1-903-516-8379x817,lopezeddie@joyce.com,2021-05-27,http://cisneros.com/
22-Jul-2021,Transfer,21.00,00.00,"511,337.27",f6ebaafaA5e23BB,5566,Rebekah,Salazar,"Meadows, Koch and Baker",West Kevin,Falkland Islands (Malvinas),+1-780-476-2431,325.994.8061,camerondawn@huffman.com,2020-02-16,http://peck.info/
22-Jul-2021,Cash,"1,669,269.00",00.00,"2,180,606.27",CEaAfc1c3B5BBDE,2439,Neil,Orozco,"Holden, Key and Rocha",Marshallshire,Pitcairn Islands,(421)094-0310,250-645-1284x3667,jane85@wilcox.biz,2020-04-17,http://www.doyle.com/
22-Jul-2021,Debit Card,"14,289.00",00.00,"2,194,895.27",D76b7da6f820338,8289,Mario,Hines,Gregory-Haas,Derekmouth,Hong Kong,+1-380-426-5692,704-003-8253,sylvia94@benton.com,2020-11-07,http://potter-middleton.net/
22-Jul-2021,Bill,"20,737.00",00.00,"2,215,632.27",eb8a292F27CCF4b,2387,Larry,White,Gentry-Shelton,Tonichester,Myanmar,(716)645-1696,547.479.5803x390,lorrainekaufman@reid.com,2021-07-23,http://www.ray.com/
22-Jul-2021,Cash,38.90,00.00,"2,215,671.17",9A513005CceA299,7782,Miranda,Weeks,"Pace, Ware and Bowers",Gordontown,Cocos (Keeling) Islands,158-433-8911x935,124-421-5859x43546,cheyennehamilton@salas.com,2020-01-14,http://www.russo.info/
22-Jul-2021,Cheque,20.30,00.00,"2,215,691.47",0a9249e4F568cE5,4154,Antonio,Maddox,Holt-Mcdowell,Caitlinland,Moldova,001-349-301-0595x349,971-598-9449x780,cliffordoconnor@alvarez-chandler.com,2020-04-13,https://www.stanley.com/
22-Jul-2021,Miscellaneous,00.00,"738,563.82","1,477,127.65",0D5f3351A8aF3F8,837,Savannah,Miller,Hurst and Sons,Hammondtown,Croatia,789-182-3093x002,670.210.9484x4151,ronniepatton@ashley.com,2022-02-04,https://www.lyons.com/
22-Jul-2021,Commission,00.00,"492,375.88","984,751.77",d1BCfd21A4927CF,7709,Ariana,Curry,Shepherd-Duncan,East Nicolas,Mauritania,(545)438-3920x1182,001-352-357-5500,cwarner@huber.com,2020-07-04,http://www.meza.com/
22-Jul-2021,Cheque,00.00,"246,187.94","738,563.83",31CCA74dEAAa372,8092,Betty,Beck,Crosby LLC,Lake Desireehaven,Cuba,959-250-6860,694-270-6527,deanmiguel@larsen.info,2020-10-03,http://carr.com/
22-Jul-2021,Reversal,00.00,"738,563.83",00.00,97dd4d6F78dDDB5,8183,Lori,Durham,"Figueroa, Wells and Kaiser",Branchstad,Papua New Guinea,001-745-302-2954x964,9974205647,cynthiamckay@mcclure-booker.com,2021-01-02,https://houston.net/
22-Jul-2021,IMPS,38.50,00.00,38.50,82C79DBCBee9d52,7806,Meredith,Poole,"Bean, Mathews and Snyder",Blakeborough,Philippines,335.530.1828x2229,001-829-674-4119x29219,sweaver@faulkner-lloyd.org,2021-10-09,https://www.watts.org/
22-Jul-2021,NEFT,"3,975.70",00.00,"4,014.20",f548deC5DcF2C13,7124,Reginald,Sweeney,Lucas Ltd,Hillfurt,Guernsey,+1-299-484-2918x124,843.889.2046,marshdakota@norman-hebert.com,2021-05-05,https://www.banks-hays.com/
22-Jul-2021,RTGS,58.60,00.00,"4,072.80",dE2b1c421ECAeAb,1256,Mia,Poole,Burgess-Odonnell,New Michelehaven,Fiji,+1-354-723-1092x033,704.662.2004,xthompson@aguilar.org,2021-12-22,http://www.downs-brady.com/
22-Jul-2021,IMPS,00.00,814.56,"3,258.24",4c706C2a7e5eC96,3518,Lisa,Roberts,"Ramsey, Nicholson and Acevedo",West Krystalhaven,Western Sahara,723-876-7992x29877,(858)871-7739x0417,briana60@thornton.com,2020-12-17,https://sanford.com/
22-Jul-2021,Bill,"31,559.80",00.00,"34,818.04",e5169aAa0A2cE5e,2470,Vernon,Wong,"Kane, Sawyer and Frye",New Lynn,Holy See (Vatican City State),7021188400,+1-932-776-6495x590,antonio35@joseph-hansen.com,2021-10-26,https://daniels-mccarthy.info/
22-Jul-2021,Reversal,00.00,"34,818.04",00.00,BCb3f0dEBf64d1D,7229,Vickie,Ross,Li Ltd,Samanthamouth,Montenegro,365.465.8775,123-034-2521,debbie85@cole.biz,2021-01-02,http://www.norris.com/
22-Jul-2021,Miscellaneous,03.00,00.00,03.00,38E5c8280BB2cE9,3358,Gregory,Mitchell,Armstrong-Dodson,South Shawna,Maldives,928-947-7639,781.844.1826,herbert79@west.com,2022-03-12,http://www.hays.info/
22-Jul-2021,Commission,44.00,00.00,47.00,6D9bF63d3DA044d,2237,Patrick,Phillips,West-Cohen,Cohenbury,Bahrain,258.775.2611,984-029-4948x6766,houstonnathaniel@deleon.org,2020-11-28,https://www.hubbard.com/
22-Jul-2021,Cash,04.60,00.00,51.60,Da2a4b1fCbd34cb,9537,Fred,Johnson,Neal Ltd,Danielston,Benin,168-735-7077x32575,098.546.1665,eric33@moran-kline.info,2022-01-17,http://www.vazquez-eaton.com/
22-Jul-2021,Cash,"4,064.70",00.00,"4,116.30",1ef11BfBaF0d2D0,5783,Cory,Rubio,"Blair, Watson and Newton",Lake Karlshire,Honduras,001-366-733-3066x1097,857.524.1575x984,howejulie@ortega.com,2021-06-06,https://adams.net/
22-Jul-2021,Reversal,00.00,"4,116.30",00.00,647b41Fb4A6AAC5,1236,Melanie,Hendricks,Warner-Barnett,East Geoffrey,Marshall Islands,6944737546,974.434.1636,ckelley@church.biz,2020-02-07,http://parrish.com/
22-Jul-2021,IMPS,"2,475.35",00.00,"2,475.35",eB53B2FaD51aeF7,72,Wesley,Cobb,Bruce LLC,Port Spencer,Congo,480-924-1413,6577055396,austinvang@glenn.com,2021-06-22,https://deleon.com/
22-Jul-2021,NEFT,06.94,00.00,"2,482.29",22c3EAB39c7a8ef,8915,Lacey,Harrington,Durham PLC,Port Ariana,French Polynesia,+1-256-958-9745,967.104.2905x64557,mandyfrancis@mccall.org,2021-03-03,http://warren.biz/
22-Jul-2021,Reversal,508.10,00.00,"2,990.39",75eff8a1c363EAe,2460,Xavier,Gordon,Woods PLC,Navarrobury,Andorra,460-020-7429x110,(400)001-5850x0976,rebeccaestrada@mooney-blackburn.net,2021-07-24,https://www.ford-pruitt.com/
22-Jul-2021,Cash,"1,747,891.00",00.00,"1,750,881.39",fD8ebdFBC6484c0,9903,Donald,Key,Walsh PLC,Owensmouth,Tuvalu,3837627237,001-615-917-7244,mejiavictor@neal.info,2021-06-12,http://www.pineda.net/
22-Jul-2021,Reversal,"153,708.80",00.00,"1,904,590.19",bE341222cAfC4cF,328,Joy,Valencia,Graham Ltd,Coltonmouth,Chile,752.730.7527,146-236-7586,rgrant@booth.info,2020-08-21,http://www.villa.com/
22-Jul-2021,Cash,00.00,"190,459.02","1,714,131.17",35410Aaab1E8d27,1227,Evan,Matthews,Barton and Sons,South Isabellaberg,Armenia,926-872-6303x471,(456)582-0410x691,gouldstanley@flores.com,2020-08-02,http://www.cherry.com/
22-Jul-2021,Cash,271.86,00.00,"1,714,403.03",ca750CCfBbEDc4D,8827,Ray,Cobb,Mccall PLC,South Terrence,Niue,823-942-0556,(928)354-2092x03308,carolvasquez@keith.info,2021-11-15,http://www.donaldson.com/
22-Jul-2021,Transfer,"11,799.00",00.00,"1,726,202.03",Ce126FdefebEdA6,8154,Kerry,Archer,Case and Sons,New Ericaberg,Greece,(170)852-5993x163,+1-626-628-1591,raymonddunlap@murray.net,2021-06-24,https://www.dodson.com/
22-Jul-2021,ATM,00.00,"172,620.20","1,553,581.83",51fc98e4E80DEF6,2480,Molly,Roberson,Jacobson-Garza,Westchester,Turks and Caicos Islands,+1-528-041-9377,355-512-6916x8317,manningmackenzie@foster-hahn.com,2021-11-08,https://www.snyder.com/
22-Jul-2021,Interest,857.00,00.00,"1,554,438.83",dE4A3EeFBe8fEDa,8221,Henry,Cherry,Young LLC,New Damon,Indonesia,001-132-580-7917,+1-966-552-6754x33300,amorton@bell-lane.org,2021-10-17,https://andersen.org/
22-Jul-2021,Transfer,"1,358.90",00.00,"1,555,797.73",cf621cD3adEDcE4,9760,Stacey,Strickland,Carson-Huang,New Cynthiastad,Burundi,622.214.0740x72240,(711)458-4641,millsgabriel@bird.com,2021-12-05,http://www.conway.org/
22-Jul-2021,Tax,"30,253.00",00.00,"1,586,050.73",D64EdFC9Abbc88e,6190,Ricardo,Conner,"Adams, Webster and James",Tranfort,Trinidad and Tobago,989-242-0599,001-695-757-9014x95646,tomshaffer@mathis-davis.com,2021-12-10,http://www.schultz.com/
22-Jul-2021,Miscellaneous,00.00,"396,512.68","1,189,538.05",7FF7d0Ce1a5f462,7844,Casey,May,Huerta Group,New Kurt,Palau,200-136-5181x58215,001-655-826-8822x1299,huntertasha@li.com,2020-11-05,http://gray.com/
22-Jul-2021,Commission,"1,320,602.50",00.00,"2,510,140.55",8eDF7cC82d0Efa1,1469,Bonnie,Lane,Patton-Huffman,Ellisborough,Nepal,+1-718-822-1426,588-614-0390x07256,odomwanda@hall-moran.com,2021-11-30,https://quinn.com/
22-Jul-2021,Miscellaneous,00.00,"836,713.52","1,673,427.03",A2ac71f11d7FEB6,7592,Lauren,Boyle,Braun-Turner,North Julieton,Barbados,1217939731,611.454.6479,marcus79@stanley.info,2021-07-28,https://www.guerra-holland.biz/
22-Jul-2021,Tax,"1,642.81",00.00,"1,675,069.84",84828Ab23aFecB7,5753,Hannah,Larson,"Trevino, Wong and Farmer",West Audrey,Honduras,836.623.6633x624,591.815.9308x7929,cesarparsons@barr-hughes.com,2021-05-19,https://moore.com/
22-Jul-2021,Purchase,"1,840,447.75",00.00,"3,515,517.59",cDAe2508Df4Da9f,6619,Wesley,Hayes,"Larsen, Moon and Burton",North Ernest,Indonesia,149-890-7192x26129,001-182-961-5704x796,kristy93@costa-vazquez.com,2021-06-24,https://www.meyers-ferguson.org/
22-Jul-2021,Transfer,"1,919.60",00.00,"3,517,437.19",46FbAe9eC21094F,9864,Frances,Rosales,Roy-Church,Lorihaven,Gibraltar,952-306-9035x272,(488)113-2379,fergusoncristina@benson.com,2021-03-21,https://www.riley.com/
22-Jul-2021,RTGS,00.00,"351,743.72","3,165,693.47",5bEDAd9D1F91e0c,9051,Erica,Zuniga,"Manning, Golden and Ellis",Port Frederick,Argentina,001-238-449-9212x6937,0288318936,gpatel@best-blackwell.com,2021-05-24,http://www.fischer.com/
22-Jul-2021,Miscellaneous,04.00,00.00,"3,165,697.47",e144acaeAC1CAac,5515,Kathy,Brewer,Hughes-Riley,New Tara,Uganda,001-558-882-8195x4006,164-433-1760,mpowell@moreno-villa.com,2020-06-21,http://bradley.com/
22-Jul-2021,ATM,00.00,"633,139.49","2,532,557.98",b0BAD45C54EdAaC,3533,Kerri,Livingston,"Gould, Brooks and Randall",Lake Raymouth,Taiwan,001-615-265-5364x839,746.669.5758,barrymanning@estrada.info,2020-10-13,https://levine.com/
22-Jul-2021,NEFT,"21,917.76",00.00,"2,554,475.74",Fc1AEA19E7D000B,2003,Jade,Oneal,Harding-Barber,South Mikaylabury,Estonia,(259)793-8011x185,001-792-433-2130x76837,dshaw@baker-morris.com,2020-07-01,https://cervantes.com/
22-Jul-2021,Transfer,00.00,"255,447.57","2,299,028.17",695cA606ecF5F75,1740,Danny,Barron,Yates Group,Lake John,Niger,+1-182-320-6044x282,857.685.9812x80466,lwood@davila.info,2021-04-12,https://www.morgan-brooks.com/
22-Jul-2021,Commission,34.00,00.00,"2,299,062.17",9263b42fcE03b7E,3686,Tristan,Ellis,Thornton-Tate,Littleborough,Nicaragua,4145507534,+1-049-598-4878,miguelmartin@dickerson.com,2021-01-18,http://arias.com/
22-Jul-2021,Cheque,668.14,00.00,"2,299,730.31",Eb307A7082Cd6Fe,918,Maria,Robertson,Zimmerman Ltd,Bobshire,France,697-591-1231x62667,647.924.7139,snowsheryl@eaton-foster.com,2021-09-11,https://www.thompson.biz/
22-Jul-2021,Cash,00.00,"574,932.58","1,724,797.73",F7CC6aDE9C1ab59,2728,Darrell,Graves,Reilly-Finley,Andresbury,Latvia,0357494548,001-537-825-3575,pollardbeth@mclaughlin-harrison.com,2020-07-12,http://snow-liu.com/
22-Jul-2021,Miscellaneous,04.65,00.00,"1,724,802.38",0D4Ce960cb41d8f,3207,Jeffrey,Horne,Morris Ltd,Moyerland,Taiwan,928-090-1985x908,(941)878-9743x329,greghatfield@potter.com,2022-01-04,http://krueger.com/
22-Jul-2021,Transfer,00.00,"215,600.30","1,509,202.08",8F9e8A45A206a69,9292,Jackie,Wong,"Duran, Cortez and Mccullough",Lindseyland,Afghanistan,772-065-3283,892.689.9330x291,kathleenfranklin@cunningham.biz,2020-04-10,https://lyons.biz/
22-Jul-2021,Transfer,00.00,"754,601.04","754,601.04",F27d7bbcD560dAd,8227,Brandon,Frost,Spears PLC,Lake Michael,Bolivia,+1-394-629-0417x640,(838)378-4324,astrickland@chan.com,2022-02-11,http://www.watkins.info/
22-Jul-2021,Interest,"923,334.50",00.00,"1,677,935.54",61D4878C8c8A5dA,7018,Alan,Frank,Rosales-Solomon,Port Johnathan,Turkmenistan,(579)299-1628,001-702-188-5095x0627,madeline97@osborn-tyler.com,2020-08-27,https://bass-hinton.com/
22-Jul-2021,Commission,"226,877.78",00.00,"1,904,813.32",dfCE769cc1D18Ae,5084,Benjamin,Houston,"Holden, Trevino and Tate",South Diana,Lebanon,968-809-7996x98609,001-084-821-7290x686,rhonda21@herrera-glover.com,2021-06-09,https://grant-price.com/
22-Jul-2021,Tax,"1,868.06",00.00,"1,906,681.38",cB6700a0aBcdDD2,5329,Angela,Robertson,Kerr-Schaefer,Caitlinville,United States Minor Outlying Islands,+1-827-877-7887x618,3128707987,calhounpam@mcfarland-blankenship.com,2021-05-22,http://giles.com/
22-Jul-2021,Reversal,00.00,"238,335.17","1,668,346.21",1B9aFdF0f972f0B,967,Adrian,Deleon,Galloway and Sons,New Veronica,Tokelau,308-979-6674x159,+1-203-288-4514x54866,sstuart@duncan.com,2021-02-05,http://hines-ayers.biz/
22-Jul-2021,RTGS,467.37,00.00,"1,668,813.58",131deA972A35Fab,780,Cristina,Harrington,Sanders-Robinson,Phelpsburgh,Taiwan,+1-794-255-3288,+1-976-619-3450x172,noblejeffrey@frank.com,2021-05-07,https://www.stephenson.com/
22-Jul-2021,Debit Card,"1,879,505.25",00.00,"3,548,318.83",cD7a3fE5AffeFa8,4277,Tom,Bailey,King Inc,Lake Christineville,Iran,681-977-1685,904.773.9453,eduardo39@bass.com,2021-01-20,http://www.howe.com/
22-Jul-2021,Purchase,03.30,00.00,"3,548,322.13",5c68658b1cF974c,1233,Samuel,Rosales,Lewis-Frey,Mathewstad,Liechtenstein,+1-574-425-1980x868,001-201-402-1878,ugeorge@barrera.com,2022-05-12,https://www.hines.com/
22-Jul-2021,Transfer,51.97,00.00,"3,548,374.10",0443B62091eE499,7674,Steven,Alvarez,Rhodes Group,North Cassandrafort,Palau,0912957663,+1-033-642-6075x7167,allenclaudia@harper.com,2021-10-22,https://www.davis-hatfield.info/
22-Jul-2021,IMPS,04.40,00.00,"3,548,378.50",E8BB9D4dd4B7C81,7159,Shelly,Frederick,Roy LLC,South Willie,Kuwait,8393338488,305-242-5406x64099,sally53@valdez.com,2020-08-01,http://www.williamson.com/
22-Jul-2021,Interest,"1,388.16",00.00,"3,549,766.66",75b2C2659e8DDbD,3286,Alicia,Tate,"Baird, Stevens and Escobar",West Dorothy,Austria,001-394-196-0158x0380,6395208379,paulgarcia@castro-vang.org,2021-05-02,http://www.schmitt-lutz.net/
22-Jul-2021,Tax,388.00,00.00,"3,550,154.66",af9E08B0dDe8216,5800,Frederick,Bullock,Orozco-Hebert,Jefferytown,Djibouti,001-835-668-1766x550,001-834-882-8713x507,blankenshipdonna@beck-barron.com,2020-03-07,http://meadows.org/
22-Jul-2021,Cheque,00.00,"443,769.33","3,106,385.33",bcdD6B4B2c43B2c,9552,Daryl,Preston,Hale-Guerra,Port Manuelshire,Haiti,0447954955,001-718-224-5734x2788,jcortez@duarte-costa.net,2021-06-01,http://www.wolf.com/
22-Jul-2021,Transfer,02.00,00.00,"3,106,387.33",47d35349E691a5F,5306,Yvette,Roberson,Gregory Inc,Rossmouth,Holy See (Vatican City State),(665)501-9229x8851,(497)411-9460x821,emilygarner@wiley.net,2020-04-26,http://melendez.com/
22-Jul-2021,NEFT,07.00,00.00,"3,106,394.33",99fBA93ffF751Ba,9237,Aimee,Lucero,Andrade-Strong,Whitneyborough,Luxembourg,+1-223-760-6945x38566,180.548.2643,moonsara@benitez-nielsen.biz,2020-11-16,https://www.kirk.biz/
22-Jul-2021,Commission,00.00,"443,770.62","2,662,623.71",e9Fad5A0ad7f87F,3182,Claire,Wiggins,"Melton, Mercado and Browning",Johnstonmouth,China,+1-505-900-9095,957-177-4238x192,dmeza@cook.org,2021-11-28,https://henson-tyler.com/
22-Jul-2021,Cheque,01.00,00.00,"2,662,624.71",5fe1294Eee679cf,2437,Brad,Leblanc,Luna-Lozano,Port Diamondtown,Tajikistan,506-162-8927,952.433.9570x810,uhicks@arias.info,2021-12-17,http://www.kelley-acosta.biz/
22-Jul-2021,Purchase,"223,262.00",00.00,"2,885,886.71",CF00A8415C9c9FA,5143,Tim,Lowe,"Howell, Faulkner and Malone",Patrickville,Kenya,775-944-1786x4549,9619857515,nsilva@frazier.com,2020-08-30,http://www.fischer.com/
22-Jul-2021,Bill,07.00,00.00,"2,885,893.71",C9BF6C5dF2a6Bd5,4926,Duane,Poole,"Gonzales, Horn and Gonzales",Allisonbury,Tajikistan,(027)068-2008x548,658.848.5227,gavin22@harmon.biz,2021-06-14,https://www.aguilar.com/
22-Jul-2021,Tax,00.00,"480,982.29","2,404,911.42",E14dc5CfcD9A8a6,7783,Helen,Stuart,Pace Inc,Michelleshire,Aruba,+1-519-579-8348,134.819.8456x540,marisamorales@graham.com,2021-03-10,https://chavez.net/
22-Jul-2021,NEFT,00.00,"300,613.93","2,104,297.49",B1F3e2A8A7AF20E,9302,Elaine,Schultz,"Wyatt, Escobar and Valentine",South Joanna,Ghana,001-830-314-0088x3584,+1-284-126-3838x4670,noah24@dalton-keith.biz,2021-05-10,https://www.miranda.com/
23-Jul-2021,Transfer,22.41,00.00,"2,104,319.90",bd57BaAdcc701Ec,7232,Lynn,Juarez,Blevins-Hill,Drewview,Uganda,578.295.4229x285,001-226-505-7732,stewartnancy@franco-reyes.biz,2020-10-19,http://www.fuller.com/
23-Jul-2021,Purchase,00.00,"210,431.99","1,893,887.91",AB9a34a7165A6EA,9536,Bill,Lee,Grant-Barajas,Nobleville,Bulgaria,001-174-160-8875,(144)542-3729x092,shane22@lucas.com,2021-03-05,https://www.carr.com/
23-Jul-2021,Transfer,01.60,00.00,"1,893,889.51",Fb3Ec6A33af50D9,3384,Sue,Kidd,"Warren, Ward and Olsen",Johnsport,Tajikistan,287-075-5536,400.544.5039,robinewing@holt.biz,2020-09-06,http://hobbs.org/
23-Jul-2021,IMPS,"60,817.00",00.00,"1,954,706.51",68a17341d8242d4,6218,Anna,Rice,Faulkner-Boyer,Billymouth,Madagascar,(442)960-3423x8782,001-790-654-0861,brentedwards@riley-craig.com,2022-02-06,http://www.bullock.com/
23-Jul-2021,Miscellaneous,00.00,"390,941.30","1,563,765.21",31BA9c58e4FfCbc,3847,Alfred,Leach,Gaines LLC,Lesterbury,Guernsey,3510481774,784-014-9507,normanjohns@guerra-owens.com,2021-12-13,http://www.lane.biz/
23-Jul-2021,ATM,"202,900.03",00.00,"1,766,665.24",8CeaB2697903D9A,6036,Shaun,Alvarado,Villegas and Sons,Geoffreytown,Mayotte,001-449-923-2348x61639,9935465464,lindsayholt@durham-turner.com,2021-07-28,https://www.gonzales.com/
23-Jul-2021,Bill,00.00,"441,666.31","1,324,998.93",10d2A0Cf5d4E6a7,6725,Francisco,Stanley,Mclean-Armstrong,North Glennstad,Djibouti,+1-419-718-3106x2737,001-308-356-9216x74697,toniavila@mendez-frye.org,2020-10-26,https://coffey-navarro.org/
23-Jul-2021,ATM,00.00,"331,249.73","993,749.20",F090dcEF5D96CF9,7527,Andre,Ellison,Savage and Sons,Port Evanstad,Kenya,+1-636-914-8921,+1-519-081-6405x3006,yhuffman@dunn.com,2020-05-21,https://russo-cook.com/
23-Jul-2021,Commission,435.00,00.00,"994,184.20",5F4892bAcEfc3ff,1974,Phillip,Pollard,Kline and Sons,Port Caseytown,Kuwait,+1-761-873-8836x57095,(874)698-0951x57206,meghandalton@glenn-madden.biz,2021-04-02,http://www.wood.com/
23-Jul-2021,Purchase,00.00,"198,836.84","795,347.36",199d7c0dEbF3Fcb,1296,Kaitlin,Koch,"Benjamin, Mendez and Wyatt",Traceybury,Yemen,5985344385,0978320463,mistycopeland@rich.org,2020-11-13,http://mccormick.org/
23-Jul-2021,Reversal,598.00,00.00,"795,945.36",82C79DBCBee9d52,7806,Meredith,Poole,"Bean, Mathews and Snyder",Blakeborough,Philippines,335.530.1828x2229,001-829-674-4119x29219,sweaver@faulkner-lloyd.org,2021-10-09,https://www.watts.org/
24-Jul-2021,ATM,"211,418.09",00.00,"1,007,363.45",D205c557ccD3Cca,4201,Wanda,Harrington,Ellis-Hinton,Priscillabury,Antigua and Barbuda,756.373.8446x85575,874-750-5686x34296,hardinglawrence@howe.biz,2020-11-18,http://www.campbell.com/
24-Jul-2021,RTGS,00.00,"125,920.43","881,443.02",6aC914F1D8eF9Dd,2959,Jose,Miller,Mata and Sons,North Darren,Bosnia and Herzegovina,(158)705-9522x763,576.408.6477,joyce24@ewing.com,2021-06-04,https://green.com/
24-Jul-2021,Commission,48.60,00.00,"881,491.62",7a7de0A6AF47cc7,6027,Victoria,Reeves,Mccarty LLC,North Samuelshire,Singapore,+1-119-772-8316x07490,(821)252-9527x62170,steve98@henson.com,2022-04-04,https://mckay-cooke.com/
24-Jul-2021,Bill,00.00,"97,943.51","783,548.11",D7Ba0FBF04dAd2f,8147,Gregory,Mitchell,Mercado-Rivas,Hendricksview,Monaco,001-675-333-8549x671,001-951-808-2242x12075,zwaters@conley.com,2020-03-24,https://wu.com/
24-Jul-2021,Reversal,00.00,"130,591.35","652,956.76",B335254C5C2a481,9839,Garrett,Barrett,Weeks-Molina,North Sonyashire,Macedonia,(227)988-7586x3407,601.901.9968,isaiah94@malone.net,2022-05-05,https://www.duffy.info/
24-Jul-2021,Miscellaneous,361.00,00.00,"653,317.76",D43Da0A148BB14D,1717,Haley,Lawson,Ayala-Mcgrath,Earlshire,Finland,001-980-074-3637,(220)206-3082x6175,schaefergerald@hill.net,2022-03-26,http://stanton.com/
24-Jul-2021,Debit Card,"592,745.20",00.00,"1,246,062.96",c4f04892ee673bE,7252,Melvin,Jenkins,"Mccarty, Browning and Mclaughlin",Port Theodoremouth,Mayotte,001-740-236-4310x0088,308.514.0641x585,marisanewman@drake.com,2022-04-17,https://www.phillips.com/
24-Jul-2021,ATM,06.00,00.00,"1,246,068.96",2cd3cEBb3Bb9c3f,9816,Nina,Boyer,"Brady, Lynn and Gallagher",South Kathryn,Saint Vincent and the Grenadines,738.100.5607x3601,190-674-6921x29242,jasmin50@sanders.info,2021-09-10,http://mckay.com/
24-Jul-2021,IMPS,00.00,"249,213.79","996,855.17",FB06767cA80E975,5441,Sandra,Velazquez,Thomas-Underwood,South Tinaland,Anguilla,001-434-070-5507x1100,(216)886-7411x16373,bill28@petersen.biz,2020-07-26,https://www.trujillo-pittman.com/
24-Jul-2021,IMPS,"58,271.00",00.00,"1,055,126.17",49c9b3729D9040E,2263,Yvonne,Brady,Beck-Horn,Lake Williamview,Jamaica,(747)560-0698x96034,6231911240,lucas26@livingston.biz,2020-04-02,https://anthony-kidd.com/
24-Jul-2021,Miscellaneous,"11,627.70",00.00,"1,066,753.87",1FecbF9E0ffc5c4,558,Stuart,Schmitt,Hampton-Irwin,Ronniebury,Nepal,001-545-448-6968,255-819-0538,hlowe@morse.com,2020-06-21,https://www.murphy.com/
24-Jul-2021,NEFT,"3,249.70",00.00,"1,070,003.57",CbE7a1f6b80aD88,2467,Shelley,Hurst,"Delgado, Gonzalez and Snow",Port Lacey,South Africa,489.450.8045x10259,001-043-278-3528x85971,brittneynixon@cochran.com,2020-01-17,http://calhoun-cochran.com/
24-Jul-2021,Bill,261.90,00.00,"1,070,265.47",f7bfAA2d5fbBe6e,4569,Jamie,Choi,Greene PLC,Deniseton,Turks and Caicos Islands,412.511.2730,(051)704-2695,jrandall@chung.com,2021-06-23,http://lee.com/
24-Jul-2021,Debit Card,"1,766,479.50",00.00,"2,836,744.97",866e9747fe66d01,2712,Sandy,Glenn,Peck PLC,Robbinsside,Georgia,699.349.5212x3928,001-537-946-0673x7176,sturner@brennan.com,2021-04-04,https://garza.net/
24-Jul-2021,Cash,00.00,"709,186.24","2,127,558.73",a8a11BD403b3c7E,7506,Amber,Mercado,"Hubbard, Choi and Sexton",Hobbsfort,Sierra Leone,001-413-805-6599,(851)260-5466,ernestwebster@paul.com,2021-07-10,http://www.bridges-zavala.com/
24-Jul-2021,Debit Card,00.00,"303,936.96","1,823,621.77",3FDaAab7c3Ae621,8076,Beverly,Hunter,Cooper-Jennings,Craigtown,Botswana,001-073-574-8178,+1-812-908-4666x36569,margaret16@blevins.com,2020-11-23,http://www.sampson.com/
24-Jul-2021,Purchase,432.70,00.00,"1,824,054.47",0A3b2f5F057B9FD,6010,Eddie,Mccormick,Bailey Ltd,Lake Jesusville,United Arab Emirates,(285)504-4426,001-104-343-3432x981,andrewsherman@davis.com,2021-01-01,http://www.hartman.com/
24-Jul-2021,Transfer,54.50,00.00,"1,824,108.97",bAafe856dACBDfA,4086,Frank,Waller,Dudley PLC,South Kristenland,Thailand,8913234157,001-161-221-1305x84614,jody12@armstrong.org,2020-06-02,https://www.george.org/
24-Jul-2021,ATM,13.00,00.00,"1,824,121.97",6f6C9a2fc5b45dA,7234,Billy,Stuart,Dodson-Baird,Ronnieburgh,Saint Lucia,(644)771-8029x2158,+1-332-581-5444x6938,landrymario@vance.com,2022-05-29,http://www.schmidt.com/
24-Jul-2021,NEFT,30.00,00.00,"1,824,151.97",afcACDAae7ae7cC,6951,Bob,Bonilla,Sawyer-Acevedo,North Terrance,Barbados,+1-954-175-5823x340,(987)517-1030,opalmer@cooke.net,2020-11-14,http://www.ray-cochran.com/
24-Jul-2021,Reversal,"22,989.75",00.00,"1,847,141.72",fE18b60F48DB50c,1824,Drew,Benson,Pittman PLC,Port Hectormouth,Lithuania,(104)809-3951,+1-211-855-5357x6865,ferrellmarc@mata-lindsey.info,2021-06-15,http://www.moran.org/
24-Jul-2021,Purchase,00.00,"230,892.72","1,616,249.00",Da1ad9A4F7AF6c6,6514,Melanie,Ortega,Cox-Shepherd,Bonnieview,Guam,(193)065-2728x320,001-784-256-1124x8941,vangross@wolfe-mccarty.com,2021-02-19,http://cooper.com/
24-Jul-2021,Tax,00.00,"161,624.90","1,454,624.10",e15D55C13FAdf5a,5078,Jackie,Wall,Byrd Group,Lake Rose,United States Virgin Islands,+1-252-797-2835,001-119-054-9746,cervantesraven@wallace.com,2020-05-26,https://molina-case.net/
24-Jul-2021,Miscellaneous,00.00,"290,924.82","1,163,699.28",8AcC9306b4cC5cE,7615,Ann,Choi,Robinson PLC,West Franklinport,Benin,263.114.7795,(829)532-5397,veronicabender@norman-goodwin.com,2021-09-26,http://avery.com/
24-Jul-2021,Transfer,106.00,00.00,"1,163,805.28",f9D7078c2fcBF22,4495,Tiffany,Marquez,Delacruz LLC,Lopezchester,Bermuda,916.283.8999x647,1873433604,adrienne07@choi.com,2021-03-07,http://cooley.org/
24-Jul-2021,Transfer,"23,008.51",00.00,"1,186,813.79",a33b28aa3bF9873,4500,Joy,Greer,Cortez-Mullen,New Jose,India,779.757.2983,001-575-151-7382x163,spencebianca@simmons-wagner.net,2020-07-28,https://henson.info/
24-Jul-2021,Purchase,00.00,"593,406.90","593,406.90",7fAa8D9Ef4765b7,4884,Mikayla,Myers,Prince Inc,Hollandfurt,Canada,757.100.3585x811,5894232573,genefarley@santos.com,2020-07-09,http://www.bonilla.com/
24-Jul-2021,Bill,00.00,"197,802.30","395,604.60",62153ef9c0Dfe01,9508,Ernest,Haynes,"Mccall, Downs and Hunt",Port Dorischester,Panama,834-570-1996x2860,4481404330,sheliahogan@villarreal.com,2020-04-14,http://www.juarez.com/
24-Jul-2021,Cash,00.00,"43,956.07","351,648.53",bA8addb8ABfbEAF,3849,Brent,Valdez,"Knight, Horn and Reed",West Xavier,San Marino,214-956-3703x0855,+1-318-423-0812,jillthornton@hardin.com,2020-03-20,https://mcknight-gilmore.com/
24-Jul-2021,Cash,67.37,00.00,"351,715.90",7805fEeb3BdCBE6,8444,Tracie,Cortez,Woodward Ltd,Bradleyburgh,Iran,820-962-3195x474,+1-040-250-4230x3286,joneskathleen@christian.com,2020-01-21,http://huerta.com/
24-Jul-2021,RTGS,04.70,00.00,"351,720.60",9120baedaea06d9,9612,Roberto,Villa,"Graham, Riley and Sanchez",Lake Rachel,Western Sahara,(728)312-8376x0769,001-381-436-3032x198,janice47@gross.com,2021-09-01,https://www.arnold.com/
24-Jul-2021,IMPS,00.00,"70,344.12","281,376.48",bbf46abB7D7DF3F,2334,Donna,Gallagher,Newton-Chase,West Preston,Marshall Islands,+1-496-537-5768x74388,+1-197-607-3570x236,gatesdebra@richards.org,2020-02-12,https://gross.com/
24-Jul-2021,Debit Card,00.00,"31,264.05","250,112.43",eeFaFbEf151cAcC,1547,Karina,Blackburn,"Gentry, Weiss and Velez",Lake Olivia,Montserrat,001-900-197-5763x98762,372-792-8329x60243,timfreeman@taylor-velez.com,2020-06-08,http://mcconnell.org/
24-Jul-2021,IMPS,00.00,"125,056.22","125,056.22",915eA9bc44EE88e,3362,Karla,Howard,"Cole, Jacobs and Holland",Lake Devin,Ireland,+1-289-347-5242x623,237.328.5832,heidi14@hanson.com,2021-06-29,http://www.jordan.com/
24-Jul-2021,NEFT,216.69,00.00,"125,272.91",27980Ea6fDfe0ed,2080,Belinda,Buckley,"Joseph, Fritz and Lin",Port Joan,Angola,(288)504-2804,392.031.9185x31100,ihensley@buck.com,2020-02-06,http://www.long-strong.com/
24-Jul-2021,Purchase,00.00,"13,919.21","111,353.70",e8C814720B065b3,5040,Jon,Bradshaw,Mathis-Houston,Alexisstad,Zambia,001-543-454-8025x287,(462)648-9874,zhouse@carter-vaughn.biz,2020-09-16,http://www.kline-buchanan.biz/
24-Jul-2021,NEFT,"3,314.00",00.00,"114,667.70",E3FC40625F4318f,1455,Luis,Booker,Spence-Ballard,North Chelseychester,Central African Republic,868.292.4980x115,176.668.7577,tdorsey@short-hardy.com,2020-12-30,http://www.kelley.com/
24-Jul-2021,IMPS,00.00,"11,466.77","103,200.93",ba71bf712Ba06B3,9158,Jody,Odom,Mooney-Ali,Lake Caseyburgh,Solomon Islands,329-025-9011x3344,107.375.8234x93258,joanne71@payne.com,2020-05-08,http://leblanc.net/
24-Jul-2021,Bill,00.30,00.00,"103,201.23",3bde170d4Be6b91,8295,Jo,Mckinney,Padilla-Riddle,Tonyburgh,American Samoa,239-623-1250,(353)883-4443x349,orandolph@russell.com,2020-10-08,http://www.todd.biz/
24-Jul-2021,Debit Card,"2,815.00",00.00,"106,016.23",4E2A194a47c3C94,223,Holly,Ford,Walker Group,Mcgeemouth,India,674-359-8368x3113,001-386-467-9110x19533,sabrinaerickson@wise.info,2020-09-10,http://odom.info/
24-Jul-2021,Purchase,00.00,"35,338.74","70,677.49",C68542ae05DAC48,85,Dillon,Gallegos,Lindsey LLC,Port Jon,Macao,836.527.9927x34601,056-265-8970x614,escobarisabella@harrell-santiago.info,2020-10-13,https://kirk-skinner.com/
25-Jul-2021,ATM,00.00,"8,834.69","61,842.80",2C8fD3b5b9B9Fa3,8892,Patricia,Byrd,Aguilar-Mckay,New Corey,Monaco,(865)674-4330x677,(879)602-2338,uguerrero@oconnor-hutchinson.biz,2022-01-12,https://bender.org/
25-Jul-2021,Tax,168.00,00.00,"62,010.80",eF6db5b6C33Cad3,9168,Lisa,Schultz,Cochran-Wiggins,West Janeshire,Costa Rica,001-754-068-5069x13673,+1-370-374-5127x263,mccartyrickey@jennings.com,2021-05-08,http://dudley.com/
25-Jul-2021,RTGS,00.00,"20,670.27","41,340.53",c927E6840FF4A0c,310,Angie,Navarro,Howell Group,Dianeborough,Namibia,1861519660,725-519-2910x288,kirstennicholson@terrell.com,2021-10-15,http://www.gentry-barnett.net/
25-Jul-2021,Tax,"28,672.00",00.00,"70,012.53",bBB6Bb4194361cC,122,Holly,Fletcher,Ford and Sons,Newmanbury,Thailand,001-583-336-8021x57385,+1-072-547-1221x03876,pammorales@james-benjamin.net,2021-03-17,http://werner.org/
26-Jul-2021,Transfer,00.00,"11,668.76","58,343.78",28222e5eF08907A,5416,Carol,Hull,Watkins-Mathews,South Haydenville,Uruguay,001-184-488-0831x41687,347.336.1982x72951,agould@joyce.info,2021-12-04,https://whitney.biz/
26-Jul-2021,NEFT,19.41,00.00,"58,363.19",C6CFa8FFA0E1aEf,4822,Lydia,Mathews,Young-Walton,Kerriland,Finland,378.642.4420x851,227-370-1671,claire32@rollins.org,2020-01-20,https://burgess.info/
26-Jul-2021,Cash,00.00,"6,484.80","51,878.39",ae37F41D3CDd82d,1731,Kelli,Barron,"Gray, Contreras and Ball",Angelicatown,Macao,128.189.6323x5170,074-693-6371x208,trevor78@beltran.biz,2020-10-09,https://sloan-valencia.com/
26-Jul-2021,Cheque,00.00,"12,969.60","38,908.79",E446B0e1dbCAbBb,2857,Micheal,Morse,Zuniga-Bowers,Port Connorshire,South Georgia and the South Sandwich Islands,(907)452-4470,6816401499,icastro@petersen.net,2021-03-25,https://haley.com/
26-Jul-2021,Miscellaneous,00.00,"9,727.20","29,181.59",Ba6BBBeEEfB0F8b,8869,Priscilla,Gay,Ball Group,Chloehaven,Vanuatu,(479)839-1167x978,856.328.4564x5032,lawrence85@andersen.net,2021-06-02,http://www.cole.net/
26-Jul-2021,Purchase,00.00,"4,863.60","24,317.99",BC2D982aaebF8B1,2935,Regina,Cline,Rojas-Chambers,North Devonport,Jersey,457.702.4570,+1-566-463-2304,dickersonmichaela@haas.biz,2022-03-15,http://www.atkinson-ashley.com/
26-Jul-2021,ATM,03.39,00.00,"24,321.38",65BD5BB3D018adE,1760,Jim,Holt,"Mccarthy, Baldwin and Gardner",Paulaside,Liechtenstein,(748)367-5510x16011,(681)176-1774x7373,andrew95@lopez-arias.com,2021-04-26,https://beasley.com/
26-Jul-2021,Debit Card,00.00,"4,864.28","19,457.10",4975BF68A04B6eb,1420,Samuel,Steele,Ryan Inc,Christianstad,Nauru,886.951.6541x15376,(681)287-6246x847,clineclifford@cooke.com,2020-03-04,http://good.com/
26-Jul-2021,RTGS,00.00,"4,864.28","14,592.82",8Bb66a004b0BF0a,1309,Robin,Potter,"Chan, Waller and Chaney",Mathisport,San Marino,001-826-813-6429x3891,167.586.0435x946,freemantravis@norman.net,2021-01-19,https://torres-medina.com/
26-Jul-2021,Tax,00.00,"2,084.69","12,508.13",eacDB369CAbc5b9,5704,Becky,Herman,Conner-Martinez,Rachelstad,Syrian Arab Republic,418-049-0238x8780,307-377-5904,cathygonzales@rodriguez.com,2020-03-11,http://vasquez-hampton.com/
26-Jul-2021,Bill,361.70,00.00,"12,869.83",da5EaDa38dEBEAC,5077,Roger,Marsh,Long LLC,Richmondville,Austria,001-621-846-5849x8063,(472)082-0334x092,don06@hickman.com,2020-11-22,http://bauer.com/
26-Jul-2021,Miscellaneous,00.00,"12,869.83",00.00,15ffA1e0cC8cAf3,6986,Stephen,Farmer,Woodard-Salas,East Breanna,Saudi Arabia,677.912.7740,(459)762-2207x616,lewisallison@fields.net,2022-02-02,http://www.norris.com/
26-Jul-2021,NEFT,686.00,00.00,686.00,74a0FbE33f348DC,4501,Alexander,Craig,Mcgrath LLC,Marksside,Somalia,9984768790,(631)391-7340x8150,dhendricks@cameron.info,2020-10-07,http://www.simmons.com/
26-Jul-2021,Reversal,00.00,68.60,617.40,fDB04FeA7885FAA,1024,Walter,Braun,Mann-Olson,West Leon,Botswana,(664)661-7265x74499,509.165.1431x34753,woodardjudith@lee-valenzuela.com,2020-07-21,https://www.calhoun.com/
26-Jul-2021,Tax,07.50,00.00,624.90,5aFAadaE373EbFD,7172,Kellie,Golden,"Johnson, Byrd and Wilkerson",Schmidtside,Madagascar,(873)617-6107x8721,150-234-8604,landryevan@shannon.net,2020-10-09,http://mendez.com/
26-Jul-2021,RTGS,00.00,208.30,416.60,28F79B7eEc472BE,3190,Erik,Meyer,Garcia Ltd,East Spencerstad,Maldives,487.045.1380x81711,930.328.9453x97098,kelliemcgee@burke-henderson.com,2020-02-05,http://www.calderon.biz/
26-Jul-2021,Debit Card,62.00,00.00,478.60,61Def6a01D0371b,6410,Shaun,Blair,Henry-Le,North Teresaport,Belarus,001-405-242-9720,833-009-5398,frankrobin@trevino.com,2022-05-16,https://hobbs-rosales.com/
26-Jul-2021,Cash,"19,630.00",00.00,"20,108.60",2d2E8e0fE60Cd74,9742,Stacey,Deleon,Fletcher LLC,Garnerfurt,Malawi,+1-528-620-6362x4202,001-086-873-3510x59114,erik33@wilson.info,2020-11-30,https://www.cook.com/
26-Jul-2021,ATM,00.00,"6,702.87","13,405.73",E46e5aC532db578,1470,Roberta,Underwood,Lambert Inc,Prestonville,Antarctica (the territory South of 60 deg S),1457391664,(581)091-6999x3420,steven99@acosta.org,2022-05-06,http://mclean.com/
26-Jul-2021,RTGS,"30,188.00",00.00,"43,593.73",BE352a8cB4F8d86,347,Bridget,Porter,Wyatt Group,Levinehaven,Uganda,266.436.0582x2195,001-165-696-3031,buckleyperry@herring.com,2020-03-06,http://roberson.info/
26-Jul-2021,Debit Card,"118,586.00",00.00,"162,179.73",f8e9987B620cCcb,4247,Amber,Simon,Lynch-Wilcox,North Meganview,Guinea-Bissau,855.449.4884x5481,001-934-722-7319,mitchellvernon@wilkins.org,2021-10-21,http://www.boone.com/
26-Jul-2021,Commission,00.00,"23,168.53","139,011.20",68B1F3DBbE09DF2,5186,Kristine,Hensley,Lawson Inc,Brewerbury,Senegal,001-828-991-0429,689.044.5282,tamara74@ryan.com,2022-05-11,https://www.farley-norris.com/
26-Jul-2021,Debit Card,211.00,00.00,"139,222.20",1C990dbadbfD3e9,8071,Susan,Strickland,Barrett-Beltran,Beverlyhaven,Mongolia,386-413-2051,+1-035-889-5524x2382,rushsheena@brady-luna.com,2021-08-13,https://www.peck-medina.info/
26-Jul-2021,Tax,134.20,00.00,"139,356.40",84e2381cDDB5CD7,9138,Ryan,Weeks,Tanner-Mcintosh,South Joshuachester,Kenya,632.337.0482x287,(957)742-1493x3057,vrichards@mclaughlin.net,2020-11-25,https://www.compton.com/
26-Jul-2021,RTGS,00.00,"23,226.07","116,130.33",Fd09AA3c0E32cCf,456,Logan,Dickerson,Arnold Ltd,Lake Robin,Heard Island and McDonald Islands,(706)788-7595x22855,948.876.9672,rachael73@spencer.com,2021-08-13,http://www.hamilton.com/
26-Jul-2021,IMPS,00.00,"12,903.37","103,226.96",aE668eef7Fd4B2B,3573,Edward,Beard,"Stanton, Reed and Johns",Port Ann,Cook Islands,462-097-3557x5942,001-633-325-6977x4692,jillian34@cowan.com,2020-10-04,https://le-chen.info/
26-Jul-2021,Debit Card,00.00,"11,469.66","91,757.30",4c33F39aDf59BBe,7430,Brenda,Nolan,Mathews-Mann,West Leahville,Swaziland,7169261377,048-670-5679x86400,hendricksglenn@pena.com,2020-04-08,https://www.chapman-wu.net/
26-Jul-2021,IMPS,00.00,"22,939.33","68,817.98",Ea49DA23fbff14E,2942,Emily,Cook,Black Inc,Frederickbury,Belarus,+1-705-087-6661x4505,8252275486,gregstewart@torres.biz,2022-01-29,https://matthews.net/
26-Jul-2021,Bill,54.00,00.00,"68,871.98",ccfef3Ba9CDc44a,5900,Mathew,Mckee,"Shaw, Long and Perry",Osbornechester,Guatemala,3660591639,855-366-0889x3343,lisabarber@webster.com,2020-07-08,https://www.welch-cooley.com/
26-Jul-2021,Interest,00.00,"68,871.98",00.00,FAa3224ddbdE48c,8314,Cameron,Olson,"Hobbs, Hartman and Graves",South Seth,Luxembourg,+1-931-097-3543,+1-477-067-7089x2613,karen91@huffman-montgomery.com,2022-02-12,https://jarvis.net/
26-Jul-2021,Transfer,06.00,00.00,06.00,6E5DABCBb2ABfA4,4355,Kenneth,Reid,Dawson-Herrera,Port Karen,Belarus,359.174.2570,718.019.0814x0956,paula22@nielsen.com,2021-10-22,http://lucero.net/
27-Jul-2021,Miscellaneous,"2,533.00",00.00,"2,539.00",C94FffbA5B72344,9396,Francis,Morse,"Briggs, Mercado and Callahan",Port Travischester,Germany,824.599.6723x86192,+1-727-398-7646x7556,tlevine@duran.com,2020-05-14,http://willis.org/
27-Jul-2021,ATM,00.00,846.33,"1,692.67",aA9510Ed57523Aa,8535,Hailey,Molina,Jarvis-Harvey,North Lance,Chad,7782175209,465.305.2784x0731,faithrandall@randall-walsh.com,2021-10-09,http://mclaughlin.com/
27-Jul-2021,RTGS,288.80,00.00,"1,981.47",f87EFE82BF178e0,9001,Rebekah,Lutz,Bryant-Nixon,Port Bradland,Croatia,+1-705-783-9895x11265,415.094.8680x789,walshtraci@bishop.com,2020-02-27,http://www.warren.biz/
27-Jul-2021,RTGS,00.00,"1,981.47",00.00,59dbfFCdc0fBEC4,1602,Breanna,Bush,"Pennington, Galvan and Neal",Cristinastad,Liberia,001-476-026-4388x00576,192-295-0587,xberg@phelps.com,2020-05-24,https://little-mercado.biz/
27-Jul-2021,RTGS,"64,481.59",00.00,"64,481.59",080d64e37586bDA,2172,Madeline,Cortez,Walsh-Bass,Lake Joanna,Vanuatu,155.703.5825x06726,+1-422-720-2893x72069,kristiegarza@english.com,2021-01-20,https://malone.com/
27-Jul-2021,ATM,12.00,00.00,"64,493.59",3A9eFaCe6efbaEd,1194,Cesar,Mcfarland,"Watkins, Ramirez and English",Reeseville,Eritrea,555.452.0608x620,152.543.4419,darrenespinoza@conner.info,2020-02-16,http://tucker-hull.com/
27-Jul-2021,RTGS,386.40,00.00,"64,879.99",C3C3a9b3B9cdB36,7068,Warren,Pittman,"Morgan, Sandoval and Irwin",Frederickview,Faroe Islands,+1-841-152-7050x20247,001-604-868-8684x345,alisonbrady@carson.com,2020-05-09,http://www.calhoun.net/
27-Jul-2021,Debit Card,101.88,00.00,"64,981.87",8759A65B1E17F23,6372,Sierra,Villanueva,Kline-Duke,New Veronicaburgh,Estonia,+1-787-508-8115x41048,759.250.4432x28133,mallory14@lang.biz,2020-06-19,http://mcmillan.com/
27-Jul-2021,Reversal,00.00,"8,122.73","56,859.14",fe8D20bAdFBBE8F,9257,Kristin,Downs,Collier-Graham,Lake Rodney,Greece,+1-441-040-9009,327.015.8719,ydudley@sparks.info,2022-03-13,https://bray-mayer.com/
27-Jul-2021,Purchase,00.00,"9,476.52","47,382.62",a88f50a26639aC7,2138,Ana,Martin,Arroyo-Mejia,Leslieland,Austria,001-693-235-6846,271-611-7047x9334,jeffsimpson@shannon-singh.biz,2021-05-20,http://www.abbott-choi.com/
28-Jul-2021,NEFT,"3,514.20",00.00,"50,896.82",Bcc2aB11725a6aD,5903,Jared,Dudley,Ramos PLC,Lake Grantbury,Madagascar,7561803074,584-206-7618x3144,williamsnicolas@vaughan.com,2020-06-16,http://drake.com/
28-Jul-2021,Bill,302.30,00.00,"51,199.12",1EBeA37d789b7fa,7113,Cathy,Rivers,Clarke-Trevino,Staceybury,Kiribati,(480)412-0451x7728,353.653.3248,mmoon@washington.com,2022-01-21,https://flowers-rodgers.com/
28-Jul-2021,Reversal,00.00,"7,314.16","43,884.96",74dEEbe0CFB7E85,2200,Emily,Morris,Berg-Crane,Mcneilburgh,Greece,(449)630-0712x064,341-640-4767x8014,breanna29@lucero-hunt.com,2022-04-27,https://www.dixon.com/
28-Jul-2021,Purchase,00.00,"7,314.16","36,570.80",4a9A0ea1cE7e0ed,6346,Eugene,Hogan,"Cuevas, Mckee and Washington",North Lawrence,Belarus,5805170536,001-697-897-7082,phyllis65@cunningham.com,2020-11-08,http://www.carey.com/
28-Jul-2021,Reversal,00.00,"4,571.35","31,999.45",65A708CD553C312,9644,Wesley,Nash,Tyler-Nolan,Wagnerport,Norfolk Island,001-941-319-3467x52638,(612)488-1258x05622,holtlarry@griffith.com,2021-03-13,https://schwartz.biz/
28-Jul-2021,RTGS,00.00,"31,999.45",00.00,83F0B1D11A63aEB,7284,Ellen,Mcintosh,"Schroeder, Ramirez and Parker",Cynthiastad,Croatia,001-443-067-2044x65930,+1-051-015-0774x924,mullinstyrone@henry-weber.com,2020-06-06,https://www.winters.com/
28-Jul-2021,ATM,03.90,00.00,03.90,1DeA9ff7bC60be0,9238,Mindy,Ball,"Avery, Robbins and Ross",Perryburgh,Saint Martin,001-571-725-7413,+1-650-907-8691x23600,kbrooks@meyers.com,2020-07-11,https://www.white-burton.com/
28-Jul-2021,Bill,"4,098.70",00.00,"4,102.60",7bdFAaBe3AaC164,7589,Lance,Espinoza,Hernandez-Howe,New Eduardoside,Zimbabwe,850-311-9611,(589)459-4907x6391,cesarcole@barajas.com,2021-07-12,http://www.gill-dorsey.org/
28-Jul-2021,Debit Card,02.00,00.00,"4,104.60",ac43B4eC675bE87,7041,Crystal,Pope,"Rojas, Hughes and Hancock",Derekfort,Martinique,528.721.0567x046,+1-649-118-2901x534,vincentthornton@key.org,2022-02-26,https://www.hayden-farmer.com/
28-Jul-2021,Cheque,266.00,00.00,"4,370.60",ea4F7CFc260e1E8,8471,Cole,Medina,Bright PLC,Whitneychester,Gibraltar,001-769-675-1733,2758017150,sarawyatt@lawrence-stone.com,2021-02-27,https://www.ochoa.com/
28-Jul-2021,Cheque,00.00,485.62,"3,884.98",dD23773A34D391A,9003,Jody,Hess,Holland LLC,Seanmouth,Moldova,884.222.6470,2703437843,vwalker@arias-alexander.com,2021-02-18,http://phelps-mcdonald.com/
28-Jul-2021,Purchase,00.00,777.00,"3,107.98",C9aC017Ce8d80cd,3993,Derek,Hanna,Reyes-Mclean,Donaldsonmouth,Italy,960-818-4763,001-723-343-8833x4906,erikweiss@bauer-jones.com,2021-11-25,http://oneill.info/
28-Jul-2021,ATM,"16,522.00",00.00,"19,629.98",4B58cDF6137BBfC,6548,Devin,Robbins,Walker LLC,Lake Kurt,Bhutan,+1-182-227-8518,+1-291-840-7811x973,shawnmccann@ayala.org,2021-07-14,https://www.briggs.biz/
28-Jul-2021,Debit Card,533.75,00.00,"20,163.73",9EaA8Bc67cfeDA2,6872,Francis,Cain,Owen PLC,Savageside,Macao,257-046-7681,001-222-135-7105x895,maddenlatoya@dyer-krueger.com,2020-09-01,http://www.sherman-curry.com/
28-Jul-2021,Reversal,"2,693.00",00.00,"22,856.73",A2Eb5DdD516FAE8,7413,Janice,Mccall,Terry-Mayo,South Rileychester,Algeria,(926)067-2619x2922,+1-841-915-4878x4303,adrienne69@ali-meza.com,2020-06-08,https://www.price-meza.com/
28-Jul-2021,Cheque,04.15,00.00,"22,860.88",5B7DfFF7cBF76AA,873,Daryl,Bernard,Mccarty LLC,New Dillonstad,Jordan,+1-311-382-3733,786-745-7786x63827,pbrandt@malone.com,2020-04-18,https://www.blackburn-kline.com/
28-Jul-2021,Transfer,00.00,"3,265.84","19,595.04",4FfEDAb1aCCB99F,7287,Robert,Edwards,"Bradley, Fields and Choi",Camachobury,Slovakia (Slovak Republic),821-390-0091,+1-905-586-7428x6693,bianca29@barker-hansen.com,2020-07-11,http://copeland.info/
28-Jul-2021,Reversal,"299,243.00",00.00,"318,838.04",CB5a8Da7d4aA15a,7648,Daryl,Booker,"Buck, Alexander and Bond",Gambleborough,Guinea,+1-449-294-9516x1186,257-614-1964,soniasexton@smith-frank.net,2021-11-10,http://www.waller.info/
28-Jul-2021,Bill,00.00,"53,139.67","265,698.37",Fcd97F87Bd9d9a6,7005,Maxwell,Kidd,Huffman-Lynn,Hermanshire,South Georgia and the South Sandwich Islands,736-203-8124x4364,1441592621,gileselijah@arnold.com,2020-04-27,http://navarro.info/
28-Jul-2021,IMPS,146.40,00.00,"265,844.77",aE668eef7Fd4B2B,3573,Edward,Beard,"Stanton, Reed and Johns",Port Ann,Cook Islands,462-097-3557x5942,001-633-325-6977x4692,jillian34@cowan.com,2020-10-04,https://le-chen.info/
28-Jul-2021,Reversal,"316,084.00",00.00,"581,928.77",D06C1E2ee9Da8FD,5837,Lorraine,Hull,"Gay, Hardin and Andrade",West Arianahaven,Grenada,+1-325-434-6592x8428,(920)569-4593,mcgrathbetty@perkins.net,2021-09-01,http://www.zamora-gutierrez.com/
28-Jul-2021,Interest,00.00,"193,976.26","387,952.51",E7e3702F2871950,7074,Mark,Carter,"Marks, Braun and Cohen",South Baileyshire,Saint Kitts and Nevis,001-092-286-2391x8307,1548135688,isabelcarr@chavez.org,2020-09-04,https://paul.com/
28-Jul-2021,ATM,00.00,"77,590.50","310,362.01",888AD00c3adA31a,512,Maxwell,Hall,Holder Group,Meyerport,Switzerland,591.561.9168x18835,969.738.0402x305,fnichols@ho-robinson.net,2020-12-05,https://www.tate.net/
28-Jul-2021,Bill,00.00,"51,727.00","258,635.01",C7CCFbb532b1d8a,4850,Ashlee,Barrera,Alexander LLC,New Christian,Lesotho,444-515-5780,(874)060-9035x991,sandy33@walker.com,2020-04-08,https://lozano.com/
28-Jul-2021,Reversal,"1,838,039.20",00.00,"2,096,674.21",1ef11BfBaF0d2D0,5783,Cory,Rubio,"Blair, Watson and Newton",Lake Karlshire,Honduras,001-366-733-3066x1097,857.524.1575x984,howejulie@ortega.com,2021-06-06,https://adams.net/
28-Jul-2021,Miscellaneous,00.00,00.00,"2,096,674.21",c481C6D7Bc67E1E,794,Charles,Bradshaw,Mcdowell PLC,Thomastown,Benin,(383)738-7485,644.874.5744,avasquez@kidd.net,2020-02-18,http://gibson.com/
29-Jul-2021,Cash,"13,332.57",00.00,"2,110,006.78",f721e7cAFE8b44f,3385,Dustin,Frank,Guzman Group,Farrellborough,Mongolia,001-409-070-8416x01279,(939)495-1309,legina@roman.info,2020-09-10,http://pittman.com/
29-Jul-2021,RTGS,00.00,"2,110,006.78",00.00,BA880CAeF9bcCe2,4263,Preston,Adams,"Oconnor, Brown and Nash",Debraview,Costa Rica,7566662510,5103729025,kirstenberger@strong-wallace.com,2021-09-15,https://parrish-cunningham.com/
29-Jul-2021,Bill,40.10,00.00,40.10,6a47f2048bFA341,9512,Wyatt,Peterson,Meza and Sons,Schwartzshire,Tajikistan,+1-998-196-2356x119,789.942.0141,barkercraig@lynn-barajas.net,2021-09-14,http://www.palmer.com/
29-Jul-2021,Miscellaneous,"143,966.00",00.00,"144,006.10",F729b1CDeCC0caf,7581,Sonya,Small,"Coffey, Oconnell and Higgins",West Levi,Timor-Leste,+1-004-040-9857x708,713.106.4135,liugavin@ballard-lyons.com,2021-07-09,https://www.morrow.com/
29-Jul-2021,Interest,00.00,"28,801.22","115,204.88",FA40E012DDc1cfd,517,Larry,Davis,"Johns, Mays and Trevino",East Albertborough,Indonesia,357-597-6977x2627,952.479.7884,isabelcooley@newton.com,2022-01-11,http://www.novak.org/
29-Jul-2021,Cash,00.00,"115,204.88",00.00,46Ae5DcdE05fDEE,7432,Cody,Tate,"Drake, Harvey and Lindsey",New Alexandria,Tonga,+1-449-094-2244,(658)760-6593x90757,preynolds@bailey.com,2020-07-22,http://www.foster.com/
29-Jul-2021,ATM,"1,230.99",00.00,"1,230.99",3Fa1C1c98cCC3bA,8391,Margaret,Coleman,Vaughn-Meza,East Marciashire,Lebanon,067-424-9888,510.050.8826,kellivasquez@buckley.org,2022-05-14,http://bass-hatfield.com/
29-Jul-2021,Interest,00.00,136.78,"1,094.21",DA15FDa18f1Fb5e,7815,Rita,Hampton,Harvey Inc,Walshstad,Puerto Rico,057.544.9290,932-028-2086x7841,valenzuelacassidy@combs.com,2021-01-21,http://www.durham.com/
29-Jul-2021,Bill,00.00,156.32,937.89,ef19F3E31A3E65e,535,Phyllis,Giles,"Reeves, Hayes and Whitehead",Reneemouth,Benin,(652)842-4012,+1-118-686-7313x65876,mcleanarthur@erickson.com,2020-08-30,https://caldwell-estrada.com/
29-Jul-2021,RTGS,48.00,00.00,985.89,Cef5DEeBAfdAfC4,8397,Shawna,Vazquez,Pacheco Ltd,West Francisville,Morocco,196.421.1887x15959,001-545-838-8749x68948,bmathis@dominguez.com,2020-12-31,http://www.elliott.com/
29-Jul-2021,IMPS,"790,272.25",00.00,"791,258.14",43eBC5D90A693da,7136,Monica,Steele,Thompson-Reeves,East Rachael,Mali,613-767-0557x968,001-829-947-9873x3668,shelby99@kline.com,2020-09-10,http://huber.biz/
29-Jul-2021,Interest,00.00,"131,876.36","659,381.78",F4DE3fFc9dadB0D,289,Ray,Yu,Vaughan-Wyatt,South Clayton,French Polynesia,5471798652,001-361-871-8894x96041,zfigueroa@cummings.com,2021-04-01,http://www.white-vargas.com/
29-Jul-2021,ATM,"55,352.00",00.00,"714,733.78",1aa3CDB10F71B9f,226,Kendra,Wilson,Rivers-Woods,North Nina,Bolivia,+1-888-655-3187x97227,122.368.5637x8695,lucas94@barrera.com,2021-02-16,https://booth-guzman.info/
29-Jul-2021,Tax,"1,377.01",00.00,"716,110.79",EaD5472E5B3ffd8,9714,Christina,Luna,Pierce-Greene,Kathleenchester,United Arab Emirates,637.554.5988,984-335-1384,schmidtbryce@lang.com,2021-07-01,http://wade.com/
29-Jul-2021,Cash,00.00,"143,222.16","572,888.63",c36bE0DA8FbC4Ee,1654,Karla,Mccormick,Cole Inc,Lake Elizabeth,Saint Lucia,649-156-7076x66036,528.142.6204,wrandall@sweeney.com,2020-08-02,https://www.acevedo-may.com/
29-Jul-2021,Reversal,"1,797,005.00",00.00,"2,369,893.63",6BefAaDaa443B53,4894,Hunter,Manning,Kennedy Inc,North Dennis,Libyan Arab Jamahiriya,001-171-693-3187x283,182-925-5101x2389,wdudley@combs.com,2021-10-14,http://price.com/
29-Jul-2021,Bill,03.44,00.00,"2,369,897.07",dA74AfF69d1Bd52,2881,Carl,Ochoa,Nguyen PLC,Katherinebury,Zimbabwe,256.115.9477x5119,(287)292-2464x253,gravesthomas@curry.com,2021-04-01,http://santos-johnson.com/
29-Jul-2021,IMPS,"3,319.00",00.00,"2,373,216.07",CD752A01Dc8428B,7579,Kellie,Carr,Pitts Ltd,South Erinberg,Kenya,001-060-302-4416x6526,001-154-369-6052x36817,nina32@atkins.com,2020-10-06,https://ponce-ochoa.net/
29-Jul-2021,ATM,"17,652.00",00.00,"2,390,868.07",1DeA9ff7bC60be0,9238,Mindy,Ball,"Avery, Robbins and Ross",Perryburgh,Saint Martin,001-571-725-7413,+1-650-907-8691x23600,kbrooks@meyers.com,2020-07-11,https://www.white-burton.com/
30-Jul-2021,IMPS,00.00,"298,858.51","2,092,009.56",BE53ED44B2B4Dd3,3155,Margaret,Dillon,"Sherman, Olsen and Bennett",Caitlinberg,Lao People's Democratic Republic,830.202.4364x007,386-750-3778x66094,wharding@dickerson.com,2020-11-29,http://holden.com/
30-Jul-2021,Tax,00.00,"261,501.20","1,830,508.36",E9379eeC0e4c621,1464,Mariah,Castillo,"Weaver, Bass and Cantrell",East Terry,Mauritius,2064191317,(427)170-6397x4274,candicehenry@berger.com,2020-04-16,http://www.acevedo.com/
30-Jul-2021,Reversal,"11,322.00",00.00,"1,841,830.36",ebdd62Ae745569a,8345,Morgan,Serrano,Sparks-Lewis,Jonesfurt,Monaco,(063)115-2010,001-758-770-7278,lorraine17@clements.org,2020-04-05,http://kemp.biz/
30-Jul-2021,Cash,62.14,00.00,"1,841,892.50",26E1F7196e2Ce0c,9448,Jeremy,Chan,"Sanchez, Haynes and Crawford",Lamchester,Luxembourg,+1-325-394-4233,4038675913,jrollins@becker.biz,2021-08-29,https://carter.com/
30-Jul-2021,Debit Card,95.42,00.00,"1,841,987.92",fC64BabBeDeD05b,4232,Ariel,Strong,Greene Inc,West Bethanyside,Nauru,001-035-155-2745x62648,(604)165-8488,tara21@payne-kerr.com,2021-11-06,https://www.stevens.com/
30-Jul-2021,Transfer,00.00,"368,397.58","1,473,590.34",266b2AAb9887Ee0,2087,Kristine,Lane,"Tanner, Mathews and Carson",New Meghanburgh,Vanuatu,812.662.7950,942-421-9038,sydney92@house.org,2020-12-24,http://barton.com/
30-Jul-2021,ATM,00.00,"163,732.26","1,309,858.08",e93DBE2CE880b2f,3767,Brent,Buchanan,Campos Group,Rowlandshire,Canada,624.325.2854x2501,546-104-9451,alanhester@lynn.com,2020-02-01,http://www.figueroa.com/
30-Jul-2021,Commission,00.00,"261,971.62","1,047,886.46",dF6AeDc714Ce39e,1279,Janet,Mcmahon,"White, York and Scott",North Candice,British Virgin Islands,489.196.0786x88453,618-578-7438,clementsrodney@gregory.com,2022-05-11,http://lee.info/
30-Jul-2021,NEFT,"1,279.00",00.00,"1,049,165.46",ccFbE36B36DA8ca,906,Stacy,Wright,Mcmillan Ltd,Lanceburgh,Macao,(298)415-3714x8433,(084)259-2369,brittany22@blake.org,2021-04-12,http://www.perkins.biz/
31-Jul-2021,NEFT,00.00,"349,721.82","699,443.64",43ae02A2D8d8B06,779,Calvin,Meyer,Fernandez-Herrera,Latashaside,Cocos (Keeling) Islands,529-591-0931,001-061-736-2529x023,morrisonyvonne@gallegos-carter.com,2021-07-16,http://hendricks.com/
31-Jul-2021,Miscellaneous,00.00,"174,860.91","524,582.73",a90f476FDf38828,6858,Brendan,Carter,Heath-Barrera,Bakerberg,Christmas Island,001-253-528-4483x6741,290-848-4881,reidbilly@fleming-fischer.com,2020-06-30,http://monroe-ali.com/
31-Jul-2021,ATM,07.90,00.00,"524,590.63",c9D86f4fA51D9c4,3198,Kristi,Bishop,"Moran, Soto and Whitehead",East Carolynmouth,Falkland Islands (Malvinas),3568240392,8089199088,diane76@mills.org,2021-02-25,https://www.noble-villa.com/
31-Jul-2021,Tax,217.53,00.00,"524,808.16",0e0aA5E3773D168,8809,Chad,George,"Houston, Ferguson and Hawkins",Port Marthafurt,Somalia,262.724.5156x0726,578-761-2233x754,aaron43@scott.net,2021-09-18,http://www.richards-skinner.org/
31-Jul-2021,Tax,00.00,"87,468.03","437,340.13",1ECAA049CCaAA7B,131,Brady,Mckay,Decker Group,East Brady,Cape Verde,1934272027,+1-248-385-9619x891,travisfoley@brandt.com,2021-05-25,https://blake.net/
31-Jul-2021,RTGS,"166,805.31",00.00,"604,145.44",BF2a993e17eda92,4101,Dillon,Gibson,Andersen Ltd,Lake Erin,Mali,+1-584-333-5625,050.827.9926x904,bobby37@juarez-hansen.com,2021-01-13,http://morton.net/
31-Jul-2021,Interest,00.00,"67,127.27","537,018.17",de6128c5B23ca48,8013,Melvin,Payne,"Bridges, Holt and Mcdonald",Murphyview,Morocco,+1-116-179-2969x05408,001-648-331-0560x60402,martha05@larsen.com,2022-04-24,https://www.briggs-boone.info/
31-Jul-2021,NEFT,00.00,"179,006.06","358,012.11",7E827eb3763be1c,6720,Paige,Armstrong,Wu-Hanson,Dorisside,Antigua and Barbuda,001-086-005-9457,753.911.3064,stefanie94@chung-sawyer.com,2021-09-02,https://prince.net/
31-Jul-2021,Bill,"331,728.00",00.00,"689,740.11",93eb5Bf642f92A7,2271,Gabriel,Casey,Underwood-Dean,Mcbridestad,Mozambique,+1-745-836-3629x35271,255-334-5753x7982,selena52@richard.info,2021-03-18,https://hughes.com/
31-Jul-2021,Reversal,48.00,00.00,"689,788.11",8AE5128FB69f3f1,3888,Xavier,Mcclain,Grimes Ltd,Hessmouth,Northern Mariana Islands,(879)605-7498x1357,514-422-3997,mbrown@callahan-moon.info,2021-07-31,https://www.arroyo-beard.com/
31-Jul-2021,ATM,00.00,"86,223.51","603,564.60",1CE0aBbAcA592Cb,4824,Samuel,Navarro,Hodges LLC,Port Nathanielmouth,Bermuda,+1-155-791-1611x37992,(864)967-7206,aguirremelissa@pena.info,2021-12-15,http://www.mcdonald-ford.com/
31-Jul-2021,Commission,00.00,"150,891.15","452,673.45",b086Cf491c40B4c,4708,Isabel,Williamson,Esparza-Griffin,South Sierrabury,Colombia,894.742.3667x90373,(065)611-6414x54608,alexa75@vance.com,2020-10-18,http://www.bean.com/
31-Jul-2021,Reversal,00.00,"56,584.18","396,089.27",2D3E32aAd0Fe9B3,6167,Philip,Ellis,David-Meyers,Bookerhaven,Micronesia,001-487-695-6074x7232,987.233.0362x2008,brady02@horton.biz,2021-10-02,https://wiley.org/
01-Aug-2021,Reversal,00.00,"99,022.32","297,066.95",73a3A6590c70D34,1940,Jenny,Phillips,"Carson, Colon and Contreras",Kirstenfurt,Jersey,8137688492,055.436.3178,osborncody@osborne-lindsey.com,2021-02-23,https://murillo.biz/
01-Aug-2021,Miscellaneous,04.90,00.00,"297,071.85",4AeFCbBCda5D851,5569,Meagan,Strong,"Silva, Paul and Navarro",North Kristiefort,Svalbard & Jan Mayen Islands,+1-569-441-0956x3555,1037496950,randyvalencia@thornton-mcintosh.com,2020-04-07,https://www.ford.com/
01-Aug-2021,NEFT,61.10,00.00,"297,132.95",6EF41fba31bfe2B,6581,Kristy,Stevenson,"Clements, Rasmussen and Edwards",Port Erinstad,Nigeria,+1-237-707-7926,(989)762-0965,pscott@oneal-riley.org,2021-08-04,http://www.mata-doyle.com/
01-Aug-2021,Cash,94.93,00.00,"297,227.88",345bb1727648cFC,2010,Angie,Weaver,Hansen-Baxter,Trujillomouth,Northern Mariana Islands,001-736-172-0169x63097,001-039-562-2083x664,pettysydney@rivas.com,2020-11-04,http://www.franklin.com/
01-Aug-2021,Miscellaneous,22.80,00.00,"297,250.68",5F929CC62eeDFBf,2376,Tricia,Turner,Taylor-Kirk,North Dwaynehaven,Greece,001-964-002-0304x490,001-827-406-4775,wendyferrell@bauer-graham.com,2022-01-14,http://www.stokes.com/
01-Aug-2021,Miscellaneous,00.00,"37,156.34","260,094.34",0B8bc12c8B4D44e,7833,Jay,Ferrell,Porter-Koch,Alisonside,Cook Islands,001-647-389-9947x355,7469253049,caldwelltanya@mcguire.com,2020-02-23,http://kline-vang.info/
01-Aug-2021,ATM,00.00,"260,094.34",00.00,7CB6Cbef2B741bD,7746,Mikayla,Walls,Everett-Jennings,Nicoleside,Cameroon,848.164.0265,+1-121-219-4274x1206,bellarthur@hamilton.info,2021-10-30,http://www.stephenson.com/
01-Aug-2021,Commission,"87,337.10",00.00,"87,337.10",5d8d6D9D50ff6dF,6797,Monica,Bolton,Wagner Group,Port Gabriel,United Kingdom,+1-288-718-4997x736,867.043.4099,meaganharvey@hunt.org,2021-04-24,http://neal.com/
01-Aug-2021,NEFT,"90,266.81",00.00,"177,603.91",f40407457D6ae00,9651,Colin,Bray,"Harrell, Lambert and Sexton",Jamieton,Peru,(713)788-4612x78976,375.274.3108x970,franklin06@everett.com,2021-01-21,https://blankenship.biz/
01-Aug-2021,Tax,50.20,00.00,"177,654.11",caBfF96a40aE715,1991,Tom,Shaffer,Montes-Todd,Derricktown,Belize,(948)182-8192x78688,1592437718,kirkcain@bolton-shaw.com,2022-02-13,http://cherry-cuevas.com/
01-Aug-2021,RTGS,"5,524.80",00.00,"183,178.91",ddC2d283aE679BD,7949,Gabriel,Mcclain,Holden Group,New Allenton,Croatia,001-107-132-3139x069,+1-778-437-5066,adriana69@escobar.com,2020-08-14,https://www.barry-zavala.com/
01-Aug-2021,Interest,00.00,"61,059.64","122,119.27",51eDcd67bAcaF0B,5512,Hailey,Murphy,Reed-Mcclain,Bryanside,Lao People's Democratic Republic,0304982075,202-099-2517x45176,warddennis@alvarado.com,2021-09-25,http://cox.biz/
01-Aug-2021,Interest,"4,039.77",00.00,"126,159.04",303E1ebfd701D4D,1787,Laurie,Galvan,Blevins and Sons,South Michealtown,Bermuda,4415985743,(336)842-6305,codyscott@potts.info,2021-03-27,http://padilla.com/
01-Aug-2021,NEFT,"22,237.50",00.00,"148,396.54",Fd76741FdCaAEdd,3942,Monica,Choi,Campbell PLC,East Danielstad,Cayman Islands,(775)916-9957,+1-157-263-6687x72013,colleen37@french.org,2020-07-19,http://www.mcdonald.com/
01-Aug-2021,Tax,49.50,00.00,"148,446.04",b094EEd228bAD85,3715,Micheal,Miranda,Compton LLC,Port Rickymouth,Turks and Caicos Islands,010-598-4440x80897,0240387775,isaac79@levy.com,2021-09-18,http://www.molina.com/
01-Aug-2021,NEFT,00.00,"14,844.60","133,601.44",0cb0ceC431291Ef,6863,Adam,Rose,Hunt-Acosta,Lake Lydiabury,French Southern Territories,835.884.1985x2582,+1-353-856-7100,kylie90@berger.info,2021-05-20,https://www.velez-nielsen.org/
01-Aug-2021,Commission,13.00,00.00,"133,614.44",81EcdBEd03Bda27,6601,Sophia,Dodson,Solomon-Mcmillan,South Gary,Vietnam,1482467265,6838476394,nblanchard@holmes-lucero.com,2020-01-01,https://www.benton-strong.net/
01-Aug-2021,IMPS,00.00,"14,846.05","118,768.39",edb87A4095c68DA,9517,Guy,Stephens,"Travis, Lara and Woodard",East Yvette,Peru,831-147-9281x0471,520-658-7073x111,sheena42@horton.com,2020-06-02,http://sandoval-hughes.biz/
01-Aug-2021,RTGS,06.30,00.00,"118,774.69",2f9991CfE9c2Ff2,6873,Holly,Finley,Ellison-Hutchinson,Joanneport,Bhutan,+1-582-086-3133x755,(852)329-8904x65732,wrowland@leon.biz,2021-04-28,https://www.hester-ellison.org/
01-Aug-2021,Interest,"164,492.22",00.00,"283,266.91",Bc038b4f5831d4c,5275,Eddie,Bautista,"Patel, Zamora and Choi",New Marcton,Somalia,960-906-0763x75895,010.484.4109,sallywu@everett.com,2021-01-04,http://arias.com/
01-Aug-2021,Miscellaneous,"587,527.50",00.00,"870,794.41",a8fEbbf214fd0cc,2408,Noah,Tapia,"Mcdaniel, Potts and Suarez",Brittneytown,Saint Lucia,745-358-0467,367-576-8877x134,noahproctor@serrano.org,2021-05-07,http://www.dillon.com/
01-Aug-2021,ATM,336.20,00.00,"871,130.61",347FA7d85Faa2BF,9932,Loretta,Mclean,Morales Ltd,North Julianfort,Dominica,440-483-3810x71362,(316)998-6672x458,fosterperry@valencia.com,2020-10-17,https://www.bright-mckenzie.info/
01-Aug-2021,IMPS,"2,561.00",00.00,"873,691.61",1ceCb250e02CAa8,8050,Chad,Warner,Nielsen Ltd,East Pedroborough,Faroe Islands,571.134.2378x5942,198-697-9062x9450,bsnow@mccormick.biz,2020-03-07,https://www.mann-durham.com/
01-Aug-2021,Cheque,00.00,"218,422.90","655,268.71",9a00E62352Ec874,5681,Duane,Pearson,Fuller LLC,South Shirleychester,Uzbekistan,327-846-4136x247,001-627-861-9612,teresa89@robbins.biz,2021-03-23,https://blanchard.com/
01-Aug-2021,Transfer,00.00,"81,908.59","573,360.12",E34b6c1c3923f7D,4889,Julie,Powell,Murray-Dyer,Lake Alan,Netherlands,001-620-567-7957x068,(913)109-1497,poolelindsey@kirby.biz,2021-09-26,https://frazier-pope.com/
01-Aug-2021,Bill,00.00,"143,340.03","430,020.09",19dB3E396bf4243,304,Gloria,Walters,Reed-Spencer,Michaelberg,Guernsey,(285)923-6414x985,095.027.6923x8251,jillfoley@oconnor-french.com,2021-11-20,http://kane.info/
01-Aug-2021,Reversal,00.00,"43,002.01","387,018.08",eAa1Cf1f05cBD0a,1911,Bianca,Nguyen,French PLC,Harryton,French Southern Territories,884.973.2490x7880,+1-795-403-4217x089,jterry@potter.com,2021-03-18,https://bryant.com/
01-Aug-2021,Cheque,"1,448,679.80",00.00,"1,835,697.88",fEC7be95D19Dff1,6116,Anthony,Rosario,"Casey, Chen and Cohen",Sanfordbury,Kuwait,+1-880-918-2856,970.717.1234,conniewu@erickson.org,2021-11-25,http://www.frost.biz/
01-Aug-2021,Interest,00.00,"458,924.47","1,376,773.41",71F1Bd8C5f80Ca7,8282,Anne,Branch,"Pruitt, Mcclure and Gordon",Petersenstad,Estonia,+1-368-672-0701,+1-083-203-1136x096,wwhitaker@mitchell.org,2020-09-14,https://www.payne-chan.com/
01-Aug-2021,Cheque,462.60,00.00,"1,377,236.01",45bBbaB4A13AB5c,3002,Leon,Beasley,Gamble-Schmitt,Katherinemouth,Guyana,+1-381-384-2716x7728,(590)235-3858,carneygeorge@daniel.biz,2021-08-31,http://wright.com/
01-Aug-2021,Purchase,387.16,00.00,"1,377,623.17",a88f50a26639aC7,2138,Ana,Martin,Arroyo-Mejia,Leslieland,Austria,001-693-235-6846,271-611-7047x9334,jeffsimpson@shannon-singh.biz,2021-05-20,http://www.abbott-choi.com/
01-Aug-2021,IMPS,"24,660.42",00.00,"1,402,283.59",d6e2A2cb6BA9D9C,6761,Wanda,Fry,Hensley-Maddox,Dianeborough,Morocco,001-498-541-5482x5780,+1-765-226-9719x1525,mollywilson@hinton.biz,2020-04-09,https://www.graham-ryan.com/
01-Aug-2021,RTGS,00.00,"701,141.80","701,141.80",E0aeDab86cD9Fb5,8019,Katelyn,Donaldson,Brooks and Sons,Lake Katieton,Fiji,(370)360-8249x23330,(132)680-5444,sylvia93@david.com,2021-03-12,https://www.hines.info/
01-Aug-2021,Purchase,"46,214.03",00.00,"747,355.83",61Def6a01D0371b,6410,Shaun,Blair,Henry-Le,North Teresaport,Belarus,001-405-242-9720,833-009-5398,frankrobin@trevino.com,2022-05-16,https://hobbs-rosales.com/
01-Aug-2021,Commission,10.00,00.00,"747,365.83",DAef58E7EcAFbFA,9606,Alexis,Little,"Cabrera, Stanley and Downs",New Darrylburgh,Croatia,9300849213,(354)469-7260x0612,nuneznancy@mcdowell.com,2020-12-15,http://dillon.com/
01-Aug-2021,Cash,00.00,"373,682.92","373,682.92",28aB3a87076A1Fe,4002,Reginald,Rose,"Flowers, Hurst and Powers",Beasleyhaven,Saudi Arabia,2524330677,9270693328,wellsjoann@wiggins.com,2021-04-03,https://www.bullock.biz/
01-Aug-2021,IMPS,"1,965,235.50",00.00,"2,338,918.42",62591BdCf896dE5,5909,Larry,Herring,Gibbs Inc,Malikland,United Kingdom,629-233-4454x25483,+1-229-524-4867,bryanmeredith@sawyer.org,2020-01-19,http://pope-baxter.biz/
01-Aug-2021,Purchase,476.60,00.00,"2,339,395.02",3f50Fe6E4C05edb,2127,Cheryl,Juarez,Marsh-Sims,Davebury,Germany,+1-089-557-1139x93718,727-427-2556x7274,katherinecolon@byrd-hickman.org,2022-02-22,https://gomez-patrick.org/
01-Aug-2021,Reversal,06.81,00.00,"2,339,401.83",33e0D2Ae0edf0Fd,2476,Nicole,Horn,Hahn-Garcia,Terrystad,Lesotho,218.694.4628,(002)357-2302,craigaustin@ayers-oneal.org,2020-05-17,https://www.delgado.biz/
01-Aug-2021,Purchase,03.00,00.00,"2,339,404.83",DF9bcCfCe4FacE3,3418,Carrie,Russo,Francis LLC,East Courtneyview,Thailand,8155699107,+1-111-339-2315,carl60@kennedy.com,2020-12-06,https://richards.net/
01-Aug-2021,Cheque,00.00,"292,425.60","2,046,979.23",aD06e45d1Ed1dB0,5126,Jocelyn,Sims,Andersen-Lyons,Figueroaview,Angola,607-344-8292x700,+1-970-071-7245x94204,george00@lambert.com,2021-02-27,http://www.estes-mcmahon.com/
01-Aug-2021,ATM,00.00,"341,163.21","1,705,816.02",76dFD2f4DA0F9Fa,9488,Catherine,Combs,Benton Group,South Colleenside,Tonga,001-040-439-5657x8777,+1-165-803-3749x842,skerr@beard.com,2020-12-24,https://www.rice-weiss.biz/
01-Aug-2021,IMPS,07.90,00.00,"1,705,823.92",d8cCD02E409D5F2,66,Gene,Wu,"Chambers, Nielsen and David",Noblefort,Bulgaria,+1-956-239-0423x80834,001-414-382-8351,nataliefarley@richardson.com,2021-10-05,http://carrillo.com/
01-Aug-2021,Commission,"261,614.50",00.00,"1,967,438.42",9aAA56f50da169D,110,Yvette,Short,Pugh-Green,Erinfurt,Namibia,190.807.9974,001-076-509-0536x0863,garymelton@petersen-lam.org,2020-01-03,http://www.lawrence.biz/
01-Aug-2021,NEFT,00.00,"983,719.21","983,719.21",Deca2C5867aB3ca,7761,Nathaniel,Parker,Elliott-Moyer,West Rebekahland,Turks and Caicos Islands,743-336-2430x756,800-771-0650,gavinstokes@horton.com,2020-06-12,http://www.drake-petty.biz/
01-Aug-2021,IMPS,00.00,"163,953.20","819,766.01",AbB5C3b648Ef1d4,682,Albert,Cameron,"Bailey, Morse and Butler",Shaunberg,Martinique,486.834.0597x5760,+1-660-520-1960x99391,teresa89@rivera.com,2021-12-02,http://khan.com/
01-Aug-2021,NEFT,336.00,00.00,"820,102.01",2c0bE27aBAaA8bB,3145,Dwayne,Peters,Glenn-Howard,Port Lorraineside,Syrian Arab Republic,(661)540-1716x26870,+1-057-070-7005x8840,kmay@lewis-mcmillan.com,2022-05-29,http://www.novak.com/
01-Aug-2021,ATM,46.00,00.00,"820,148.01",F6Ba95abECbbEd6,9262,Latoya,Cannon,"York, Rowland and Donaldson",Normaton,Western Sahara,943.911.4349x45806,+1-088-083-4544x816,meganramirez@vaughan.com,2020-01-29,https://ayala-holmes.com/
01-Aug-2021,Cheque,683.51,00.00,"820,831.52",B67f0bC593dE9e4,2215,Cassidy,Rush,Marks Group,South Jacob,Saint Barthelemy,567-513-3075,+1-456-266-7485x845,dennis88@francis.com,2020-04-25,http://mcneil.com/
01-Aug-2021,Debit Card,00.00,"91,203.50","729,628.02",0748BdEFeb4834F,26,Mackenzie,Williamson,Hart-Klein,New Maxhaven,Saint Helena,+1-605-640-1833x70183,656.931.4990,zramos@haney.org,2020-03-06,http://www.allison-clements.com/
01-Aug-2021,Transfer,00.00,"182,407.01","547,221.02",B2A4fEc9fa4FC39,2773,Bill,Andrade,Morrison-Parks,Port Theresahaven,Holy See (Vatican City State),049-239-6225x9348,001-527-193-6094,tbaird@peters-valdez.com,2020-03-13,http://mason.com/
01-Aug-2021,Purchase,199.84,00.00,"547,420.86",B91848D0762fCfB,9929,Summer,Scott,Conley-Mcmillan,New Kristy,Afghanistan,240.137.1638,290-805-2931,tarahenson@villarreal.biz,2021-05-10,http://www.warren.org/
01-Aug-2021,Cash,00.00,"273,710.43","273,710.43",f838D73a1AcA4dd,2257,Anita,Marquez,"Reilly, Andrews and Roman",Matthewsville,Papua New Guinea,466.697.1387x099,001-238-614-3180x99888,jackson10@suarez.info,2020-08-12,http://reeves-valencia.info/
01-Aug-2021,Bill,00.00,"39,101.49","234,608.94",aBcaaa9B6Fe122D,6374,Diamond,Reed,"Glover, Wyatt and Shaw",Brooksburgh,Liechtenstein,124.257.8120,(296)790-0002,pollardamy@parker.com,2022-05-27,https://lindsey-spencer.com/
01-Aug-2021,Interest,00.00,"29,326.12","205,282.82",b2729cce9390e94,7256,Alec,Mayo,"Wade, Stuart and Charles",Thomasport,Indonesia,140-002-3731x05445,(486)905-4334x2619,lsingleton@hubbard.com,2020-01-21,http://hampton.com/
01-Aug-2021,NEFT,00.00,"25,660.35","179,622.47",f41dF8Fd2aF69d5,2248,Haley,Davies,"Hendrix, Meyers and Braun",North Albertborough,Guinea-Bissau,351.505.8558x6249,001-992-635-7508x439,camachooscar@clark.com,2021-11-05,https://www.kirby.com/
01-Aug-2021,Commission,00.00,"89,811.24","89,811.24",7f1AdcCC17B38A2,9561,Connie,Mcpherson,Roman Group,North Greggmouth,Namibia,001-034-125-2069x679,(695)799-3797,valvarado@king.com,2021-06-07,https://reyes.biz/
01-Aug-2021,Transfer,04.92,00.00,"89,816.16",bdaf74CcEDC5A6B,2047,Gene,Glenn,Cardenas LLC,New Jacobton,British Virgin Islands,(639)185-5188x9405,+1-159-591-3729x1462,leroy68@farley.net,2022-02-08,https://www.jenkins.info/
01-Aug-2021,Bill,"2,256.70",00.00,"92,072.86",dF9F4f651E0052c,7804,Charles,Mclean,Benton Ltd,Timtown,Peru,030.399.3854x81439,9582312719,harrypearson@collier.info,2020-08-24,https://www.sweeney-kaufman.info/
01-Aug-2021,Transfer,00.00,"11,509.11","80,563.75",Dbf8dbcEAc5d107,256,Leslie,Little,Curtis-Jarvis,East Brendanfort,Congo,4246157054,001-272-262-9810x30183,thomasstefanie@garner-cooper.com,2020-07-03,https://conley.com/
01-Aug-2021,Tax,00.00,"16,112.75","64,451.00",e2Fd0fA55580b60,6525,Mckenzie,Franco,Craig-Bright,Port Anne,Netherlands Antilles,(231)631-0649x6953,579.732.8626x3233,vicki87@ramsey.biz,2022-05-22,https://www.nguyen.com/
01-Aug-2021,Bill,"18,475.08",00.00,"82,926.08",1b5cf9fc9ffF59C,572,Tony,Guerra,Wilcox-Tate,Hatfieldfort,Mayotte,570.722.4709,494.016.6859x09912,stephensjerome@oneill-villanueva.com,2022-04-23,http://www.mcintyre.com/
01-Aug-2021,Tax,00.00,"9,214.01","73,712.07",bFe73752eCFfCD7,6476,Jesse,Neal,"Lutz, Hunt and Roberts",Selenaton,Argentina,683-066-3295x668,(058)598-5306,phernandez@yates-fischer.com,2021-03-29,https://ewing.com/
01-Aug-2021,Reversal,00.00,"14,742.41","58,969.66",Bfbade7aCC44ddb,7296,Glenda,Frederick,"Payne, Valenzuela and Bryant",Kayleemouth,Mauritania,445.265.9031,+1-204-208-8839x64146,freydon@newton.com,2021-11-24,http://dunlap.com/
01-Aug-2021,Transfer,00.00,"5,896.97","53,072.69",dd8fAF875cea349,9355,Candice,Cross,"Newton, Reed and Silva",East Ethan,Saint Lucia,077.466.8023x17278,046-579-4704x21236,rileysnow@gilbert.com,2022-01-02,http://www.grant-russell.com/
01-Aug-2021,Commission,"216,409.00",00.00,"269,481.69",Fa0CeBEac3d3Adb,9737,Jeanette,Mcgrath,Lane Group,Evanland,Tajikistan,(326)945-3917x71218,717.970.2020x82182,stephencohen@murphy.biz,2020-05-23,https://harris-ryan.net/
01-Aug-2021,Cheque,"1,813,738.00",00.00,"2,083,219.69",FaddddA784EdCeC,9481,Jordan,Nelson,"Roy, Fuentes and Rodriguez",Ianbury,Switzerland,+1-421-248-6063x3976,+1-314-678-9449x0866,gnielsen@walters.com,2020-06-18,https://www.shah.com/
01-Aug-2021,Cheque,460.00,00.00,"2,083,679.69",9c35f1B9C8caAdc,3598,Benjamin,Patel,Moran-Esparza,North Alexander,Tajikistan,+1-042-370-6484x013,(070)904-2725x250,bobby84@mcgrath-massey.biz,2021-06-16,http://www.russell-rosales.com/
01-Aug-2021,RTGS,07.00,00.00,"2,083,686.69",497bFE60296a7C5,7175,Brooke,Spencer,"Carson, Hutchinson and Hickman",West Heidiside,Denmark,531.564.4470x949,(205)969-0252,pjacobs@ellison.com,2020-06-06,https://middleton.com/
01-Aug-2021,Miscellaneous,00.00,"231,520.74","1,852,165.95",05c6e3D55a93Ce3,1471,Dakota,Chapman,Cochran and Sons,Coxton,Saint Pierre and Miquelon,572.114.6164x236,001-991-905-2279,gwalker@stevens.biz,2022-04-10,https://www.zuniga.info/
01-Aug-2021,Tax,"16,149.00",00.00,"1,868,314.95",CfCBe4bfd64abbC,7792,Eduardo,Mayo,Orr Ltd,Cainchester,Ecuador,769.552.4639,670.137.1073,hectorpeters@larson-cross.info,2020-10-25,https://www.burton-bush.org/
01-Aug-2021,Cash,00.00,"934,157.48","934,157.48",78399AFFeBF99A4,8996,Darin,Mayer,"Carey, Bryan and Michael",Stokeshaven,Reunion,+1-961-418-0345x5185,9141920220,judycarpenter@vaughn.biz,2022-01-21,http://hahn-fields.com/
01-Aug-2021,Purchase,446.60,00.00,"934,604.08",AAa83DeeEb0aaAE,8891,Roberto,Shelton,"Wyatt, Hunt and Durham",Rebeccashire,Falkland Islands (Malvinas),001-073-585-5415x10160,441.548.4128x97231,foxclaire@strickland.biz,2021-08-21,http://www.chambers-rivera.com/
01-Aug-2021,Bill,"19,290.70",00.00,"953,894.78",6eDeAc5c6Ef8c08,9447,Fernando,Villegas,"Bennett, Gilbert and Sweeney",Port Geraldborough,Sao Tome and Principe,+1-559-667-7139x2140,+1-298-392-7652x37302,melissa45@nicholson.com,2022-05-15,http://cooke-reilly.com/
01-Aug-2021,Bill,"2,012.00",00.00,"955,906.78",A87C11D0ECe2f45,978,Mathew,Peterson,Mason Group,Garrettberg,Uruguay,974-942-6719,053-795-4514,anitaduran@hendricks-flowers.com,2021-07-15,https://www.webster-abbott.com/
01-Aug-2021,Interest,"1,390,219.80",00.00,"2,346,126.58",9c6b6C3b6a74c81,9105,Sean,Carlson,Kelly Group,Darrellfort,Reunion,4059279575,2427188099,kenneth00@wagner.com,2020-01-19,http://wilkerson-myers.net/
01-Aug-2021,IMPS,01.40,00.00,"2,346,127.98",bb9D28dEaE43973,2815,Megan,Shelton,"Mora, Waters and Price",Ebonyfurt,Kyrgyz Republic,1999807046,(133)280-5056,tomgross@trevino.com,2022-05-09,http://www.meyers-best.com/
01-Aug-2021,Cash,12.00,00.00,"2,346,139.98",BD4584A18f406A8,5622,Devon,Jefferson,Buckley Inc,Stefanieland,Vanuatu,919.847.9348,(599)415-2231x97158,sueboyle@jenkins.com,2022-05-18,https://www.rice.info/
01-Aug-2021,Bill,"2,380.00",00.00,"2,348,519.98",1DC0Ab2c49fD6D1,2103,Kristie,Malone,"Sanford, Lane and Sawyer",North Sydneyview,Brazil,623-962-4689x13190,001-147-253-0067x57734,fandersen@acevedo.com,2022-04-06,http://fisher-buckley.com/
01-Aug-2021,Purchase,00.00,"391,420.00","1,957,099.98",bFc0e9D06DFDE10,8654,Christopher,Kent,"Warren, Mcknight and Blanchard",Jorgeland,Azerbaijan,972.132.6099,(825)402-0513x96535,ycross@griffith-stephenson.biz,2021-03-04,https://www.aguilar.com/
01-Aug-2021,Bill,00.00,"391,420.00","1,565,679.98",3aE736eebEC66d1,6382,Elaine,Richmond,Mccullough-Dean,Quinnfurt,Georgia,042.839.7938,(612)170-6561x40803,wandamcconnell@hines-cole.com,2021-11-02,https://www.rivera-trujillo.org/
01-Aug-2021,Transfer,18.60,00.00,"1,565,698.58",9ccb7ED7CE792D5,3313,Gregg,Moreno,Wood-Preston,Flynnfort,Hong Kong,001-961-208-4968x7047,+1-690-780-8987x532,mccoyryan@simon-vang.com,2021-03-03,http://joyce.info/
01-Aug-2021,Tax,07.20,00.00,"1,565,705.78",a580AEbEc6780aA,7328,Stacy,Travis,"Ward, Lin and Kim",Leonburgh,Bhutan,+1-472-029-6569,(055)663-8408x0494,norrispriscilla@patrick.org,2021-08-27,http://www.barrera-davies.biz/
01-Aug-2021,NEFT,18.10,00.00,"1,565,723.88",8A90aab81aBAFc8,1775,Roberto,Bolton,"Mcmillan, Johns and Velez",North Makayla,Togo,(590)599-4092,(838)231-7940,adkinsbrittany@nolan.net,2022-01-23,http://thompson.net/
01-Aug-2021,Transfer,00.00,"195,715.49","1,370,008.40",afe3Dd2df8dBc9d,2367,Andrea,Gilmore,Melton Group,Feliciastad,Kenya,211-754-7827x4048,269-513-6213x43976,tkelly@chaney-decker.org,2020-12-05,https://www.mills.com/
02-Aug-2021,Debit Card,41.20,00.00,"1,370,049.60",B44ec66f4D70d47,8510,Meagan,Whitney,Hunt-Stein,Mccoymouth,Serbia,741.671.9809x6696,001-945-267-5583,dparker@hurley.com,2022-04-06,https://sweeney-barr.biz/
02-Aug-2021,Bill,00.60,00.00,"1,370,050.20",447ecD44de1ecCa,8520,Katelyn,Barnes,Pearson-Gamble,North Brandonshire,Yemen,436.140.6528x813,165-425-1085x36558,frichard@lewis-grant.com,2020-07-27,https://wise-khan.com/
02-Aug-2021,Cheque,18.40,00.00,"1,370,068.60",4AEcC2Dcdf9Aba0,8266,Jasmin,Ortega,Munoz-Richards,North Tracy,Maldives,759.158.6370x875,+1-774-120-3804x724,parrishalexa@vaughn.org,2021-10-31,https://www.henry-lin.info/
02-Aug-2021,Bill,00.00,"195,724.09","1,174,344.51",b24f6baAB432DAf,2921,Amy,Duran,"Bird, Moreno and Griffin",Kochtown,Switzerland,001-001-002-8164x33186,1214411111,nancymccoy@gates.com,2020-04-13,http://hester-randolph.com/
02-Aug-2021,Tax,00.00,"195,724.09","978,620.42",B9Df6c1dB8531dc,9702,Maria,Thornton,"Cooke, Ross and Holt",Lake Kathrynstad,Azerbaijan,+1-294-490-8506x24576,+1-965-833-4871x974,woodardkylie@mack-kline.com,2022-05-17,http://sanford.com/
02-Aug-2021,Debit Card,"1,472,076.00",00.00,"2,450,696.42",dFc9EE59FEaDff6,2090,Malik,Nielsen,Aguilar Ltd,Port Jerrymouth,Mali,001-707-504-8677x721,001-933-398-7152x691,paigeriley@duran.com,2022-03-03,https://www.gill.org/
02-Aug-2021,Debit Card,01.67,00.00,"2,450,698.09",FB8A4E5Fb64c894,8229,Alice,Wilcox,Ward Inc,South Keithhaven,Vietnam,(720)311-5419x28729,840.499.8278x8913,christopherpearson@vaughan.com,2022-05-23,https://booker.info/
02-Aug-2021,RTGS,"82,253.50",00.00,"2,532,951.59",bCa8ce25bcfEE32,6955,Joel,Krause,"Walters, Braun and Guerra",North Suzannestad,Cuba,140-145-0174,134-452-7645,clintonbest@patrick-rogers.com,2020-04-13,https://www.ayala.com/
02-Aug-2021,Cash,00.00,"506,590.32","2,026,361.27",A29d72e1F8ce487,5941,Brooke,Higgins,Abbott Group,West Alisha,Eritrea,+1-759-696-8536x2729,968.702.9599,eugenecrawford@jackson.biz,2020-06-24,http://carroll-tapia.net/
02-Aug-2021,Miscellaneous,02.40,00.00,"2,026,363.67",cdC79DdEcF0B52C,569,Dwayne,Kane,"Branch, Mcclain and Baker",Terrimouth,Saint Lucia,(307)645-5099,(380)435-1039x041,gamblemaria@humphrey.com,2020-09-22,http://richard-olson.com/
02-Aug-2021,ATM,"143,785.00",00.00,"2,170,148.67",5F728865fDbA77B,3943,Jermaine,Frank,Dorsey LLC,Marthashire,Pitcairn Islands,001-330-106-5999x58991,(036)114-7688x3212,mitchellkara@pollard.com,2021-09-30,https://ochoa.com/
02-Aug-2021,ATM,"128,977.06",00.00,"2,299,125.73",E2F2dBf731f4E3b,9145,Annette,Hardy,Beltran LLC,Lake Theodorehaven,Greenland,881.775.9562,(361)728-9276,qfrye@ortiz.com,2021-07-25,https://price.net/
02-Aug-2021,RTGS,00.00,"574,781.43","1,724,344.30",a7cfa569c8B6efa,2645,Jose,Arias,"Pearson, Holloway and Carson",New Dillonfort,Holy See (Vatican City State),+1-650-748-1812x11414,8118876665,russokylie@clarke.com,2021-09-29,https://gutierrez-ruiz.com/
02-Aug-2021,Commission,00.00,"191,593.81","1,532,750.49",Bf3B8dE1B93A6d4,2342,Jake,Newton,Joyce and Sons,Vasquezview,Anguilla,(583)317-8474x33992,+1-797-940-3974x551,mcmahonerika@benjamin-warren.com,2020-05-08,https://garza.com/
02-Aug-2021,Cheque,00.00,"766,375.25","766,375.24",8fE8cBA8df40AC7,8333,Patty,Faulkner,Underwood-Simmons,South Derrick,Saint Helena,+1-210-276-0652x9103,(642)753-6431,vancericardo@cross-osborn.org,2021-12-26,http://www.bradley.net/
02-Aug-2021,ATM,"25,437.60",00.00,"791,812.84",51F91DB8ECaEA2c,3698,Paula,Davenport,Stout-Oconnor,East Jermainefort,Vietnam,863-139-6807x86316,(090)756-1758,watersgabriella@abbott-collins.info,2022-04-08,http://barrett.biz/
02-Aug-2021,Commission,"329,987.25",00.00,"1,121,800.09",F3603661F39eAE0,1200,Jeremiah,Riley,Mullen Ltd,North Ellen,Rwanda,351.617.4405,312-654-1063x0858,gibbsjason@hodges.com,2021-01-27,http://www.gay-jones.biz/
02-Aug-2021,NEFT,17.34,00.00,"1,121,817.43",BCCcB54d5d55d5A,6154,Catherine,Peterson,Mclean Inc,Morganton,French Southern Territories,(003)725-4694x90894,2762736317,lucaslonnie@kim.com,2022-05-17,http://www.fischer.com/
02-Aug-2021,NEFT,"20,734.26",00.00,"1,142,551.69",E0BC07239ba9dA6,8038,Adam,Dorsey,Robinson-Schwartz,Carpenterfort,Thailand,468-408-4767x977,001-412-793-8491,garrettjoseph@jackson-mullen.com,2021-12-15,http://kirk-lara.com/
02-Aug-2021,IMPS,02.90,00.00,"1,142,554.59",1AE3dC9BDDc37Aa,3859,Carrie,Dillon,"Bowman, Small and Morton",Josephport,Wallis and Futuna,001-269-966-5280x725,(306)048-6199x68668,faulknershawna@simmons-pruitt.info,2021-12-04,https://www.jacobs-myers.org/
02-Aug-2021,Tax,"1,355,590.25",00.00,"2,498,144.84",eEb1aaDd31c8Fd6,9308,Sheryl,Huff,"Hanna, Foley and Avery",West Dalton,Christmas Island,(655)914-7614,+1-124-882-0755x6669,qwall@klein.com,2020-08-02,https://www.johnson.com/
02-Aug-2021,Cheque,"4,003.90",00.00,"2,502,148.74",C52Fcf0ACaAD08C,5803,Isaac,Brock,Baker-Ramirez,Bernardmouth,Pitcairn Islands,001-813-451-9197x455,(202)636-9824x223,russellbriggs@guerra-mullen.info,2020-10-19,http://www.holland-casey.info/
03-Aug-2021,ATM,00.00,"2,502,148.74",00.00,d1Be4D41500884C,4914,Steven,Finley,Lamb Group,Stantontown,Bouvet Island (Bouvetoya),340-106-7755x365,(809)563-5088,zwoodward@petersen-mclaughlin.com,2021-07-06,https://www.archer.com/
03-Aug-2021,Bill,08.00,00.00,08.00,b58f2D9DeB0FD9e,2294,Alejandra,Lynch,"Rojas, Hanna and Richard",East Harry,Colombia,(756)069-5183x0677,418-061-4432x6039,allisonpeck@gentry.com,2020-09-05,https://burke.com/
03-Aug-2021,ATM,00.00,01.60,06.40,cC9Eb16B53F2C39,6168,Chad,Serrano,"Wilkinson, Townsend and Castillo",Hineshaven,Eritrea,+1-323-999-0434x85422,+1-198-286-0338,terryzhang@duncan.com,2021-06-08,https://www.ware-barber.com/
03-Aug-2021,RTGS,153.90,00.00,160.30,4FCb5dC6F5E0814,2422,Dale,Yu,"Weber, Roy and Lee",Ralphshire,Central African Republic,+1-666-285-2791,335-282-2581,weeksantonio@brown.com,2020-04-17,https://www.pena.com/
03-Aug-2021,Transfer,00.00,80.15,80.15,D7Ba0FBF04dAd2f,8147,Gregory,Mitchell,Mercado-Rivas,Hendricksview,Monaco,001-675-333-8549x671,001-951-808-2242x12075,zwaters@conley.com,2020-03-24,https://wu.com/
03-Aug-2021,ATM,"3,583.85",00.00,"3,664.00",50f7D8E02dfB621,5524,Bill,Richards,Novak-Long,Byrdburgh,Switzerland,329-543-1121,+1-942-902-4458x281,lekellie@christensen-lam.org,2020-04-08,http://www.cooper.biz/
03-Aug-2021,Interest,"254,454.00",00.00,"258,118.00",6aEBdCB530061Ea,4618,Carol,Hogan,Soto and Sons,North Evelynton,Canada,417-851-1848x314,481.282.4654,fryeriley@dawson.info,2021-01-05,https://francis.com/
03-Aug-2021,NEFT,00.00,"258,118.00",00.00,e3c45E3E4FcCeA0,1185,Frederick,Fletcher,Frey-Reynolds,West Guy,Tonga,813.229.9757x58288,0775767643,matthewmccann@santos.com,2021-06-01,http://gallagher-sanford.net/
04-Aug-2021,Interest,00.00,00.00,00.00,E46d07b1A76AE1C,543,Jose,Dickerson,Cain-Meyers,Anitaburgh,Ukraine,390-461-5145x3868,076.787.3069,moonstefanie@mccarthy.com,2021-06-14,http://www.finley.net/
05-Aug-2021,RTGS,06.10,00.00,06.10,D9e3c6dCE0D1d4c,2744,Jeanne,Farrell,"Martin, Mcclure and Conley",East Ellen,Korea,622-847-6153x2911,345-137-0848x42951,kristine34@rivas-suarez.net,2020-07-15,https://boyer.com/
05-Aug-2021,Bill,00.00,01.22,04.88,210da3EeaceDb3c,6628,Samuel,Reid,"Santos, Salinas and Kennedy",New Virginia,Malaysia,413.682.9038,9462717392,georgegail@hopkins-moreno.com,2020-07-16,https://www.gates.org/
05-Aug-2021,Tax,"30,367.00",00.00,"30,371.88",1fA31A6FFeF4b1a,1336,Sheryl,Bentley,Bridges-Wilkerson,East Brendafurt,Switzerland,720.814.9843x619,001-318-276-1988x799,petersjim@davidson.com,2022-03-31,https://hooper.com/
05-Aug-2021,ATM,00.00,"3,374.65","26,997.23",964Cf0C1C6d4a9e,9987,Diamond,Edwards,"Anderson, Bennett and Finley",South Allen,Saint Pierre and Miquelon,854-656-3546x60262,553.162.5807x5026,kylemoss@cowan.biz,2020-02-18,https://www.macdonald.com/
05-Aug-2021,Debit Card,"229,057.00",00.00,"256,054.23",3BEb4Fc4BacF8e5,2576,Eric,Cruz,Pena Inc,West Bobby,Christmas Island,(720)264-8931,0652489344,katiemcmillan@gould-barrera.biz,2020-01-19,https://morse-fowler.info/
06-Aug-2021,IMPS,"30,058.29",00.00,"286,112.52",49D0c593E7ffAa3,7184,John,Warren,Costa-Shea,Lake Carlosfurt,French Polynesia,001-405-110-6416,240.492.1667x799,pruittkendra@thornton.biz,2020-06-10,https://www.meza.org/
06-Aug-2021,ATM,00.00,"143,056.26","143,056.26",0d36A1739B6B148,5915,Sophia,Archer,"Andersen, Bradshaw and Coleman",Williamland,Saint Lucia,+1-110-399-0304x6469,0417597298,anewton@burke.info,2020-11-27,https://hooper-moody.com/
06-Aug-2021,Debit Card,"181,637.97",00.00,"324,694.23",AaFaaEa36c0bf6A,6342,Spencer,Kerr,Roth PLC,North Dorothychester,Saint Helena,(949)819-0937,(753)709-5680x080,aaron18@larsen.net,2021-07-08,https://www.leblanc.com/
06-Aug-2021,Miscellaneous,00.00,"40,586.78","284,107.45",f32620d0c22E8b0,9218,Sophia,Meza,Hernandez Ltd,North Rickeymouth,Venezuela,+1-559-969-2018,+1-095-306-5387x017,wsherman@harrison.com,2020-09-11,https://www.jenkins.biz/
06-Aug-2021,IMPS,"92,351.00",00.00,"376,458.45",2aeB0fAF9Fd1A2A,359,Jill,Schaefer,Molina-Fritz,West Carl,Cook Islands,+1-983-220-0215x955,+1-210-246-0470x5906,bfitzpatrick@kelly.com,2022-03-08,https://callahan.com/
06-Aug-2021,Debit Card,"3,860.03",00.00,"380,318.48",Dc9b3E425Bef90c,8156,Gregg,Patton,"Berg, Maldonado and Silva",Lanefurt,Suriname,(450)999-6600,(080)389-4179,elizabeth16@kerr.com,2020-04-19,http://www.henson-barber.biz/
06-Aug-2021,Transfer,00.00,"42,257.61","338,060.87",1ca7788b48FeE2e,184,Glen,Bullock,Mcbride and Sons,Joyceport,Swaziland,037-168-6087x3358,160.965.1293,bcole@stevens.com,2020-03-23,http://www.bernard-archer.info/
06-Aug-2021,Reversal,00.00,"67,612.17","270,448.70",C24caA81ad61d6c,2409,Shawna,Erickson,Chen Inc,Port Gwendolynhaven,Seychelles,358.460.4582x773,7553849200,rodney94@vance.biz,2021-02-14,https://www.sparks.info/
06-Aug-2021,Cash,"97,791.03",00.00,"368,239.73",166dC9a56fe1239,7461,Alejandro,Hopkins,"Gomez, Bartlett and Melton",South Julia,Ghana,0030550666,893.872.3982x307,rivaskenneth@whitaker-blevins.com,2022-02-03,https://miller-cole.biz/
06-Aug-2021,Commission,00.00,"40,915.53","327,324.20",6F9aCA7a4F014D1,2142,Kiara,Gentry,Grant-Barrera,East Kyle,Guernsey,+1-218-401-4412x281,+1-046-449-9589x1762,jordannavarro@moses.com,2020-06-25,https://www.henry-clements.biz/
06-Aug-2021,ATM,"1,323,829.75",00.00,"1,651,153.95",8b7dd3663ca8210,986,Earl,Reid,"Singh, Miller and Golden",West Lancestad,El Salvador,(304)401-6534,(579)946-4417x338,wayne62@jennings-burnett.com,2020-09-16,http://www.salas-gross.biz/
06-Aug-2021,ATM,34.30,00.00,"1,651,188.25",Eac59eEa3FC3DB9,6123,Andres,Harrison,Rojas-Ortega,Antoniofort,Peru,565.594.9099,+1-065-356-3045x18591,tracey81@liu-lindsey.com,2020-07-14,http://www.ellis.com/
06-Aug-2021,Transfer,"21,650.43",00.00,"1,672,838.68",6D30DE16c37f3eC,5149,Sandra,Galvan,Burch-Horne,West Kathleen,Kuwait,(690)368-1888x027,+1-557-378-2255x4038,orrdanielle@welch.net,2021-11-08,http://www.hinton-lambert.com/
06-Aug-2021,RTGS,00.00,"418,209.67","1,254,629.01",FeA461cdD0aBfBa,4977,Eugene,Atkins,Graham-Ray,West Derrick,Belarus,(158)309-8674,001-973-278-4961x8015,tharrell@price-chaney.com,2021-03-18,https://copeland.org/
06-Aug-2021,Reversal,00.00,"250,925.80","1,003,703.21",8Eb623320c4D45b,424,Randy,Gomez,Mcdaniel Ltd,Colinland,Iran,527.791.5662,001-523-780-0623x66348,bishopbryan@mcpherson-rosario.com,2020-03-03,http://wolfe.com/
06-Aug-2021,IMPS,00.10,00.00,"1,003,703.31",0dD33e46C7bE769,6391,Charlotte,Richards,"Atkins, Austin and Wiley",Tomtown,Nepal,001-926-089-1322x021,8230513700,yrobbins@macdonald.com,2020-06-15,https://www.yu.info/
06-Aug-2021,Debit Card,"995,294.00",00.00,"1,998,997.31",635De41f687c324,478,Lacey,Levy,Gilmore and Sons,Lake Warren,Belarus,(401)895-1449,(050)395-2080,houstondesiree@neal-combs.org,2020-08-26,http://garner-conway.com/
06-Aug-2021,Cash,"1,357,968.00",00.00,"3,356,965.31",B14E9F56e7a9ccd,3299,Theresa,Moody,Colon Ltd,East Stuartborough,Slovakia (Slovak Republic),971-417-0679x89840,354-166-9297,luceroalice@barron.com,2021-08-05,http://www.crane.com/
06-Aug-2021,Transfer,420.00,00.00,"3,357,385.31",1AacD8d00BB4d0C,6579,Jerome,Peterson,Ray-Cantrell,Armstrongland,Burkina Faso,001-799-619-4368,+1-058-743-7829x24010,jeremyspence@frazier-skinner.biz,2022-02-05,http://www.lindsey-glover.com/
06-Aug-2021,Reversal,"6,717.00",00.00,"3,364,102.31",7A06684bC0bfbFa,441,Chelsey,Tapia,"Long, Terry and Garner",South Laurachester,Moldova,001-607-068-6950x55174,4282991256,wallacekristy@cross-oconnell.com,2020-05-17,http://www.david-huff.com/
06-Aug-2021,RTGS,"4,983.00",00.00,"3,369,085.31",c64CC10d636a26a,7848,Levi,Townsend,Blevins-Yu,Baxterstad,Algeria,+1-675-796-0499x4927,001-848-534-4918x16121,cguzman@cooke.com,2021-12-19,http://barry.net/
06-Aug-2021,Tax,"18,479.92",00.00,"3,387,565.23",4296df0C13e2BCE,6535,Sherry,Forbes,"Meza, Fuller and Pittman",East Kylieberg,Korea,370.358.0435x3681,(274)458-3751x16579,jriley@fitzpatrick.net,2022-04-10,http://munoz.com/
07-Aug-2021,IMPS,984.00,00.00,"3,388,549.23",A184fC7364be631,8588,Leslie,Delacruz,Horn and Sons,Lawrenceshire,Mauritius,417.135.6451,001-896-247-8605x04388,ncline@santana-cross.net,2020-02-04,http://www.raymond.com/
07-Aug-2021,Tax,00.00,"1,694,274.62","1,694,274.62",cC82EB07AAE4b3B,2893,Heidi,Burton,Dunn-Lyons,Lake Robin,United States Virgin Islands,+1-106-474-3119x1865,001-102-271-2329,lunacolton@macdonald.com,2021-11-29,https://barker.net/
07-Aug-2021,Transfer,00.00,"242,039.23","1,452,235.39",4326a35c52D943D,9144,Meredith,Preston,Duffy-Brown,South Matthew,Timor-Leste,+1-735-957-0539x35329,071-432-3677x8231,lindsey45@michael-morales.com,2021-06-18,http://www.blair.com/
07-Aug-2021,Cash,00.00,"242,039.23","1,210,196.16",DDcdC5d99e78c80,2002,Jodi,Frost,Villanueva Group,Tyroneberg,Mauritius,001-000-063-3072x286,001-209-513-2574,kristiemiles@chaney-brennan.com,2020-10-23,http://www.livingston.com/
07-Aug-2021,Tax,"15,011.03",00.00,"1,225,207.19",aec5CeDc949143F,295,Kristy,Paul,Ortiz and Sons,Brentside,United States Minor Outlying Islands,001-028-436-4997,(590)746-8290x729,kirsten26@chaney-stephens.com,2020-02-17,http://acevedo-baker.com/
07-Aug-2021,Tax,00.00,"122,520.72","1,102,686.47",2fC135381ccEebA,9551,Sherri,Riley,Frey-Sawyer,Calhounstad,Antigua and Barbuda,001-742-977-8039x76094,7933040978,juarezgabriel@patterson-bennett.net,2021-06-03,https://mcintyre.biz/
07-Aug-2021,Interest,"219,692.90",00.00,"1,322,379.37",AcB32b621dBDC09,5251,Jesus,Caldwell,"Gardner, Gilmore and Butler",Bonillamouth,Tunisia,001-637-510-7065x4620,802-204-6152x4848,bbowman@stanton-curtis.com,2020-11-26,http://dalton.com/
07-Aug-2021,Tax,00.05,00.00,"1,322,379.42",9E7e5F9D4eCA1a5,2085,Andre,Costa,Rose-Neal,West Ernest,Guinea-Bissau,+1-418-143-4273x919,(837)583-9185x9153,gene44@garcia.com,2021-10-24,http://www.meyer.com/
07-Aug-2021,Cash,00.00,"1,322,379.42",00.00,eC83DEa5B25B8e6,7959,Ralph,Dougherty,Luna PLC,Donhaven,Cayman Islands,790.463.1260x1371,001-923-977-2120,natalie38@vang-obrien.com,2020-02-12,https://www.kline.com/
07-Aug-2021,NEFT,"2,576.00",00.00,"2,576.00",A425ace78C9Bf03,7345,Colton,Durham,"Morton, Cantu and Conley",Grantfort,Ecuador,(330)649-8299x019,704-915-7161x18640,traciethompson@patterson.biz,2020-11-19,https://kaiser.com/
07-Aug-2021,Interest,00.00,515.20,"2,060.80",00bcE7218Abf9ae,8496,Dennis,Collins,Gallegos-Grimes,Arthurchester,Mozambique,6607178773,+1-015-419-8529x96690,kristybarry@chaney.net,2020-10-03,http://wang.net/
07-Aug-2021,Bill,373.00,00.00,"2,433.80",0778d8Decad8147,107,Christine,Manning,"Carr, Harvey and Webb",East Eduardo,Slovenia,(099)652-7937,0410407343,toddmcmahon@beard-lambert.com,2021-01-24,http://hurley.org/
07-Aug-2021,Reversal,00.00,243.38,"2,190.42",5eA5225D9ccAca1,5393,Kirsten,Arnold,Ritter Group,Lake Misty,Latvia,+1-501-352-5655,001-078-276-8961x9578,uvalenzuela@chung.com,2021-03-09,http://hutchinson-hudson.org/
07-Aug-2021,Tax,132.00,00.00,"2,322.42",9B13Eb7a280B7E9,1010,Kelsey,Colon,Andrade-Sawyer,Lesterfort,Indonesia,+1-990-015-4214x4165,001-270-221-6376x1125,oowens@valenzuela.biz,2020-10-14,http://hickman.com/
07-Aug-2021,Debit Card,63.00,00.00,"2,385.42",a4Be3A89f99E12E,6316,Catherine,Mcneil,Andrews Group,East Sethport,Mauritius,+1-975-615-4584,+1-443-464-6108,vsimmons@garrett.com,2022-02-21,https://lucero-moran.org/
07-Aug-2021,Miscellaneous,00.00,397.57,"1,987.85",dA88e289aF0c5C7,6277,Marisa,Brandt,Waller and Sons,Dylanshire,Faroe Islands,(556)800-0097x95228,001-811-260-3564x922,andresferguson@herman.net,2020-06-21,http://www.wheeler.info/
07-Aug-2021,Cheque,"259,247.00",00.00,"261,234.85",6cA8E6Aae4F30Ef,807,Kristin,Mcconnell,Mack Group,Adamfort,Madagascar,192.399.2330x25224,(467)800-2830x46644,woodmaria@bryan.org,2020-04-19,http://barnes.com/
07-Aug-2021,Commission,00.00,"37,319.26","223,915.59",d877afa38D1cA9b,9733,Mallory,Simon,Greer Ltd,Kaitlynview,Latvia,+1-677-772-5531x44267,+1-992-185-4751x2329,jennifer87@ware-le.org,2020-02-01,http://austin.com/
07-Aug-2021,ATM,49.40,00.00,"223,964.99",dcbf5a3F6FBaEc3,2112,Marcia,Contreras,Hurst-Ashley,South Caseyton,Lebanon,379-373-2422x206,001-821-471-6902x7292,rtodd@hull.com,2022-02-22,https://www.collier.biz/
07-Aug-2021,Reversal,00.00,"37,327.50","186,637.49",bdcC0cFDEd7a0aB,3561,Helen,Huang,"Galvan, Shelton and Carr",South Brady,Mauritania,931.313.3374x88382,+1-102-932-1496,monroejody@bryant.com,2020-11-09,http://www.cervantes.com/
07-Aug-2021,ATM,00.00,"93,318.75","93,318.74",C17dab74930a79C,3546,Kristy,Fitzpatrick,Mccormick-Salazar,Orrton,Antigua and Barbuda,780-061-0442x427,422.432.2106,terrysharon@watts-reyes.com,2021-08-11,http://www.foster.com/
07-Aug-2021,ATM,"3,497.04",00.00,"96,815.78",19dB3E396bf4243,304,Gloria,Walters,Reed-Spencer,Michaelberg,Guernsey,(285)923-6414x985,095.027.6923x8251,jillfoley@oconnor-french.com,2021-11-20,http://kane.info/
07-Aug-2021,NEFT,372.00,00.00,"97,187.78",eCEE08Fb05B4BBE,8455,Bryce,James,Bean Group,West Kristen,Syrian Arab Republic,001-448-418-6568x822,001-866-900-5528x295,davidmcdowell@wheeler-burgess.org,2020-06-25,https://stuart-hunt.biz/
07-Aug-2021,Cheque,00.00,"48,593.89","48,593.89",6dc7EFb1dAe7FFe,9710,Harry,Harrell,Morales and Sons,New Beth,South Georgia and the South Sandwich Islands,001-915-276-9165x3636,001-218-858-7497x4051,hinesgwendolyn@combs.org,2021-01-30,http://www.villanueva-duncan.net/
07-Aug-2021,Reversal,00.00,"12,148.47","36,445.42",16e7F7b88F77fd2,3918,Bradley,Horne,Walsh LLC,Lake Anthonyside,Swaziland,+1-329-592-0360x702,2651828658,sherribush@sampson-hensley.org,2021-12-24,https://www.huynh.com/
07-Aug-2021,ATM,04.50,00.00,"36,449.92",8bEfF473c4b5C6f,7321,Desiree,Crane,"Johnson, Choi and Hinton",Reneeburgh,Ecuador,055-864-2672x243,8462917376,diamondpatterson@hardy-terrell.com,2021-07-18,http://www.morton.com/
07-Aug-2021,Interest,"3,372.23",00.00,"39,822.15",D770CF66Dd94a4f,8406,Curtis,Graham,"Henry, Taylor and Walton",South Ronald,Chile,(586)462-2570,(442)068-5380x81212,morenostuart@schmitt.net,2021-09-22,https://www.combs.biz/
07-Aug-2021,RTGS,00.00,"4,977.77","34,844.38",aCd0BFbcf7958bd,7181,Alvin,Ibarra,Dyer Group,West Edwardland,Argentina,527.775.0393x5666,(932)668-1664,hollowaykristie@camacho.com,2020-04-23,http://www.johns.com/
07-Aug-2021,Commission,00.00,"3,871.60","30,972.78",abCdE6AF6BA89ae,7952,Larry,Anthony,Perkins Ltd,Cynthialand,Netherlands Antilles,001-417-983-4841,1606312058,karlathomas@hess.com,2021-02-27,https://hess-michael.com/
07-Aug-2021,Commission,00.00,"3,871.60","27,101.18",C5DDd86f74EcCF4,8660,Nicole,Watson,Barker-Moody,Priscillafurt,Brazil,001-472-121-7688x9393,2319065584,yjacobs@sloan.com,2022-02-27,https://terrell.biz/
07-Aug-2021,Miscellaneous,00.00,"2,710.12","24,391.06",F6d0c75E3701EFa,1407,Isabella,Stanley,"Ali, Carroll and Carson",Kristineton,Burkina Faso,605.169.5443,001-616-953-7751,morsehelen@fox-serrano.com,2021-06-10,https://sandoval.com/
07-Aug-2021,Reversal,00.00,"12,195.53","12,195.53",A7734c4626ab39e,9784,Kristen,Clark,"Pierce, Dillon and Rubio",East Clayton,Trinidad and Tobago,191.482.5890x9523,(000)577-1550,drakealexis@yang.com,2021-02-23,http://knight.com/
07-Aug-2021,IMPS,00.00,"1,742.22","10,453.31",315fBcC0f3E2cEC,9721,Candace,Schwartz,Dean-Mckinney,Manuelbury,Sao Tome and Principe,001-622-711-6942x6028,001-630-336-2860x0071,jackie41@molina.com,2021-08-17,https://www.riley-bonilla.com/
07-Aug-2021,Tax,00.00,"1,045.33","9,407.98",fAB97e675E327F3,6395,Philip,Shannon,"Butler, Perez and Christian",Lake Danburgh,Saint Pierre and Miquelon,253.805.6031x67014,2509607820,schristian@frey.org,2020-09-06,https://hicks.net/
07-Aug-2021,Bill,"31,283.00",00.00,"40,690.98",EF0dcDf4EeF1CC6,9036,Toni,Nash,Davis Group,Owenschester,Madagascar,623.835.5112x8429,001-236-711-1266x89503,autumnbrennan@estrada.org,2021-10-06,https://www.carter.net/
07-Aug-2021,Miscellaneous,00.00,"13,563.66","27,127.32",Ff4174BCF03a8d0,6148,Marisa,Torres,"Ritter, Kramer and Chang",Kirbyport,Saint Barthelemy,001-739-621-9488x03901,5642514544,cameronruth@ellison.info,2021-09-04,https://foster-dunn.com/
07-Aug-2021,Reversal,00.00,"9,042.44","18,084.88",947E3b94CAeCEef,7442,Whitney,Neal,Flynn Inc,Freyborough,Romania,219.950.3125,001-499-049-3288x316,gonzalezmarco@moody-madden.org,2021-01-22,https://www.nunez.net/
07-Aug-2021,NEFT,00.00,"18,084.88",00.00,AF448EaC8b6b1Af,1886,Tasha,Pittman,"Ferrell, Pierce and Calderon",Haroldville,Sierra Leone,875-461-4445x82567,530.849.3398x587,leonardirwin@garner-krueger.info,2021-11-18,https://giles-orozco.com/
07-Aug-2021,NEFT,"1,075,455.20",00.00,"1,075,455.20",dccc39F2a8E5044,650,Marco,Brandt,"Leblanc, Brown and Downs",Carlyfort,Sierra Leone,(371)221-0584x58346,(216)882-9318,ebeck@macdonald.net,2021-03-29,https://www.raymond.net/
07-Aug-2021,Cash,00.00,"1,075,455.20",00.00,39cfaAAbFcbca34,6821,Dalton,Macias,"Vazquez, Paul and Harvey",West Chasefurt,Christmas Island,001-984-254-2322x62004,(237)187-0335x272,trevorhanna@hurley.biz,2020-12-04,http://www.petersen.biz/
07-Aug-2021,Cash,50.87,00.00,50.87,d59AfC9b255Aa8b,1672,Adam,Garrison,Clayton Ltd,West Stacie,Bermuda,001-822-021-0681x78994,001-059-304-7143,yhardy@watts-hayes.info,2020-08-10,http://sawyer-booth.com/
07-Aug-2021,Bill,00.00,07.27,43.60,b57bAd8e401a1AF,7907,Terry,Hood,Hardin-Howe,Port Victorside,Somalia,(298)432-4841x57397,846.781.0482,savannah00@lane.biz,2020-07-19,https://lawrence.com/
07-Aug-2021,Tax,"26,287.04",00.00,"26,330.64",31A7098a3Ab99c4,2067,Kathryn,Branch,"Ritter, Hill and Summers",Christianshire,Senegal,001-055-373-1450x6116,439.136.0624,zprice@reeves-wilkinson.info,2021-01-19,http://velez.com/
07-Aug-2021,Transfer,"27,802.50",00.00,"54,133.14",88c69a92A78beCb,4632,Yolanda,Bush,"Massey, Horton and Herring",Francisberg,Australia,+1-800-459-1169x84111,+1-260-937-2135x471,anneward@henry.com,2020-11-13,http://www.hill.com/
07-Aug-2021,Transfer,00.00,"6,014.79","48,118.35",2CB212FfbeFFBA3,8583,Meredith,Stone,Huff and Sons,West Shellyburgh,Holy See (Vatican City State),145-942-1798x2145,189-864-6411x97643,ann36@odonnell.biz,2022-02-01,http://www.potts.com/
07-Aug-2021,Bill,00.00,"9,623.67","38,494.68",cBaF2ebb2eFDA34,4470,Oscar,Huffman,Mays-Arellano,Brucefurt,Cuba,290-179-4737,(933)476-3246x0386,phelpsblake@sutton.biz,2021-12-28,https://www.mcbride.com/
07-Aug-2021,RTGS,50.00,00.00,"38,544.68",CbE7a1f6b80aD88,2467,Shelley,Hurst,"Delgado, Gonzalez and Snow",Port Lacey,South Africa,489.450.8045x10259,001-043-278-3528x85971,brittneynixon@cochran.com,2020-01-17,http://calhoun-cochran.com/
07-Aug-2021,ATM,06.00,00.00,"38,550.68",9342eaC1F12a7b3,5350,Dale,Flynn,Woodard PLC,North Renee,Botswana,+1-887-293-2791x8914,611-592-8457x1342,stokestheodore@ramirez-benitez.com,2021-08-02,https://www.hutchinson.com/
07-Aug-2021,ATM,00.00,"4,283.41","34,267.27",97aDf4215738A7B,1808,Marilyn,Macdonald,Hayes Group,West Carolineton,Faroe Islands,001-701-443-3527x036,+1-039-414-8064x046,devinrosario@byrd.com,2020-03-26,http://bright.net/
07-Aug-2021,Bill,00.00,"3,807.47","30,459.80",285767fa959679c,4697,Jordan,Singh,Andrews PLC,West Wandabury,Mozambique,5913132282,979-849-3514,whoward@frazier.org,2021-04-24,https://www.myers.com/
07-Aug-2021,Commission,00.00,"10,153.27","20,306.53",fc94fcFCc5EF4e3,4395,Jennifer,Sherman,Barton Group,East Jaime,Pakistan,046-074-2754x6836,9521219091,trevor59@mooney-clements.info,2021-11-08,http://www.soto-shields.com/
07-Aug-2021,Bill,06.71,00.00,"20,313.24",AEfAd4c1ea66Fb4,9973,Dalton,Fischer,"Vincent, Wiggins and Perry",South Aliciaville,Angola,(531)376-9227,001-204-122-2408,joannosborn@fitzpatrick.org,2022-04-21,http://www.huang-hamilton.org/
07-Aug-2021,Commission,00.00,"5,078.31","15,234.93",95b86D64c5fFB52,9117,Jasmin,Bailey,Green-Flowers,New Mckenzie,Turkmenistan,+1-398-261-9977x26252,001-821-237-9417x53863,vargasjimmy@roach-gallegos.com,2021-10-31,https://www.murphy-murray.com/
07-Aug-2021,Cheque,"1,973.70",00.00,"17,208.63",dD3FAF3b214dB3e,7070,Mia,Whitaker,Arellano-Shah,North Jason,Palau,923-445-4501x402,175-211-7274x5539,hinesvernon@gonzales.org,2021-08-29,http://www.mathis.com/
07-Aug-2021,NEFT,01.58,00.00,"17,210.21",7fe2B624892Dc90,7396,Mckenzie,Gibson,"Estes, Mendez and Owen",Marisaborough,Greenland,352.836.6973,202.884.5948,vortega@mccarty.net,2020-12-18,http://www.frederick.com/
07-Aug-2021,Tax,12.74,00.00,"17,222.95",6eE86b00C91Ec4C,8715,Taylor,Buckley,Lynch Ltd,Lake Jeremyberg,Niger,714.623.2103x115,156-064-7587x812,helen11@irwin.com,2020-08-24,http://baker.org/
07-Aug-2021,Debit Card,00.00,"17,222.95",00.00,FEAb644523069F3,7555,Jaclyn,Lin,Sexton-Valenzuela,West Sharimouth,Uruguay,001-759-920-2951x31287,743-643-5850,freid@sherman.info,2021-11-10,http://keller-tate.com/
07-Aug-2021,Interest,"201,308.80",00.00,"201,308.80",4Ff30dd4F3e1e80,3980,Crystal,Maldonado,"Mcclain, Casey and Little",Lake Jose,Northern Mariana Islands,757-444-7658x661,+1-514-091-5514,gardnerlawrence@austin-barr.com,2020-12-27,http://warner-stephenson.com/
07-Aug-2021,Debit Card,226.60,00.00,"201,535.40",760ec91Cf5bd84b,6681,Carol,Huang,"Hoover, Irwin and Houston",Lake Robert,Gambia,439-899-1307x4955,9089166378,lucas33@vega-mcintosh.com,2022-03-21,http://www.russell.info/
07-Aug-2021,Transfer,00.00,"201,535.40",00.00,fF30DF2Ce89686C,7537,Alice,Hale,Thomas-Harding,Lindsayfort,French Southern Territories,628.816.4969,(700)802-8563,alecmills@villegas.com,2021-08-07,https://shelton.com/
07-Aug-2021,Cash,06.00,00.00,06.00,A01fAD8d8FBFdFC,7317,Carly,Garner,Hancock-Mcdaniel,Petersfurt,Vietnam,(589)959-4035x15581,641-464-2986x5872,carrieyang@glover.net,2020-07-12,http://norton.com/
07-Aug-2021,NEFT,00.00,02.00,04.00,A35AddFB6807Fde,3080,Kent,Haas,Charles Group,Doriston,Sierra Leone,095.972.7928,381.490.6539,manuellucas@ramirez.com,2020-03-02,https://www.burns.com/
07-Aug-2021,Cash,00.00,00.67,03.33,15CC35C2A5Ca7be,4076,Claudia,Bartlett,Leach-Jarvis,Port Stefanie,Cyprus,(430)400-6725x98865,(158)771-4135x0567,fsaunders@arellano.net,2020-10-02,https://www.hahn.com/
07-Aug-2021,Commission,"189,429.40",00.00,"189,432.73",DFEA9B9e090469C,775,Sandra,Maddox,Everett-Ferrell,Lake Elaine,Central African Republic,727.973.4919,(034)917-9924x573,fred20@frederick.com,2020-09-17,https://www.mills.com/
07-Aug-2021,Interest,00.81,00.00,"189,433.54",7ffdc6cfcB8bEf6,2259,Julian,Walsh,Gross Inc,Greerside,Guernsey,001-099-171-6423x5891,001-828-288-8801x73174,qrobles@robbins.info,2020-05-04,https://www.mullins-hodges.net/
07-Aug-2021,Transfer,00.00,"94,716.77","94,716.77",3Afab3c6abdE5E3,1636,Isaac,Hendricks,Ruiz-Harrison,South Corey,Bahamas,341-892-9798x0347,169-549-4280x2691,tammy32@mendoza-richards.net,2021-04-03,http://www.wolfe.com/
07-Aug-2021,NEFT,00.00,"11,839.60","82,877.17",93e6f8bDCb4D1AC,2116,Chad,Nguyen,Mccann LLC,New Gracebury,Mauritania,492-075-5960,(785)636-2008x449,isaac73@hood.com,2021-04-03,https://forbes-garrett.net/
07-Aug-2021,Bill,00.00,"10,359.65","72,517.52",f826accf8E21ceC,8364,Hayley,Best,Kaiser Inc,Danielsborough,Liechtenstein,883-358-5193,(606)937-1426x626,noah80@mora.com,2022-05-22,https://www.dyer.biz/
07-Aug-2021,Cheque,09.77,00.00,"72,527.29",b0fd5F30cf65A2c,8491,Sandy,Beck,Ryan-Morton,South Robinside,Solomon Islands,+1-975-516-3824x6205,(550)122-8468x121,jcisneros@marquez-herring.org,2020-08-28,https://gallagher-miles.info/
07-Aug-2021,Transfer,"234,979.00",00.00,"307,506.29",1dDAdaD79586b17,5522,Benjamin,Malone,Gordon-Hopkins,South Desiree,Taiwan,001-615-314-3507x3405,+1-904-756-2228,shelbylara@brady.com,2020-07-30,http://conrad.net/
07-Aug-2021,Miscellaneous,00.00,"102,502.10","205,004.19",bcd6D1c06caC16B,5628,Sonia,Wilkerson,Mcdonald Ltd,Vangshire,Mongolia,493-775-2867x6957,(017)519-4071x285,autumn55@schaefer.net,2021-07-28,https://www.blake-bray.com/
07-Aug-2021,Tax,"225,004.10",00.00,"430,008.29",C5d3A983dE8B7Af,1151,Autumn,Morrow,Cain-Key,Gavinmouth,Puerto Rico,(364)863-0943,001-598-633-2610x1437,obright@shah.org,2021-11-23,https://www.guzman-foley.net/
07-Aug-2021,Transfer,"1,562,084.75",00.00,"1,992,093.04",Da2a4b1fCbd34cb,9537,Fred,Johnson,Neal Ltd,Danielston,Benin,168-735-7077x32575,098.546.1665,eric33@moran-kline.info,2022-01-17,http://www.vazquez-eaton.com/
07-Aug-2021,Miscellaneous,00.00,"249,011.63","1,743,081.41",EBbC478FdAd2E4d,5142,Kirk,Howard,Nicholson-Rivera,Simsmouth,Syrian Arab Republic,028.551.2010,299-027-3350x0898,bassgeoffrey@todd-haynes.com,2021-09-24,https://cox-phelps.org/
07-Aug-2021,Commission,"3,432.00",00.00,"1,746,513.41",DECAc9dfD8b2169,7534,Lindsay,Guerrero,Landry-Schmidt,Hannaside,Kyrgyz Republic,+1-711-856-7390x0171,(911)938-1976,basskatrina@grimes.com,2021-09-24,http://www.choi.com/
07-Aug-2021,NEFT,30.00,00.00,"1,746,543.41",Ddc284Ca2e2CAe9,1496,Jennifer,May,Delgado Ltd,New Virginiashire,Azerbaijan,243-674-1479x418,041-829-3862x4309,stephensonlori@villa.biz,2021-01-03,https://salinas.com/
07-Aug-2021,NEFT,03.00,00.00,"1,746,546.41",f4a5ACed764DCd9,4577,Janice,Davis,"Ho, Mcmillan and Andrews",North Christinastad,Guinea-Bissau,(805)694-1182x27435,212-539-5784x287,abigailyu@oconnell.org,2022-05-16,https://huang.com/
07-Aug-2021,IMPS,61.86,00.00,"1,746,608.27",84a37Cb3792AAdD,8325,Natalie,Merritt,Whitaker and Sons,Lake Samanthaland,Azerbaijan,001-609-457-1190x533,(350)382-2521,tonyalara@landry.com,2021-05-31,http://www.fox-moore.com/
07-Aug-2021,ATM,03.60,00.00,"1,746,611.87",A48a5304CAC6dee,9118,Jessica,Reyes,Stone LLC,Leonardstad,Sao Tome and Principe,001-251-944-6068x2051,209-745-5580x755,hebertamy@wang.com,2021-08-15,https://www.mckinney.com/
07-Aug-2021,Bill,"104,626.88",00.00,"1,851,238.75",A77fc8e7C585cCf,4388,Mary,Stein,Henderson-Duran,Lake Matthew,Barbados,+1-119-575-2988x057,(516)713-0024,odunn@haley.com,2021-10-03,http://patterson.com/
07-Aug-2021,Cheque,303.00,00.00,"1,851,541.75",EBC84eaFB9AC061,9405,Kimberly,Duke,Berger LLC,West Madisonburgh,United States of America,+1-715-311-0882x99283,9172686866,alicehaas@ruiz.org,2022-03-25,https://www.valentine.net/
07-Aug-2021,Debit Card,00.00,"264,505.96","1,587,035.79",4B27EC39Ab83D9E,2384,Pedro,Ayers,"Dunn, Conley and Elliott",Port Vincentberg,Albania,6480940275,(747)434-7961x512,alejandro04@riggs.org,2020-08-05,https://www.wells.com/
07-Aug-2021,Interest,"148,600.00",00.00,"1,735,635.79",dEDa1a7Acf11A2f,2586,Miranda,Villa,Cummings LLC,Lake Davidhaven,Uzbekistan,+1-185-920-3303x6156,0387183534,twalsh@macdonald.net,2021-05-12,https://www.sawyer.com/
07-Aug-2021,Reversal,23.00,00.00,"1,735,658.79",BedfbB8AEADF1D5,6557,Jimmy,Abbott,Black Ltd,New Veronicaside,Indonesia,485.570.2703,951-656-8620x96343,zachary01@anderson-forbes.com,2020-01-10,https://www.everett.com/
07-Aug-2021,Commission,72.70,00.00,"1,735,731.49",9e2fA9CF143e8A0,6549,Steven,Stanley,Vaughan PLC,Mullinsville,Wallis and Futuna,(642)352-4206,145.947.0052,mejiajon@jefferson.net,2020-04-22,https://www.hebert-taylor.biz/
07-Aug-2021,RTGS,"44,440.44",00.00,"1,780,171.93",28F79B7eEc472BE,3190,Erik,Meyer,Garcia Ltd,East Spencerstad,Maldives,487.045.1380x81711,930.328.9453x97098,kelliemcgee@burke-henderson.com,2020-02-05,http://www.calderon.biz/
07-Aug-2021,Commission,47.00,00.00,"1,780,218.93",16674Af6e17032E,9978,Jerry,Oneal,Hansen Group,West Dylan,Holy See (Vatican City State),913-114-6135x645,041-007-3095,raven56@ross.com,2021-12-04,https://may.info/
08-Aug-2021,Debit Card,25.00,00.00,"1,780,243.93",e1B07addD3A0eea,9442,Elizabeth,Cooper,"Wilcox, Fuller and Sloan",North Lucas,Peru,(522)898-9494,(518)932-0605,alexandercisneros@wright.com,2021-07-18,https://www.lane.org/
08-Aug-2021,NEFT,211.50,00.00,"1,780,455.43",Fb0FDba4e37AF5B,2525,Felicia,Andersen,Fischer-Wilcox,Lake Dustinhaven,Saint Kitts and Nevis,0367606756,(610)484-1001x931,qcowan@conley.com,2022-01-04,http://www.roy-stone.info/
08-Aug-2021,Bill,00.00,"445,113.86","1,335,341.57",311afdFA8FC4C2f,4120,Tamara,Galvan,"Martinez, Moses and Fletcher",Jaredport,Reunion,(876)843-8465x42088,801.620.5008,pagewayne@bowman.com,2022-03-18,https://sanford-rojas.biz/
08-Aug-2021,NEFT,00.00,"1,335,341.57",00.00,7DB5d6CE47C0fd2,1080,Krista,Munoz,"Warner, Sexton and Reynolds",West Karina,Namibia,(078)652-1321,+1-374-702-5040,anaeaton@vazquez.com,2021-07-24,https://www.wagner-stein.net/
08-Aug-2021,Tax,"1,469.55",00.00,"1,469.55",edc646126B41eb6,2340,Clarence,Weaver,Woods-Vincent,East Alejandro,Puerto Rico,+1-601-346-0717x3603,201-932-3613,popematthew@foley.com,2020-08-01,https://www.drake.net/
08-Aug-2021,Bill,23.89,00.00,"1,493.44",5d53c5149eAE99B,8534,Jesse,Simmons,"Phillips, Day and Odom",Ninaport,Switzerland,5184377668,+1-709-243-7310x238,ykhan@mclaughlin.com,2021-01-19,http://www.keller-green.info/
08-Aug-2021,Transfer,"1,988.67",00.00,"3,482.11",8DEfDed1B5AF20A,9867,Haley,Keller,Sullivan Ltd,Pearsonstad,Switzerland,530-281-7887,951-532-2272x81874,kiara18@cook.net,2020-08-19,http://ritter.com/
08-Aug-2021,Bill,"1,744,521.25",00.00,"1,748,003.36",15c065936ddCB8F,4032,Blake,Davis,Ingram LLC,Grantberg,Svalbard & Jan Mayen Islands,239.834.6489x99455,869.502.6705,tristanrubio@villegas-boone.com,2020-05-25,https://burgess-pearson.com/
08-Aug-2021,IMPS,00.00,"874,001.68","874,001.68",63FA0cEb1cf0fF2,4886,Tara,Mckay,Branch and Sons,Rogerschester,Japan,001-063-286-9894x889,397.921.0407x83516,vfloyd@dunn-spears.com,2020-12-30,http://morse-lara.com/
08-Aug-2021,NEFT,02.69,00.00,"874,004.37",2f9F0c87EEbfBd7,6742,Shelia,Garza,Leon-Bell,North Andrewhaven,Czech Republic,+1-643-748-3369x166,(908)142-7018,morristravis@castro.com,2021-02-09,https://downs.com/
08-Aug-2021,Cash,00.00,"218,501.09","655,503.28",Ee3F175ECBBAA1c,4661,Diana,Mitchell,Myers LLC,Madisonland,Singapore,(543)042-0144,910-603-7738x087,brandi37@wilcox.org,2020-02-17,https://www.black-garrison.com/
09-Aug-2021,Interest,00.00,"81,937.91","573,565.37",27b2a3FC4a3Afd8,3646,Randall,Cunningham,Ramos-Pruitt,Randalltown,Saint Kitts and Nevis,723-235-1194,001-449-298-9100x662,rfox@figueroa-pruitt.com,2020-08-19,https://www.garrett.com/
09-Aug-2021,Debit Card,00.00,"57,356.54","516,208.83",9dFb98cc4F2ff3E,2922,Ebony,Weber,"Farrell, Anderson and Mann",Alvarezville,Guadeloupe,(184)141-0460x66690,(420)917-7735,jeanne63@bird-aguirre.info,2020-05-05,http://hayes.com/
09-Aug-2021,Transfer,"247,681.20",00.00,"763,890.03",b389BDfC3F2537D,2429,Gabriela,Cook,Hamilton-Shepherd,Jorgefurt,Venezuela,+1-909-618-1745x587,+1-665-886-8494,phyllis97@garza-newman.info,2021-03-24,http://www.ballard.com/
09-Aug-2021,Interest,00.00,"381,945.02","381,945.02",E0d32414eBDCfA5,2934,Grace,Walton,"Hammond, Carpenter and Chambers",Adkinsside,Kiribati,500.702.4118x91233,(508)045-3218,mahoneysheryl@rich.org,2020-01-02,https://www.hebert.info/
09-Aug-2021,Purchase,00.00,"47,743.13","334,201.89",87D7420354C5dC0,2265,Ricardo,Jones,"Jefferson, Moon and Hogan",Lake Stacy,Korea,(560)462-2868x0863,(497)197-0764x697,vcox@medina-daugherty.com,2022-05-02,https://www.glass.com/
09-Aug-2021,Cheque,00.00,"167,100.95","167,100.94",Be2eAcF77d15cDf,8791,Jeremy,Sloan,Harding-Roberts,Benjaminside,Brazil,092-788-9658,853-072-1732x9432,bray@chavez-rodriguez.com,2020-09-20,http://www.gay.info/
09-Aug-2021,Transfer,"175,231.59",00.00,"342,332.53",96AD18E116016c0,9199,Jeremy,Ramirez,"Bailey, Weeks and Houston",Benjaminfort,New Zealand,001-357-821-8869x0092,(464)036-8349x24555,gabrielramirez@knox-bush.com,2021-12-04,http://turner.com/
09-Aug-2021,Cheque,00.00,"57,055.42","285,277.11",4dcAdb4847CD290,2708,Randy,Frye,Chaney-Barton,Pughview,Brazil,+1-643-630-6590x4746,(481)425-5643x34356,cobbtracey@valenzuela.com,2020-04-26,http://www.york.net/
09-Aug-2021,Transfer,00.00,"95,092.37","190,184.74",aA8C7B4613cC34C,2878,Toni,Cortez,Kelly LLC,Port Darlene,El Salvador,(785)334-4897x632,(306)744-1636,dbeltran@barker.com,2022-01-06,https://www.freeman.com/
09-Aug-2021,Cheque,"702,084.00",00.00,"892,268.74",FFFfdFBC1BADcb3,772,Seth,Perez,"Watts, Murphy and Montes",Zacharybury,Luxembourg,(399)581-8897x549,036.223.2396x365,bill33@beard-rice.com,2021-09-30,https://www.ramirez.com/
09-Aug-2021,Purchase,00.00,"223,067.19","669,201.55",5Fe6A5796fc19c5,6991,Veronica,Prince,"Bennett, Allison and Brandt",Lake Hector,French Guiana,521-877-7221x7293,001-332-408-6052x2867,doughertyterry@bender.info,2021-06-11,http://spears-mccoy.com/
09-Aug-2021,Tax,"164,801.00",00.00,"834,002.55",a90cC02fAD6f876,5933,Joanne,Leach,"Donaldson, Michael and Montes",South Claudia,South Africa,001-061-307-3815,801-854-3037,fblackwell@werner.info,2022-03-14,http://www.rosario.net/
09-Aug-2021,Cheque,00.00,"92,666.95","741,335.60",D4dFeC29Ca7f338,4104,Sandra,Mccall,"Moses, Warren and Mays",Eugenemouth,Ecuador,001-948-636-4511,7412350841,xroberson@beltran-buck.com,2022-02-08,http://wise.com/
09-Aug-2021,Reversal,00.00,"247,111.87","494,223.73",5B8Ffc59EeBd87D,9994,Bernard,Wolf,Huynh-Best,Port Barryborough,Bhutan,977.287.5016x4827,337-342-2622x707,rmorse@lane.com,2021-04-29,http://www.sweeney.com/
09-Aug-2021,RTGS,"1,013,186.80",00.00,"1,507,410.53",Fbe6BC97a0C2Ba3,3193,Jorge,Owen,Nixon PLC,South Christianview,Lebanon,249-752-1605,(325)715-3524x5298,dtyler@bell-bailey.com,2021-02-12,http://www.adams.net/
09-Aug-2021,Debit Card,"8,072.06",00.00,"1,515,482.59",19EE920b5514dD6,6685,Latasha,Peterson,Wyatt-Mendoza,West Dalton,France,+1-540-861-2915,327-464-8511x77153,claire01@stevens.com,2021-04-03,http://www.conrad.com/
09-Aug-2021,Miscellaneous,00.00,"303,096.52","1,212,386.07",617BEdC1Fe048bD,8677,Frederick,Esparza,"Branch, Cummings and Doyle",Villanuevaborough,Trinidad and Tobago,001-223-837-0084x201,(583)237-3171,freysherri@mcguire.org,2021-08-30,https://www.peters.net/
09-Aug-2021,Cash,00.00,"121,238.61","1,091,147.46",FE1CD67ba32Adde,8497,Darryl,Ewing,"Simon, Barton and Russell",Dorischester,Cyprus,(675)366-6873x092,+1-349-231-2527x87182,nathaniel57@byrd.com,2021-11-02,https://brady.com/
09-Aug-2021,Reversal,00.00,"545,573.73","545,573.73",fCF027f2A34FdBE,444,Colin,Hammond,Myers Ltd,Hendrixview,Senegal,359.871.9570,552.585.1831x111,jaime31@gray.com,2020-09-27,http://forbes-valdez.org/
09-Aug-2021,Debit Card,05.00,00.00,"545,578.73",AeFF1cF6aD662C6,8015,Marissa,Avery,Andersen-Foster,Lake Mindytown,Hong Kong,001-092-859-2906x1319,001-008-502-5438x7631,gavin01@arellano.com,2020-03-27,http://www.sampson.net/
09-Aug-2021,Tax,"14,475.93",00.00,"560,054.66",318C871DC39180F,7149,Kristina,Andrade,Mooney-Braun,South Brandi,Bahamas,001-476-620-0143x943,001-784-479-5295x4030,englishstephanie@cole.info,2020-02-14,http://mercer.org/
09-Aug-2021,NEFT,00.00,"112,010.93","448,043.73",bAF7eba25fFf9d3,7731,Julian,Pace,Pineda Group,North Charles,Falkland Islands (Malvinas),767.295.6618x599,746.459.8105x16356,fordkari@rodgers.com,2021-03-08,https://melendez-blanchard.net/
09-Aug-2021,ATM,00.00,"224,021.87","224,021.86",2ca4D2B1CbBad6B,3508,Gary,Pineda,Greer LLC,West Lawrence,Moldova,001-204-935-8920x9296,001-102-865-5439x517,trojas@cameron-martin.info,2021-03-08,https://morris.com/
09-Aug-2021,Bill,"35,571.00",00.00,"259,592.86",b5833b20B6f0FF1,6804,Tyrone,Morales,Cannon PLC,Duaneville,Mali,673-817-4380,484-436-6488,breannaburns@wright-mahoney.org,2020-02-07,http://www.larsen.com/
09-Aug-2021,Interest,00.00,"51,918.57","207,674.29",f2d510Aded02a29,9155,Michaela,Finley,Dorsey Inc,Port Aimee,Guam,001-836-114-5033x2565,773.387.3701x62743,zhoffman@blake.biz,2020-12-01,https://arellano.info/
09-Aug-2021,NEFT,00.00,"51,918.57","155,755.72",d6EA2B6ea2642ff,8652,Evelyn,Vance,Dixon PLC,Teresafurt,Eritrea,657.785.9295x9738,(800)160-6602x239,suarezguy@atkins-juarez.com,2021-11-13,https://ingram-nolan.com/
09-Aug-2021,Cheque,00.00,"31,151.14","124,604.58",f0bFeBE2EcC6E44,308,Elijah,Wagner,Snyder-Mccoy,West Diane,Somalia,151-710-4724x7177,+1-904-493-3489x267,opace@conway.net,2021-06-06,http://haley.net/
09-Aug-2021,Tax,00.00,"41,534.86","83,069.72",db4CBcbFfC2DBfa,461,Lydia,Banks,Kennedy LLC,Riosland,New Zealand,+1-480-761-9968x75709,001-887-395-5014x91968,nbuck@dalton.com,2020-07-26,http://hill.net/
09-Aug-2021,NEFT,00.00,"16,613.94","66,455.78",500aec857FFc945,5980,Stephen,Riley,Shepard Ltd,Port Katrina,Niue,+1-511-202-6207,925.348.2300,qbarr@landry.biz,2020-09-07,https://www.humphrey.com/
09-Aug-2021,Cheque,"119,643.00",00.00,"186,098.78",38Bfb3eda7f85b0,4627,Alejandro,Cameron,Orozco and Sons,West Alexandriafurt,Korea,9407387372,(814)040-3102x407,gardnerlee@may.net,2020-05-06,https://www.costa-glenn.biz/
09-Aug-2021,Interest,"28,185.80",00.00,"214,284.58",7Dc9E4AD643af9e,7934,Debra,Curtis,"Gordon, Ramsey and Duke",Saundersberg,Micronesia,(285)009-3286x1348,001-200-409-9719x346,kellycoffey@fitzpatrick.com,2020-04-10,http://gregory.com/
09-Aug-2021,Tax,00.00,"42,856.92","171,427.66",5306bCcCAACA922,6943,Garrett,Estrada,"Crosby, Moses and Best",Lake Eugene,Barbados,015.049.5163x181,679.375.6822x5661,ernest31@moore.com,2021-10-24,http://www.ibarra.com/
09-Aug-2021,Commission,00.00,"21,428.46","149,999.20",f9Be6F3d2BAcc1E,7504,Melvin,Gibson,Whitaker-Brewer,North Yesenia,Madagascar,775.701.5643x92755,130-285-7393x332,harrellisaiah@chen-donaldson.com,2020-02-01,http://www.coffey.com/
09-Aug-2021,IMPS,00.00,"24,999.87","124,999.33",BCF6E71ffAe0ebA,4793,Alvin,Lambert,"Avila, Wood and Cowan",South Gary,Northern Mariana Islands,+1-097-666-3833,(091)827-6537x154,norrisjo@beard.com,2020-10-15,http://cole.com/
09-Aug-2021,RTGS,02.90,00.00,"125,002.23",A35AddFB6807Fde,3080,Kent,Haas,Charles Group,Doriston,Sierra Leone,095.972.7928,381.490.6539,manuellucas@ramirez.com,2020-03-02,https://www.burns.com/
09-Aug-2021,Cheque,"151,608.90",00.00,"276,611.13",2E9C41E8Fca20f1,5856,Bianca,Payne,Galloway LLC,Lake Kevinville,Paraguay,001-705-659-9976x1354,589-785-1340,baxtergabriella@richmond.com,2020-09-06,http://pena.biz/
09-Aug-2021,Commission,00.00,"30,734.57","245,876.56",d4d2e1a1aD7df6C,936,Darren,Fuller,"Mccarty, Powers and Blackburn",Whiteheadview,Faroe Islands,800-187-0481,001-007-220-6286x96262,sharonwhitaker@marsh-webster.org,2022-04-28,http://www.oneill.com/
09-Aug-2021,RTGS,00.00,"35,125.22","210,751.34",Beb14Bbee95FEFE,6836,Nancy,Baldwin,Mcbride-Zavala,Wallerton,Kyrgyz Republic,340-687-9715x989,(136)687-4732x2797,mezakristine@knox.org,2021-04-21,http://chen.com/
09-Aug-2021,Transfer,00.00,"52,687.84","158,063.50",cBf502b528ed889,2808,Cameron,Leonard,"Morgan, Santiago and Gaines",Schneiderhaven,Taiwan,613-329-9419,001-825-385-2046,victoriamccullough@joyce-villegas.com,2020-10-21,http://www.rollins.net/
09-Aug-2021,Tax,60.00,00.00,"158,123.50",fA8d3f90B787641,2139,Yesenia,Shepard,Contreras-Bowers,Rollinsport,Indonesia,148.884.0565x0750,+1-702-511-2163x5356,wwilliams@khan.com,2021-02-13,https://franco-gentry.com/
09-Aug-2021,Miscellaneous,"3,465.00",00.00,"161,588.50",Deca2C5867aB3ca,7761,Nathaniel,Parker,Elliott-Moyer,West Rebekahland,Turks and Caicos Islands,743-336-2430x756,800-771-0650,gavinstokes@horton.com,2020-06-12,http://www.drake-petty.biz/
09-Aug-2021,ATM,00.00,"23,084.07","138,504.43",6c82627B47fCad3,9813,Reginald,Weiss,Mendoza-Sloan,Vargasburgh,Kuwait,(466)747-2388x6309,(721)032-8243x0364,hduncan@miller.com,2020-12-15,http://mora.net/
09-Aug-2021,Cash,24.15,00.00,"138,528.58",CbBc4C1ed7Ae6F6,6772,Collin,Lester,Cameron Group,Dannyport,Jersey,001-754-730-6777x2479,+1-326-332-9874x468,angelingram@snow.org,2022-05-20,http://andrade.com/
09-Aug-2021,IMPS,"5,333.00",00.00,"143,861.58",8a9a10BD9D46b9A,4545,Felicia,Abbott,Wood-Hinton,North Trevorbury,New Zealand,526.367.2552,+1-375-609-2802x5394,tarajones@rios-humphrey.com,2021-07-07,http://www.douglas.info/
09-Aug-2021,Interest,453.37,00.00,"144,314.95",0eFeA9aBcc73eBF,2982,Philip,Salas,Calhoun-Farley,Woodwardstad,French Polynesia,(472)273-5884x4355,794-270-1006x9880,patricia07@joseph-deleon.biz,2020-05-18,https://www.lyons-holmes.biz/
09-Aug-2021,Commission,"252,969.00",00.00,"397,283.95",Ae477E4DE4242Ae,5564,Samuel,Petersen,"Lang, Cardenas and Paul",Lake Kelsey,Belarus,353-801-3661,363.408.0962x18161,jacobsontammy@glenn.net,2021-12-05,https://leonard.net/
09-Aug-2021,Debit Card,06.40,00.00,"397,290.35",A634Af2aBBD3dE4,3433,Calvin,Murphy,Cardenas and Sons,Timothyborough,Latvia,(292)171-3250,(146)921-2142x885,elijah44@lambert.com,2021-11-16,http://www.holloway.info/
09-Aug-2021,IMPS,300.00,00.00,"397,590.35",A7e177F7a1E823b,6455,Nathan,Sherman,"Pitts, Jarvis and Gillespie",Port Rogerville,Croatia,(278)807-0382x03991,(440)191-8284x8157,faithbarrett@richardson.com,2021-08-28,http://www.maynard-bradford.info/
10-Aug-2021,Cheque,"22,756.00",00.00,"420,346.35",Fbf89bACC9D82a4,5751,Larry,Patterson,Clayton-Page,East Cameronfort,Jersey,075.098.0124x8399,+1-717-292-1322x57840,johnmartin@calderon.org,2021-04-25,http://cervantes.com/
10-Aug-2021,Reversal,00.00,"140,115.45","280,230.90",FB82DDa596361fC,8426,Bobby,Knight,Wu Ltd,Janeburgh,Iraq,+1-253-684-3839x6032,331-780-2576,itownsend@terry-case.org,2020-11-03,https://www.oneill.com/
10-Aug-2021,Commission,00.00,"140,115.45","140,115.45",2Dc4F6B5491a5AE,4747,Jasmin,Huffman,Barry-Simpson,Shellymouth,San Marino,(035)277-2232,3041188185,haydendudley@hunt.info,2021-12-10,http://hull.info/
10-Aug-2021,Reversal,46.30,00.00,"140,161.75",F88f8Bac77Ff5D1,5113,Paul,Solis,Gay PLC,Laneshire,Cuba,+1-568-619-0790x106,001-894-639-0558x3022,mallorybriggs@pratt.org,2021-11-09,https://matthews-buck.com/
10-Aug-2021,Purchase,00.00,"140,161.75",00.00,1ceAFc50CEbD37B,9901,Laura,Burton,Dickson PLC,New Mollyshire,Puerto Rico,276-417-1795,001-325-059-6759x30537,kirkharding@ortega.com,2020-12-16,https://howell.com/
10-Aug-2021,Tax,"178,685.00",00.00,"178,685.00",eEb1aaDd31c8Fd6,9308,Sheryl,Huff,"Hanna, Foley and Avery",West Dalton,Christmas Island,(655)914-7614,+1-124-882-0755x6669,qwall@klein.com,2020-08-02,https://www.johnson.com/
10-Aug-2021,Purchase,00.00,"19,853.89","158,831.11",C827B1af2A1C576,3858,Diana,Chung,Faulkner-Washington,Tommyburgh,Brazil,+1-008-666-3365x5166,374-793-9273,genebrady@poole.biz,2022-04-27,http://www.haney-moon.com/
10-Aug-2021,Purchase,00.00,"19,853.89","138,977.22",359FdCFad917b2c,9848,Earl,Suarez,Odom PLC,Lake Jennifer,Trinidad and Tobago,001-105-671-4897,+1-572-032-1172x38903,traci90@bird.com,2021-05-12,https://www.ponce.com/
10-Aug-2021,NEFT,00.00,"27,795.44","111,181.78",c67A24bBdF7B3d7,9041,Dan,Blanchard,Romero-Le,South Debraland,Bermuda,576-466-1267,(763)637-7952x04286,eddiepotts@ayala-austin.com,2021-09-16,http://ayala-porter.com/
10-Aug-2021,Bill,48.04,00.00,"111,229.82",e1bc8dfACAD5Abc,5754,Riley,Cain,Best-Thompson,Rachelborough,Slovakia (Slovak Republic),001-854-447-3498x2544,863.066.0668x22891,peter16@wu.com,2020-09-22,http://hogan.net/
10-Aug-2021,Bill,00.00,"13,903.73","97,326.09",1EF98D8f597a6EB,5989,Donna,Barker,"Hodges, Wang and Wiggins",Kaylabury,Cook Islands,001-702-800-8528,001-764-196-7590x926,toni89@briggs-harmon.info,2021-03-13,https://www.mayer.com/
10-Aug-2021,Cheque,00.00,"32,442.03","64,884.06",BBBff63AedF1eb0,1855,Kendra,Barnett,Jordan and Sons,Changville,Tunisia,+1-180-987-6830x3399,001-693-358-4345x39003,ybarron@rios-hendricks.com,2020-10-01,http://moreno-stokes.com/
10-Aug-2021,Debit Card,00.00,"32,442.03","32,442.03",F4195E9e1621bD7,960,Alison,Riggs,Hall-Blackburn,Judithbury,Ethiopia,960.068.4536,(071)103-8359x4594,duranshawn@bowers.com,2022-03-30,http://www.mullen-morris.com/
10-Aug-2021,Reversal,"608,563.00",00.00,"641,005.03",dA23dA7eb28CCA9,458,Daniel,Charles,"Dorsey, Cook and Kaufman",Port Gilbertfort,Libyan Arab Jamahiriya,618.772.9522x892,001-047-754-2640,marvinwoodard@lam.biz,2020-03-07,http://braun.com/
10-Aug-2021,Reversal,10.50,00.00,"641,015.53",F2a44D88AfcDEeB,4293,Alyssa,Knight,Leach-Gamble,New Dalton,Gabon,(657)878-3639,001-130-774-5993x8831,ceverett@gamble-faulkner.com,2021-07-25,https://lindsey-duncan.com/
10-Aug-2021,RTGS,"46,904.56",00.00,"687,920.09",cB5994100151F5F,8815,Nancy,Hays,Vega-Guerra,North Jeffery,Mauritius,001-541-709-5989x85241,+1-890-604-8059x216,lanesharon@allison.biz,2020-02-21,http://www.smith-doyle.com/
10-Aug-2021,ATM,"1,715.60",00.00,"689,635.69",b1BabAFCce090F5,9791,Alejandro,Cameron,Richardson Ltd,Louisburgh,Senegal,426.235.9969x94451,(317)642-6419x2108,alan20@willis.org,2021-02-12,https://www.gallegos.com/
10-Aug-2021,Reversal,"65,127.75",00.00,"754,763.44",f5166ff8847B7eB,8674,Devin,Gonzalez,Saunders Group,Colinmouth,Canada,591.148.6438x9868,001-010-588-4537,shanegiles@francis.com,2020-06-07,https://curtis-trevino.com/
10-Aug-2021,Cheque,"353,849.80",00.00,"1,108,613.24",Fc1AEA19E7D000B,2003,Jade,Oneal,Harding-Barber,South Mikaylabury,Estonia,(259)793-8011x185,001-792-433-2130x76837,dshaw@baker-morris.com,2020-07-01,https://cervantes.com/
10-Aug-2021,Commission,00.00,"110,861.32","997,751.92",3dFac1832FedfCb,9595,Cole,Hampton,"Casey, Cunningham and Sheppard",Camachobury,Cayman Islands,688.289.5878,443-125-9079x64724,leeashley@henderson.net,2022-04-06,https://hoover-mcguire.net/
10-Aug-2021,RTGS,00.00,"332,583.97","665,167.95",Ef03b9DcbFbe3Cd,1841,Yvette,Phillips,Dickerson and Sons,New Caitlinburgh,Montenegro,001-828-468-3820x51710,7632323716,tballard@carey.com,2020-03-22,http://carter.com/
10-Aug-2021,Bill,"4,027.60",00.00,"669,195.55",bFf6FB8b3F0852B,2976,Wanda,Lowery,"Osborn, Wolfe and Knox",Ricardoview,Taiwan,027-885-3739x851,227-419-1561x953,smithfelicia@mora-yates.com,2021-01-21,http://www.alvarado-craig.com/
10-Aug-2021,Reversal,00.00,"133,839.11","535,356.44",aFCABc1d6d7eEDc,4273,Yvette,Stephens,Ali-Gill,Goodwinhaven,New Caledonia,001-294-638-4800x771,982-359-9426x9656,morrisemily@brandt-myers.com,2021-01-19,http://www.sweeney.com/
10-Aug-2021,Bill,00.00,"89,226.07","446,130.37",eDACCb9ecaA5E73,3383,Stefanie,Castillo,Owens Group,Hardingfort,Norway,232.529.8173,949.536.7015,eyork@velez-valentine.info,2020-11-05,http://shannon-summers.com/
10-Aug-2021,Cash,00.00,"111,532.59","334,597.78",a895a9dfea93dD7,6979,Michael,Beasley,Schroeder LLC,New Cheryl,Togo,001-629-907-7727x336,199.675.0432x0753,jeanettemarshall@gay-haney.info,2020-12-19,https://ward.com/
10-Aug-2021,Cash,00.00,"37,177.53","297,420.25",5c4BC033ac4Efab,1062,Leonard,Macias,"Nielsen, Macias and Webster",West Seanborough,Thailand,001-776-128-9104,+1-666-258-5190,lvasquez@webb.org,2020-04-20,https://www.butler-lowe.com/
10-Aug-2021,Interest,00.00,"297,420.25",00.00,79e3dbccCcFDC59,5022,Belinda,Rose,Horton-Velasquez,East Darius,Solomon Islands,001-453-230-8985x249,772-366-1331x29953,timdurham@frost.com,2021-07-28,http://www.bullock-chapman.com/
10-Aug-2021,Debit Card,"10,450.84",00.00,"10,450.84",fadde5f0dFeAfFD,647,Philip,Ortega,Wiggins PLC,West Tara,New Caledonia,(315)270-9384x011,(323)576-6343x46232,conniefowler@bryant-valencia.com,2021-06-07,https://horton.com/
10-Aug-2021,Transfer,00.00,"2,090.17","8,360.67",Af3E3ff2baB07de,5182,Jorge,Aguilar,"Hartman, Gomez and Tran",Lake Greg,United Kingdom,652-581-4738,001-246-668-1667x951,hicksaimee@black-johnston.com,2021-05-09,https://www.browning-lang.com/
10-Aug-2021,Debit Card,"1,541.56",00.00,"9,902.23",EBbC478FdAd2E4d,5142,Kirk,Howard,Nicholson-Rivera,Simsmouth,Syrian Arab Republic,028.551.2010,299-027-3350x0898,bassgeoffrey@todd-haynes.com,2021-09-24,https://cox-phelps.org/
10-Aug-2021,Reversal,"25,719.79",00.00,"35,622.02",a9B478dAb98e1D4,5943,Shelly,Anthony,Chavez-Braun,West Tony,Dominica,+1-146-816-6927x73022,7767852040,riley32@stevens-harding.info,2021-07-24,http://lynn.info/
10-Aug-2021,RTGS,55.00,00.00,"35,677.02",7DD8d6e0AABA8FF,1728,Roger,Novak,"Cortez, Stevens and Ayers",South Barry,Netherlands,149-407-4039,+1-907-768-1609,gardnersandy@zuniga.net,2020-01-03,http://orr.net/
10-Aug-2021,Reversal,00.00,"35,677.02",00.00,BBC2fdC2ecd7cdF,9069,Krista,Frey,"Hardin, Hickman and Bailey",New Frankborough,Chile,722-826-8409x5907,421-893-6299x52666,ray89@pitts.com,2021-12-31,https://www.sanford-molina.biz/
11-Aug-2021,Debit Card,526.66,00.00,526.66,4C8C625eF7Bf3DC,5910,Dillon,Mann,Palmer LLC,Miguelport,Samoa,469-388-2609x33355,668.500.1681x9582,carla88@mcdonald-glass.com,2020-06-26,http://daniels-salas.com/
11-Aug-2021,Cash,00.00,52.67,473.99,AFBd06F16e8DF6f,3955,Kent,King,"Chan, Simpson and Wiggins",South David,Malaysia,288.173.6385x5023,998.124.8877x6867,velasquezray@sloan.com,2021-11-05,https://griffin.net/
11-Aug-2021,IMPS,00.00,473.99,00.00,095f1fFa9B8DadE,8703,Tanner,Sparks,"Hines, Chang and French",Melaniehaven,French Southern Territories,507.969.8051x0669,2937742162,mvelazquez@wheeler.info,2020-06-11,http://www.frost.com/
11-Aug-2021,ATM,25.10,00.00,25.10,933bAd1cf4bc4eb,4548,Kathleen,Ewing,Benjamin-Hanna,East Kristinatown,Vanuatu,478-868-9725,(281)568-8990,deborah62@cordova-taylor.org,2021-01-19,https://strong.biz/
11-Aug-2021,Debit Card,00.00,25.10,00.00,E23d31e388cdeF4,8890,Janice,Zhang,Mccullough Ltd,Port Taylormouth,Mauritania,6639319032,+1-053-065-6084x0337,belindawiggins@santiago.net,2020-03-25,https://www.valdez.com/
11-Aug-2021,Debit Card,34.20,00.00,34.20,dd6fc2216aE3cc9,5725,Stacey,Allison,Blanchard Group,Donaldchester,Netherlands Antilles,212-658-3367x088,272.715.9788,serranotasha@watson.com,2021-08-22,https://hopkins-yates.com/
11-Aug-2021,Debit Card,00.00,17.10,17.10,Eab0fa37Ca49d65,825,Olivia,Pacheco,Stone LLC,Blackfort,Guadeloupe,589.693.6782x9571,+1-208-920-4195x17546,theresa81@willis.com,2020-12-14,http://hogan.com/
11-Aug-2021,Commission,00.00,02.44,14.66,499b067c488c26f,8804,Taylor,Zuniga,Watkins-Nunez,Lake Priscillamouth,Palau,001-178-309-4489x647,+1-601-095-3488,rweeks@gates.com,2022-02-18,http://www.norman.net/
11-Aug-2021,IMPS,00.00,03.67,11.00,B1AF8BF3CFb0BdB,4190,Krista,Mcmahon,Schroeder PLC,Port Kristine,Myanmar,+1-384-017-1134x6171,8313149838,leonardterry@mclaughlin-ayers.com,2021-10-07,http://moore-fitzpatrick.biz/
11-Aug-2021,Miscellaneous,00.00,01.10,09.90,a7a07082c726fdA,1949,Austin,Joyce,Roberson-Delgado,Greerchester,Peru,8110994126,(949)909-5007x5625,robersonkristopher@tanner.com,2020-11-24,http://montoya.net/
11-Aug-2021,Miscellaneous,00.00,03.30,06.60,BFeb7E4CD56e21F,950,Johnny,Chapman,Rivas Inc,East Jaredland,Jamaica,496-712-6734,752.927.2754,shelly22@holland-doyle.net,2020-02-22,http://www.dennis.info/
11-Aug-2021,Transfer,06.32,00.00,12.92,E9B18eB8BDFcfe2,5067,Ana,Glover,Cruz-Lester,Lake Deborahfort,Egypt,053-914-0101x16800,(406)924-6437,mercerjeff@zavala-cooke.info,2021-01-01,http://www.graves-monroe.com/
11-Aug-2021,RTGS,"1,189,643.00",00.00,"1,189,655.92",3D00D14A8B5Dea6,4289,Kenneth,Parker,"Adkins, Jacobs and Gross",Jacobbury,Nepal,+1-469-661-7855x681,+1-491-380-0387,bruce70@park.info,2020-06-10,http://holt.com/
12-Aug-2021,IMPS,00.00,"396,551.97","793,103.95",eEd279bCaAA476C,8585,Megan,Livingston,"Carlson, Barber and Friedman",New Gene,Uzbekistan,001-026-446-7452x7216,179.815.2424,tricia95@baker.net,2022-03-28,http://www.powers.com/
12-Aug-2021,Bill,01.71,00.00,"793,105.66",d59AfC9b255Aa8b,1672,Adam,Garrison,Clayton Ltd,West Stacie,Bermuda,001-822-021-0681x78994,001-059-304-7143,yhardy@watts-hayes.info,2020-08-10,http://sawyer-booth.com/
12-Aug-2021,Bill,"2,272.90",00.00,"795,378.56",0c1b53bcFF5603c,5462,Debra,Odom,"Rojas, Peterson and Black",Dixonburgh,Puerto Rico,388-818-5741x888,(652)198-6609x403,mooreronnie@singleton.com,2021-01-24,http://pope.com/
12-Aug-2021,Purchase,00.00,"88,375.40","707,003.16",82a23D4eC7f3eDC,4083,Betty,Byrd,"Ali, Crawford and Wise",New Miguel,Japan,(064)884-0944x8729,3640943402,mariogentry@blanchard-lawrence.com,2021-09-13,http://allison.info/
12-Aug-2021,Interest,00.00,"353,501.58","353,501.58",Bb762FB670aFc3f,8116,Guy,Mora,Rosales and Sons,Charlesview,Trinidad and Tobago,(133)395-3565x80090,(824)002-5691,jwelch@ibarra.info,2020-08-03,https://hansen-serrano.net/
12-Aug-2021,Commission,00.00,"35,350.16","318,151.42",eAF3e0D500E11BC,6447,Kristopher,Olsen,Warner-Moreno,Mirandaburgh,Korea,(916)783-4149,001-179-161-9291,wallacefernando@olsen.biz,2021-01-27,http://eaton.net/
12-Aug-2021,IMPS,"1,390,327.25",00.00,"1,708,478.67",DEC9679E0F4DDbd,3949,Rachael,Sosa,Gill-Harding,Frankburgh,Ukraine,272.069.6850x0322,+1-325-958-7818x8363,norma21@campos-hurley.com,2020-07-25,https://www.tyler-zhang.biz/
12-Aug-2021,ATM,174.42,00.00,"1,708,653.09",06AF19AafaCf17F,3170,Jasmine,Solis,"Rowe, Mueller and Steele",Delgadoborough,Cape Verde,108.977.7724x68950,2564221570,elizabeth48@rosales.com,2020-04-18,http://patterson.com/
12-Aug-2021,IMPS,"1,637,956.80",00.00,"3,346,609.89",6cECa992bEbaAe3,5743,Christine,Huff,Valentine LLC,Port Sarafurt,Guinea-Bissau,001-972-229-3143,252-179-2938,reneecampos@nielsen-reese.com,2020-12-02,http://glenn.info/
12-Aug-2021,RTGS,"1,043.22",00.00,"3,347,653.11",4c1FEa0fa8AD569,500,Lee,Boyle,Lang LLC,Vangmouth,Ethiopia,242-082-5755x4541,+1-092-028-1774,deanstacie@carson.com,2021-03-02,http://yu-george.com/
13-Aug-2021,Cheque,"914,106.20",00.00,"4,261,759.31",dce6Fc71a59aB3e,8686,Felicia,Cherry,Compton-Zavala,Lukeport,Papua New Guinea,064.440.8280x65879,847.716.4193x0590,christian86@pratt.net,2021-01-02,https://farmer-ryan.com/
13-Aug-2021,IMPS,04.90,00.00,"4,261,764.21",68a6cBB89f251da,143,Stefanie,Singleton,Garcia PLC,Philipmouth,Liberia,+1-467-898-2863x84979,(855)578-9000,kerriray@owen-stone.info,2021-10-29,http://www.singleton.com/
13-Aug-2021,NEFT,00.00,"426,176.42","3,835,587.79",dBDF0Bd0E6eedd5,7894,Gabriella,Ramsey,Powell PLC,Lake Joann,Norway,+1-127-978-7134x6546,589-175-0933,madison31@cohen-haney.biz,2020-02-24,http://pope.com/
13-Aug-2021,Commission,00.00,"426,176.42","3,409,411.37",fedE7F470B17B0B,1795,Andres,Roth,"Woodard, Sharp and Colon",West Patrickfurt,Argentina,(031)368-0600,001-542-332-4810,hsolis@griffith.com,2021-01-04,https://burgess-alvarez.com/
13-Aug-2021,Bill,00.00,"1,136,470.46","2,272,940.91",eEDBF12Fc97bB15,3212,Melody,Schroeder,English-Carey,Christinehaven,American Samoa,+1-096-017-3175x611,598-327-3725x73385,ashley12@jarvis.com,2020-12-22,https://fowler.biz/
13-Aug-2021,Tax,00.00,"757,646.97","1,515,293.94",8FD1fC4aDFaEA7c,9407,Alvin,Weber,Bartlett-Blankenship,Robintown,Mongolia,2878427621,001-692-667-9675x6845,albertbarron@brock-wilkinson.com,2022-05-17,http://berg.com/
13-Aug-2021,IMPS,00.00,"757,646.97","757,646.97",Ee3ebbc2B0EAE15,6775,Jenna,Quinn,Castillo LLC,New Rebeccaland,Isle of Man,547.660.1202x498,001-397-383-7290,stokesjoel@ryan.biz,2021-04-20,https://www.deleon.net/
13-Aug-2021,IMPS,176.10,00.00,"757,823.07",9ecedD8b3e4EFD3,3043,Mallory,Branch,"Krause, Garcia and Howard",Tuckerport,Nauru,+1-379-140-5352,433-075-7596x1913,kcross@hudson-mcknight.info,2020-02-18,https://www.villa.com/
13-Aug-2021,Cheque,00.00,"378,911.54","378,911.54",1FABa2F48E7F6b9,2888,Jody,Costa,Mcneil-Barajas,New Becky,Saint Barthelemy,001-992-047-4413,(485)368-4859x00400,hodgekurt@bass-mann.com,2021-05-26,https://hood.com/
13-Aug-2021,Reversal,00.00,"378,911.54",00.00,2eC63FaDdFaF7dd,5926,Erin,Murillo,Leblanc-Morales,Lake Julian,Namibia,001-546-513-0586x9465,155-853-3438x003,amanda21@hayes.com,2021-02-28,https://www.duran.org/
13-Aug-2021,IMPS,01.80,00.00,01.80,dBC2D8aB4c8687f,926,Glenda,Jefferson,"Wood, Powers and Lara",Melindaview,Uganda,623-710-8714x0128,+1-724-073-6403x8939,roachdiana@stewart.com,2020-11-13,https://www.hebert.com/
13-Aug-2021,Cash,00.00,00.30,01.50,efDEeFAf05Cec10,5973,Morgan,Lee,Gonzalez LLC,North Ricardo,Bolivia,402.454.3460,451.421.6697x151,jennyoconnor@castro.com,2021-03-21,http://odonnell.com/
13-Aug-2021,Cash,"280,003.20",00.00,"280,004.70",e9C0FEEff97DD3b,7418,Frederick,Kelly,Huerta-Hardy,Ninaburgh,Kiribati,+1-198-170-6202,+1-564-703-8555x106,collinsbrianna@nielsen.com,2020-12-02,http://www.riddle-webster.net/
13-Aug-2021,Purchase,"436,653.00",00.00,"716,657.70",3AceaffdDd5FC0A,4581,Jordan,Galloway,"Summers, Little and Ward",Bellfurt,Nauru,(588)427-5410,5864091234,uwerner@roy-kaiser.com,2022-01-22,https://www.leblanc-herman.info/
13-Aug-2021,Tax,06.20,00.00,"716,663.90",dA3669d0BaD459C,9377,Jade,Beasley,Stafford-Rosario,Bruceburgh,Venezuela,026-852-0074x943,+1-145-399-8308x6996,jprice@dunlap.biz,2021-03-06,https://arias-barry.org/
13-Aug-2021,Cheque,00.00,"79,629.32","637,034.58",88A2e7C1918B4e9,8149,Daniel,Frye,Carson-Weber,Sethhaven,Antigua and Barbuda,(378)185-0220x6923,001-794-708-2224,jeremiah69@murphy.info,2022-04-04,http://salinas.info/
13-Aug-2021,Reversal,54.16,00.00,"637,088.74",7575aEDB31D87Ec,9882,Jermaine,Arellano,Stewart-Bentley,New Kiara,Myanmar,042.577.0850x070,9775233358,friedmankristi@phelps.com,2021-08-01,https://www.acevedo-bradford.com/
13-Aug-2021,NEFT,"1,977,976.00",00.00,"2,615,064.74",87fECaD534afB98,4218,Bernard,Pope,Whitney PLC,New Summer,Chad,4830563981,154.056.7361x3706,melendezemma@richardson-wagner.net,2021-10-18,https://www.freeman-everett.net/
13-Aug-2021,Reversal,"210,892.50",00.00,"2,825,957.24",3AfEEA3D9f4F5dd,1391,Rickey,Orozco,Buck PLC,West Deniseton,Congo,2830733103,+1-212-723-3775x191,normadavies@fuller.biz,2021-04-24,https://potts-ewing.biz/
13-Aug-2021,Cheque,00.00,"282,595.72","2,543,361.52",D06FDEBbfef76e8,2444,Oscar,Snyder,Glenn-Hutchinson,West Arianaside,Qatar,312-672-0083x23519,8650843113,orrtodd@murray-mann.com,2021-10-30,https://dickson.com/
13-Aug-2021,Purchase,02.31,00.00,"2,543,363.83",5Ed1117CBBacB0f,7462,Selena,Wolf,Ramsey Group,Wendyville,Jersey,+1-211-903-4440,(277)285-1864x2901,garrettmelvin@schmidt-oconnell.info,2020-01-07,https://bray.com/
13-Aug-2021,Bill,00.00,"363,337.69","2,180,026.14",Ca9D6fd16D9bBAD,8504,Connor,Fleming,Powers-Randolph,New Yvetteville,Morocco,8376997817,855-816-0243x1580,clayaustin@herman-elliott.info,2021-05-27,https://rowland.com/
13-Aug-2021,Miscellaneous,"4,500.00",00.00,"2,184,526.14",AFCEA430Faa17aB,782,Johnny,Maddox,"Richard, Gomez and Carlson",North Sergio,Canada,000.513.1822x923,+1-721-314-8684x7898,cfinley@estrada.com,2021-09-17,https://cameron.com/
13-Aug-2021,Reversal,21.80,00.00,"2,184,547.94",8731fEE83b8dDC6,1606,Joanna,Roth,Sandoval Inc,Karlshire,Micronesia,001-098-859-1712x2837,(153)310-2149,ugolden@eaton.com,2020-05-13,http://hull.com/
13-Aug-2021,Reversal,00.00,"242,727.55","1,941,820.39",3BbF8F60ffD27fB,8460,Emma,Fuller,Coleman-Blackburn,West Marilynview,Saint Kitts and Nevis,926.006.7581x92361,363-359-6503x65634,combstamara@wilkinson.biz,2021-09-12,https://www.weaver.biz/
13-Aug-2021,Cheque,06.00,00.00,"1,941,826.39",2301b8bD9afAfA2,8053,Mandy,Cortez,"Wood, Garner and Sandoval",Dannymouth,Oman,556-007-2782,(083)404-4832,pughjeffery@bauer.com,2021-10-14,http://www.mcneil.com/
13-Aug-2021,Debit Card,00.00,"194,182.64","1,747,643.75",aa1256F2Fd46cfD,5327,Roberta,Mays,Willis Inc,Tyroneshire,Grenada,(756)244-2927,543.079.9190x132,paynebrent@ferguson.com,2020-04-11,http://www.krause.com/
14-Aug-2021,Bill,00.00,"349,528.75","1,398,115.00",AAdEc1411aF0229,3149,Erika,Hurst,"Davies, Stein and Franklin",Biancaburgh,Gabon,001-912-460-0663x457,001-460-660-9265,ronnie29@duncan.com,2020-08-23,https://moss.com/
14-Aug-2021,Cheque,00.00,"155,346.11","1,242,768.89",6B36c6b5dCeE0Ca,6909,Don,Roman,Walsh and Sons,Port Joycefort,Bahrain,119.700.7391x50051,267.644.6361x378,glenadams@whitaker.com,2021-12-21,http://schaefer.com/
14-Aug-2021,Transfer,00.00,"1,242,768.89",00.00,61ffeEEcA2c6A33,2120,Brittney,Coffey,Lane-Parks,East Claudiashire,Niue,963.907.2012,716.731.7217,cynthia62@brock.com,2020-05-01,https://mcfarland-marks.org/
14-Aug-2021,Debit Card,06.35,00.00,06.35,0F53bd0a1ddaD59,3485,Erik,Cole,Black-Callahan,Juliemouth,Mauritania,979.737.1737x34632,8247257764,monique35@bishop.com,2021-06-05,https://www.shaw.biz/
14-Aug-2021,Debit Card,00.00,00.79,05.56,147387Db3f806D9,5139,Marvin,May,Rivera Ltd,West Katrinaborough,Seychelles,001-320-865-0560x87977,(032)886-6695x04824,tfranco@campos-boyd.com,2022-02-16,http://www.kim.org/
14-Aug-2021,Commission,00.00,00.56,05.00,B179dACDBCe4ABE,2117,Stuart,Fowler,"Dougherty, Marsh and Webb",East Dwayneport,Burkina Faso,406.953.5159x27628,181-342-6599,lauragraham@cunningham.com,2020-02-28,http://villegas-mckay.info/
14-Aug-2021,Miscellaneous,"22,759.56",00.00,"22,764.56",63AfBfFC1Ea62b2,3011,Shane,Carson,"Hawkins, Petty and Bishop",North Tommy,Grenada,001-990-151-3942x679,565.635.3197,qcohen@nicholson.com,2020-11-11,https://www.mays.com/
14-Aug-2021,Interest,00.00,"2,276.46","20,488.10",E7B8BFeaF4802ac,3742,Calvin,Walls,Griffith Ltd,Jennifertown,Fiji,+1-739-849-1435x072,(342)945-2230,allenmckenzie@giles.org,2021-12-20,http://www.massey-holder.net/
14-Aug-2021,Cheque,00.00,"4,097.62","16,390.48",87E8bcaa763C106,6400,Cathy,Johnston,"Kane, Mercer and Mccall",Lake Shelleyside,Turkmenistan,991-190-3160x31545,585-904-4791,carly75@cordova.com,2021-03-19,https://ortiz.com/
15-Aug-2021,IMPS,00.00,"16,390.48",00.00,cBDFAeDDFFECfF5,3063,Randall,Novak,Duarte-Shaffer,Tarashire,Luxembourg,+1-475-876-1361x904,378-207-1294x92548,floresjerry@atkinson.biz,2020-01-22,https://casey-dickerson.com/
15-Aug-2021,Cheque,843.00,00.00,843.00,aCd0BFbcf7958bd,7181,Alvin,Ibarra,Dyer Group,West Edwardland,Argentina,527.775.0393x5666,(932)668-1664,hollowaykristie@camacho.com,2020-04-23,http://www.johns.com/
15-Aug-2021,IMPS,00.00,105.38,737.62,ddEe60B8e39AF8d,369,Bill,Hardy,"Mason, Proctor and Freeman",North Jessechester,Fiji,135-097-2385,(754)344-9493,antonio01@schmidt.org,2021-11-19,https://reese.biz/
15-Aug-2021,Bill,02.98,00.00,740.60,dfFaddffc0AafbC,1210,Kara,Novak,"Marshall, Quinn and Sanford",Bakerhaven,Haiti,(613)998-6364,(809)068-9868x36802,isaiah02@beck.com,2020-06-22,http://romero.org/
15-Aug-2021,Purchase,"1,852,600.20",00.00,"1,853,340.80",a263aFC9AfC7b54,3477,Carmen,Cole,"Cain, Stanton and Holder",South Sarahchester,Bermuda,093-683-5241x64747,001-294-530-5847,tonyawaters@mullen-saunders.biz,2020-08-25,https://vega-clements.com/
15-Aug-2021,Reversal,00.00,"926,670.40","926,670.40",433b6a71bfff4b6,1872,Justin,Gardner,Dickerson and Sons,Beckyland,Switzerland,(793)285-0979,001-545-946-9230x97398,sanfordgordon@swanson.com,2021-01-02,https://arellano.com/
15-Aug-2021,IMPS,00.00,"115,833.80","810,836.60",c0C0d0FE5eF1aeE,1609,Jimmy,Glass,Miller-Kelly,Ginaside,Macao,715-171-1443,2935604473,kristopher39@lawrence.biz,2021-08-20,https://www.lindsey.com/
15-Aug-2021,Interest,00.00,"101,354.58","709,482.02",32e78699553B7DE,1703,Daryl,Harrell,Bean Group,Lake Belinda,Serbia,001-164-645-0236x1029,382-774-6433x35682,kirbysylvia@houston-hebert.com,2020-09-02,https://www.hardin.biz/
15-Aug-2021,Miscellaneous,"106,843.00",00.00,"816,325.02",cCdfaCc7961eEC7,2273,Alejandro,Mueller,"Duncan, Douglas and Cross",Lake Sheila,Nepal,175.447.8626,001-015-633-6935,khantricia@fields.com,2021-12-09,http://www.lambert-mullen.org/
15-Aug-2021,RTGS,00.00,"408,162.51","408,162.51",8C0B306Cd8D9108,9326,Hayley,Browning,"Beck, Hahn and Todd",Brucetown,Comoros,039.107.6083x19792,(183)752-2797x3079,fstrickland@sharp-harvey.com,2022-01-29,https://levy.biz/
15-Aug-2021,Reversal,00.00,"102,040.63","306,121.88",F64AAdc1BCD1CE0,4202,Marilyn,Lin,"Davies, Cochran and Hopkins",South Karina,Uzbekistan,652-162-9875,118.548.7532,patricialevy@strong.net,2020-07-29,https://www.weber.com/
16-Aug-2021,Debit Card,05.70,00.00,"306,127.58",3e78ee8F80d83D5,3826,Lee,Barnett,"Hester, Dean and Delacruz",Hickmanport,United States Virgin Islands,(802)905-0639x68681,663.840.7745x598,dunlapjennifer@riddle.com,2020-11-19,http://winters.biz/
16-Aug-2021,IMPS,00.00,"34,014.18","272,113.40",aA77ECe6859A8De,8650,Edgar,Gould,Huang-Shelton,South Randy,Montserrat,0126874840,+1-727-084-7889x13178,alexnovak@cole.info,2021-09-21,http://www.wilson.biz/
16-Aug-2021,Debit Card,00.00,"90,704.47","181,408.93",A35A5CdBE8168b2,2243,Kristie,Hendricks,Orr-James,Houstonborough,New Zealand,+1-110-196-0828x66952,344-958-4525,jackhicks@henry-blackwell.com,2022-04-25,http://www.mosley-oconnor.biz/
16-Aug-2021,Transfer,"4,693.93",00.00,"186,102.86",09Ec145B716b8fd,6119,Ernest,Holland,Ochoa Inc,North Jasonland,Brunei Darussalam,001-548-547-5511x0181,995.117.0463x9829,kristi29@bishop.biz,2021-09-28,http://stevens.biz/
16-Aug-2021,ATM,00.00,"62,034.29","124,068.57",A11c0C6C8c7dBcd,3081,Craig,Richards,"Brennan, Soto and Davenport",Dariusstad,Hungary,772-342-4978,550-900-2636x551,antonio32@bradford-collins.com,2022-01-26,http://reyes.net/
16-Aug-2021,Bill,00.00,"20,678.10","103,390.48",Def85EffBeF0440,7277,Brady,Jenkins,Oconnor-Bowen,Kaiserstad,Thailand,(924)974-8863x4750,9163061906,rangelclaudia@lawrence.com,2020-01-29,http://www.robles-santana.com/
16-Aug-2021,Miscellaneous,"66,391.40",00.00,"169,781.88",83d5b6bba5dC1FD,8691,Darlene,Blevins,"Castillo, Collier and Gibbs",Yufurt,Austria,340.117.4220x05591,237.409.0906,angie51@pacheco.biz,2022-04-27,https://glover-rosales.com/
16-Aug-2021,RTGS,35.38,00.00,"169,817.26",EB9Bf46a74aBacE,5136,Louis,Deleon,Jacobs LLC,East Alanton,Martinique,(131)857-4732,(595)141-5230x054,uchung@burnett-collier.biz,2020-02-26,https://moyer-skinner.net/
16-Aug-2021,Reversal,19.65,00.00,"169,836.91",0C75aBDa4b34Eec,5604,Jacob,Bruce,Burch-Estrada,Tonyburgh,Honduras,4164559869,+1-440-988-3588x9500,tmorris@donaldson.net,2021-05-03,https://www.gonzales.com/
16-Aug-2021,Tax,00.00,"56,612.30","113,224.61",c2890efA85cA3Ba,3265,Jill,Morrow,Carroll Group,Sophiaton,Italy,001-987-846-7320,454-885-9338,copelandrebecca@meyers.com,2020-03-19,http://www.dalton.info/
16-Aug-2021,ATM,"187,256.80",00.00,"300,481.41",dE1Ae4fea53eaC2,1890,Sarah,Leblanc,Ashley-Melton,Daltonville,Sudan,317.783.1164x385,2227393195,jimbailey@hays.org,2020-02-07,http://www.acevedo-allison.biz/
16-Aug-2021,Transfer,23.00,00.00,"300,504.41",A4c3f8CF4aD3A99,9430,Jaime,Powell,Stark-Lucas,Marisaview,Kenya,001-608-418-8616x5028,001-269-511-2001,merceryvonne@riddle.biz,2021-09-16,http://rush.net/
16-Aug-2021,Debit Card,00.00,"150,252.21","150,252.20",083E212Babb5CaC,2314,Rebekah,Schwartz,"Gallagher, Small and Mcguire",Garyton,Yemen,001-777-207-2397x10879,976.872.0504,marygross@nguyen.info,2022-01-23,http://www.coleman.com/
16-Aug-2021,RTGS,00.00,"21,464.60","128,787.60",FeDc06C4D5cdD50,4737,Jackson,Huber,Hinton-Bautista,Traciehaven,Syrian Arab Republic,+1-878-854-1035x153,+1-224-676-3734x21683,joycemarks@massey.com,2020-02-02,https://www.walls.com/
16-Aug-2021,Interest,00.00,"12,878.76","115,908.84",3DF696FDE9D1cc6,4865,Briana,Scott,"Hansen, Forbes and Cannon",Padillamouth,San Marino,1640577605,3923040889,travis80@wong.com,2020-07-23,http://www.wolfe-daniel.com/
16-Aug-2021,Transfer,00.00,"57,954.42","57,954.42",1C141a357dA4Ddd,1828,Gabrielle,Dennis,"Gomez, Sanders and Cantrell",New Damon,Namibia,001-616-702-7385x89733,+1-741-762-2242,caitlin73@acevedo.com,2022-04-16,https://sullivan-dunlap.com/
16-Aug-2021,IMPS,"2,825.57",00.00,"60,779.99",b7beEa7fDE4eBb9,454,Jaclyn,Cardenas,"Noble, Downs and Knapp",Port Traci,Hong Kong,211-550-6047x8207,+1-193-800-2383x083,phebert@farmer.com,2022-03-24,https://hinton.com/
16-Aug-2021,ATM,00.00,"8,682.86","52,097.13",Ff4174BCF03a8d0,6148,Marisa,Torres,"Ritter, Kramer and Chang",Kirbyport,Saint Barthelemy,001-739-621-9488x03901,5642514544,cameronruth@ellison.info,2021-09-04,https://foster-dunn.com/
16-Aug-2021,Commission,"222,167.50",00.00,"274,264.63",da447C19eD3E9F0,5662,Andrea,Lara,"Abbott, Everett and Davidson",East Brent,Netherlands,7549053988,496-086-5405x3272,ashleeeverett@hampton.org,2021-03-01,https://www.calderon.com/
16-Aug-2021,Reversal,00.00,"30,473.85","243,790.78",00EA1C9FCb20FE2,4349,Linda,Gilmore,"Gonzalez, Brennan and Pugh",New Nicolemouth,Kyrgyz Republic,001-515-200-0285x187,(956)221-3411x01886,tracey12@pratt.com,2020-11-01,https://baker.com/
16-Aug-2021,Interest,00.00,"243,790.78",00.00,f455E6ed59cfb57,5834,Annette,Buckley,Strong-Ali,Vegaside,Switzerland,854.283.6866,(231)085-5511,curtisgregory@sweeney-lam.info,2022-02-06,https://www.terrell.com/
16-Aug-2021,Miscellaneous,"1,297,485.20",00.00,"1,297,485.20",Cc37EF9858bddA5,7481,Charles,Carr,Hodges Ltd,Port Gilbertmouth,Burundi,481-014-2165,722.287.8733,donovantony@steele.info,2022-05-29,https://cortez.com/
16-Aug-2021,Debit Card,01.00,00.00,"1,297,486.20",Eb17cE4feEb0100,436,Tricia,Fletcher,Franklin Inc,East Kirk,Myanmar,408.412.7123x30688,1024127095,bconner@hartman.com,2020-06-26,http://www.stark-oliver.org/
16-Aug-2021,Purchase,00.00,"648,743.10","648,743.10",f6d251eD4ae024E,2412,Judith,Yates,Pham Group,North Savannah,Nepal,8642268721,001-513-914-0843x733,eburch@parrish-cameron.org,2021-02-28,https://www.hughes.info/
16-Aug-2021,Cheque,"252,991.00",00.00,"901,734.10",1dA5F3BaFa13fEE,5990,Cathy,Monroe,Small LLC,Downsburgh,Malta,(689)759-3057,832.627.8274,theodore73@cannon.com,2020-03-19,http://trujillo-joseph.com/
16-Aug-2021,Miscellaneous,00.00,"90,173.41","811,560.69",9ADA2BD0Be9D72b,3916,Misty,Malone,Rivera Ltd,West Marissa,Tuvalu,+1-549-017-1307,(898)177-6989x435,charlenerichardson@singh.com,2020-12-15,https://lam-moore.com/
16-Aug-2021,Reversal,02.00,00.00,"811,562.69",53D27CbE3b3CAf7,41,Darren,Santana,Guerra LLC,Meyerbury,French Southern Territories,+1-145-916-2809x14415,440.474.1607,biancahenry@hernandez.org,2021-06-11,http://www.gates.net/
16-Aug-2021,NEFT,00.00,"270,520.90","541,041.79",86FC4E3087C3eD7,6246,Alan,Callahan,"Francis, Paul and Avery",Anahaven,Ecuador,(321)655-5671x37772,898-657-8110x81307,haileycherry@allen-cobb.com,2020-02-23,https://www.house-banks.com/
16-Aug-2021,Debit Card,00.00,"90,173.63","450,868.16",5B6d34BaF962B79,1646,Paige,Stanton,"Mason, Whitehead and Barrera",Wolfetown,Greenland,+1-171-137-3148x5404,537.851.9794x3164,tranmarcus@maxwell.net,2022-03-03,http://krause-porter.com/
16-Aug-2021,Cash,"1,877,235.00",00.00,"2,328,103.16",a2CDAdD0645ffa2,4369,Monica,Tucker,Dillon Ltd,New Daleville,Macao,(236)597-4068x78812,001-667-581-0421x543,bentleycasey@reese.net,2021-05-27,http://sherman.org/
16-Aug-2021,Interest,00.00,"291,012.90","2,037,090.26",d4E778CcE3db760,5597,Joy,Ortiz,Wells-Wang,Rhondaberg,Christmas Island,001-124-338-6874x3126,847.558.4782x74368,karamahoney@stone.info,2020-06-06,https://www.pollard.com/
16-Aug-2021,Bill,00.00,"2,037,090.26",00.00,a75Cd6A25aB21A4,9779,Nicolas,Benjamin,Wise Inc,Phyllisside,Montenegro,1294296010,975-224-4884,karicasey@mccarthy-benjamin.net,2021-08-03,https://charles-levine.org/
16-Aug-2021,Cheque,250.00,00.00,250.00,AeB8D236777AFbA,8909,Vicki,Manning,"Stewart, Hurley and Gilmore",Penningtonchester,United Kingdom,(461)625-2889,001-204-079-3794x24434,amckinney@york.com,2021-06-13,http://www.gutierrez.com/
16-Aug-2021,Miscellaneous,"11,508.85",00.00,"11,758.85",bCa8ce25bcfEE32,6955,Joel,Krause,"Walters, Braun and Guerra",North Suzannestad,Cuba,140-145-0174,134-452-7645,clintonbest@patrick-rogers.com,2020-04-13,https://www.ayala.com/
16-Aug-2021,Tax,"30,689.00",00.00,"42,447.85",a69EC70Ac9a6BFf,8551,Cameron,Nichols,Williamson PLC,Lake Tara,Marshall Islands,558.003.6796x276,(547)459-8798x37220,beasleyjorge@payne-hoover.com,2020-06-30,http://www.hayden.info/
16-Aug-2021,NEFT,00.00,"6,063.98","36,383.87",380f4DdDC06fa82,2424,Grant,Snyder,Buckley LLC,Mortonmouth,Ecuador,006.798.9180x5770,689.541.4149x06592,breweredgar@aguirre.com,2021-02-01,https://krause.info/
16-Aug-2021,Transfer,00.00,"4,547.98","31,835.89",5CFcaDEd4df2DaA,452,Joseph,Steele,Meadows PLC,Dyerland,Samoa,(621)466-4444,749-958-2014x289,volson@carter-barr.info,2020-03-21,https://www.floyd-harmon.biz/
16-Aug-2021,Reversal,141.50,00.00,"31,977.39",8CB58f03eFe6dDe,2461,Guy,Solomon,Huerta-Rivas,Lake Leonard,Syrian Arab Republic,001-457-175-0519x21265,+1-503-004-3154x96800,kgay@kelley.net,2020-09-22,https://www.weber.net/
16-Aug-2021,Cash,00.00,"15,988.70","15,988.70",fDbB79FAB142707,36,Francis,Hubbard,Barron Group,West Makaylaton,Seychelles,+1-895-654-6918x3859,(182)766-9394x4641,savannah10@simpson.com,2021-03-17,https://www.velazquez-wright.com/
16-Aug-2021,Tax,130.30,00.00,"16,119.00",aBAfDAF3CA90EC2,2192,Jacob,Perez,Roach-Anthony,Chamberston,Palestinian Territory,+1-098-965-7583x4101,(317)606-3649,katie06@greene-pham.com,2021-06-21,https://mcgee.com/
16-Aug-2021,Purchase,00.00,"1,791.00","14,328.00",4096c18Ffe12d1f,6977,Tanya,Peters,Brock and Sons,Graceburgh,Korea,+1-907-371-1962x6132,347-011-0000x66073,jillian40@patel-banks.com,2020-06-18,http://suarez.com/
16-Aug-2021,Commission,13.50,00.00,"14,341.50",aB8dEb7cF7F338C,3839,Katrina,Dunlap,"Cunningham, Berg and Hughes",New Sheri,Honduras,148.243.7554,760-310-5308x529,miguel93@hendricks.biz,2021-03-23,https://hodges.com/
16-Aug-2021,Interest,31.00,00.00,"14,372.50",456DA0F5B196eBF,1061,Jacqueline,Gallegos,Little-Lamb,Levineville,American Samoa,811-209-8997x308,841-822-9579,rojasgabriela@clarke.net,2021-07-28,http://singleton.org/
16-Aug-2021,Debit Card,00.00,"7,186.25","7,186.25",Cf8eB8Fc16D5e63,7512,Drew,Chandler,Chaney-Osborn,West Devon,Belize,+1-725-219-9535x5009,(425)566-6461x32745,mckenzievance@kelly.com,2020-11-03,https://odom.org/
16-Aug-2021,Debit Card,00.00,898.28,"6,287.97",bca9CCD7EFCD24D,5531,Caitlyn,Saunders,Glass-Byrd,Port Alyssahaven,Slovakia (Slovak Republic),5367053156,+1-590-083-0350x455,avaughan@johnson-bean.com,2021-06-13,https://lozano.com/
16-Aug-2021,IMPS,49.50,00.00,"6,337.47",D612caeb8FfE25A,8793,Darrell,Mclean,"Leblanc, Pope and Baxter",Riosfort,Luxembourg,001-194-295-7386x500,001-629-917-1811x203,riosbenjamin@richards.com,2021-10-04,https://www.cross-sanchez.com/
16-Aug-2021,ATM,"231,369.10",00.00,"237,706.57",01f7Cb51B4aa8bE,7331,Shawna,Winters,Matthews Group,Barkershire,Australia,001-870-372-3317,645.438.8705x8457,fskinner@boyer.info,2021-12-17,https://www.kidd.com/
16-Aug-2021,Tax,00.00,"33,958.08","203,748.49",a0b56AfaCba8CE5,1575,Clayton,Duran,Burns-Acosta,New Wendy,Tonga,001-152-308-6862,(814)468-4190x867,rfoster@curry.biz,2021-09-25,https://quinn-hardin.com/
16-Aug-2021,Commission,486.00,00.00,"204,234.49",02898865ef261D8,2581,Gary,Watson,"Cameron, Peck and Hale",North Grantbury,Greece,334-059-0518x2057,749.882.3352,mariecochran@maddox-mcdowell.com,2021-08-21,https://www.crosby-hicks.com/
16-Aug-2021,ATM,664.00,00.00,"204,898.49",BEd0ACBfb90fDAC,7189,Troy,Leblanc,Russo LLC,Lake Ricky,Haiti,255-568-7014x00471,137-233-2531,swansonpeter@luna.com,2020-12-01,https://www.gay.com/
16-Aug-2021,Tax,422.70,00.00,"205,321.19",fb6F888A84f87b0,6717,Lee,Burch,"Cortez, Martin and Christensen",New Spencer,Jamaica,170.328.3670,1156698760,jarvisalvin@bean-garcia.com,2020-02-20,https://www.atkinson.org/
16-Aug-2021,Cash,"1,009.56",00.00,"206,330.75",CbBA6A9AA6d2b3B,6700,Maria,Winters,Perry Ltd,Lake Scottstad,Vietnam,531.997.2394,714.538.9732x0960,barnettparker@jimenez.com,2022-04-05,https://www.hunter-estrada.com/
16-Aug-2021,RTGS,01.30,00.00,"206,332.05",AAE10aB2CfF0C7E,6703,Grace,Franklin,Elliott Inc,Debbieville,Cambodia,904-535-4953x683,366.182.7676x153,mason29@manning.net,2020-09-22,http://shaw-jennings.com/
16-Aug-2021,Cheque,"170,428.66",00.00,"376,760.71",65BBDEda3B60c95,8612,Sandy,Day,"Harmon, Michael and Johns",Stanleychester,Swaziland,(765)469-7342x6567,(188)518-5918x568,everettyvonne@soto.com,2021-12-13,https://hardin.info/
16-Aug-2021,Bill,00.00,"47,095.09","329,665.62",bAD50bedbB8A8DB,4670,Dominique,Garner,Huff LLC,Shepardstad,Romania,+1-830-941-0156x981,+1-974-379-6858x4399,ghester@scott.com,2020-11-16,https://www.myers.com/
16-Aug-2021,Reversal,164.90,00.00,"329,830.52",3e1187fCcebC8d2,7,Mathew,Hoffman,"Bender, Pittman and Kidd",West Ralph,Uzbekistan,842.380.1168,(178)178-5447x32603,bauergerald@morrison.com,2020-04-09,http://www.holt.com/
16-Aug-2021,Purchase,"3,479.16",00.00,"333,309.68",6b612C90DfF1BaB,6562,Travis,Ali,"Cox, Macdonald and Pineda",Lake Brian,India,+1-995-411-2041x86598,+1-596-645-9818,derrickbeltran@harrington-gill.biz,2021-05-11,http://www.church-hendricks.com/
16-Aug-2021,Transfer,00.73,00.00,"333,310.41",dAAA0a0f13cDe0D,8512,Tami,Yang,Gentry-Newman,Sherylbury,Bahrain,+1-147-607-9032x64548,+1-938-330-2970x6399,timothycooke@harding-hood.biz,2022-05-06,https://www.brady-sanford.com/
16-Aug-2021,Bill,202.90,00.00,"333,513.31",233D0C19b0eC933,6199,Lance,Bray,Brady-Harding,Lake Courtney,Kazakhstan,+1-242-939-8620,(541)236-5365x773,scarson@baldwin-estrada.com,2020-03-08,https://www.zimmerman.com/
16-Aug-2021,Commission,00.00,"55,585.55","277,927.76",aAb22429E17AFB8,7824,Sierra,Clark,Dennis-Sexton,Lake Charlottebury,Saint Martin,6054150247,+1-758-390-7466x1984,bakeramber@greer-flowers.com,2021-04-27,https://ho-lambert.com/
16-Aug-2021,IMPS,00.00,"39,703.97","238,223.79",F6B7eaFAf32cD00,7734,Heather,Cannon,Mcmahon-Levy,South Markfurt,United States of America,302-815-0543x937,(959)859-7400x94366,bmorgan@pratt-acevedo.com,2021-06-21,http://www.garner.net/
16-Aug-2021,Interest,00.00,"47,644.76","190,579.03",47B103d5B5f10F1,3884,Sherri,Escobar,Russo-Blackwell,Kimside,Peru,801.598.8166,254.433.4701,bnovak@mathews.org,2021-03-25,https://dean.net/
16-Aug-2021,Cheque,00.00,"27,225.58","163,353.45",aC11e5F7EdC4DBf,4459,Herbert,Walters,"Huber, Miles and Mcconnell",Kentstad,Wallis and Futuna,(911)965-0929x5709,811.627.2835,pughrandall@velazquez.org,2022-04-17,http://www.willis.net/
16-Aug-2021,RTGS,00.00,"27,225.58","136,127.88",6BF0F748795Ef68,1515,Johnathan,Stephenson,"Drake, Vaughn and Abbott",Herringland,Gambia,(200)506-2953x6401,666-564-1328x0955,isaiahlara@khan-garrett.com,2021-05-26,http://www.whitehead.biz/
16-Aug-2021,Tax,470.00,00.00,"136,597.88",374FDD8e1fA34C1,7088,Austin,Duke,Mercer PLC,Lake Jorgefort,Faroe Islands,175-571-0868x461,(292)169-9146,sarah41@duran.com,2021-04-03,https://villa.com/
16-Aug-2021,RTGS,00.00,"68,298.94","68,298.94",9aF244b44Dc6d7e,7712,Kaitlyn,Webster,"Lawrence, Camacho and Herring",Branchstad,Bangladesh,001-246-652-6955,504-017-2781x9320,willie54@stephens.net,2020-12-12,https://gamble.com/
16-Aug-2021,Tax,07.00,00.00,"68,305.94",DB2C9D8cC75dd2d,1574,Jeremiah,Vang,"Serrano, Mills and Roman",Khanville,Turkey,+1-934-656-1056x70855,001-114-534-9654,patrickallen@sims-moore.com,2021-05-25,http://www.gillespie.com/
16-Aug-2021,IMPS,01.18,00.00,"68,307.12",6761CdEFBf35cA2,9277,Jane,Ochoa,Gilbert Inc,Dyerside,Maldives,523-523-3824x146,+1-414-967-0513x294,solislinda@bender-salazar.com,2020-10-30,https://juarez-herring.com/
16-Aug-2021,IMPS,"428,225.50",00.00,"496,532.62",5bEDAd9D1F91e0c,9051,Erica,Zuniga,"Manning, Golden and Ellis",Port Frederick,Argentina,001-238-449-9212x6937,0288318936,gpatel@best-blackwell.com,2021-05-24,http://www.fischer.com/
16-Aug-2021,Debit Card,"3,414.80",00.00,"499,947.42",baFBeA46617A6bb,945,Bryce,Cox,"Hunter, Aguirre and Clay",Lake Jesusside,Sao Tome and Principe,795-987-5359x44590,+1-020-096-5280,brentchambers@carr-chapman.com,2021-09-18,http://www.pham-hess.info/
16-Aug-2021,Bill,00.00,"249,973.71","249,973.71",9ecc05ceAfcFDFB,7062,Marilyn,Pearson,"Sweeney, Miller and Booker",North Sallyview,Lebanon,705.503.6017x8827,+1-456-773-0873,sgarza@hughes-bowers.com,2022-03-20,https://bridges-wall.net/
16-Aug-2021,ATM,00.00,"24,997.37","224,976.34",C3Ac9a163b9b4F2,1540,Kellie,Fitzgerald,Potts-Cooke,North Stephanie,Madagascar,244-736-2987,6771263984,rchaney@stout.com,2020-01-12,http://browning.com/
16-Aug-2021,RTGS,00.00,"28,122.04","196,854.30",ccFbE36B36DA8ca,906,Stacy,Wright,Mcmillan Ltd,Lanceburgh,Macao,(298)415-3714x8433,(084)259-2369,brittany22@blake.org,2021-04-12,http://www.perkins.biz/
16-Aug-2021,Transfer,347.80,00.00,"197,202.10",06e3a0B88eFC96f,2488,Jane,Chambers,Gray-Huang,Lake Stuart,Paraguay,001-871-656-5065,+1-031-313-7096x554,stokessheri@reynolds.org,2021-10-04,https://www.franco-watson.com/
16-Aug-2021,IMPS,00.00,"98,601.05","98,601.05",f2aab2A7CCDaEC9,1915,Noah,Orr,Mathews-Floyd,Pughhaven,Togo,1695662591,(570)903-0217x470,eshea@newman-nelson.com,2021-06-07,http://ferguson.com/
16-Aug-2021,NEFT,00.00,"49,300.53","49,300.52",d535Ccee51f5Cc6,236,Leslie,Ramos,"Stephens, Green and Dudley",Vaughnside,Montenegro,+1-004-914-0818,463-667-7297x27905,oscar33@holden-morrow.com,2022-03-23,https://maynard-madden.net/
16-Aug-2021,ATM,00.00,"49,300.52",00.00,CC9EFA9ead50cc4,2241,Yvonne,Willis,Gutierrez Inc,Brianberg,Maldives,007.226.0077x178,297.105.5974,jwhitehead@gamble-hatfield.com,2021-02-08,https://chan.com/
16-Aug-2021,NEFT,58.54,00.00,58.54,2BdA1E11E3c0cc0,5069,Cathy,Hernandez,"Peterson, Jackson and Holt",Yangville,Iraq,001-351-562-4488,+1-260-522-7161x9943,danacain@ruiz.info,2021-11-25,https://www.michael-coffey.net/
16-Aug-2021,Debit Card,"17,241.00",00.00,"17,299.54",87ccb6B526F8082,9397,Riley,Cisneros,Melendez-Stafford,Port Lindaburgh,Cuba,370-257-2678x1049,440.702.9999,nina86@pearson.com,2021-07-15,https://vaughan-berger.com/
16-Aug-2021,Transfer,00.00,"4,324.89","12,974.66",DAFfBd2aC85655D,6585,Sean,Fernandez,Miles LLC,North Ronaldshire,Denmark,308-545-9982,169.012.9079x6779,morselaurie@hart.org,2022-01-07,http://davies.com/
16-Aug-2021,ATM,"499,666.50",00.00,"512,641.16",2Eb1E4e1b88E4cb,2673,Shane,Hodges,"Burnett, Monroe and Gilbert",Oconnellmouth,Saint Martin,001-893-625-3611x859,0845457556,jefferyhardin@buchanan.com,2020-01-31,http://www.odom.info/
16-Aug-2021,Cash,23.20,00.00,"512,664.36",38C4ab36bbDffcE,9926,Alejandra,Mendez,Horton-Ferrell,North Laurie,Palestinian Territory,783.780.6390,+1-293-726-8000x82793,mbruce@lawrence.net,2020-10-15,http://www.esparza-santos.com/
16-Aug-2021,Cash,00.00,"128,166.09","384,498.27",AAdEc1411aF0229,3149,Erika,Hurst,"Davies, Stein and Franklin",Biancaburgh,Gabon,001-912-460-0663x457,001-460-660-9265,ronnie29@duncan.com,2020-08-23,https://moss.com/
16-Aug-2021,Debit Card,00.00,"38,449.83","346,048.44",726dCF0E593c07f,7219,Cassie,Trujillo,"Barrera, Kline and Shea",Branchville,Maldives,001-167-961-5481x1609,9226333092,bobby65@pratt.com,2022-04-28,http://rose-vaughan.com/
16-Aug-2021,Cheque,00.00,"49,435.49","296,612.95",445ca64B6b6aF95,4617,Bradley,Benjamin,Ortega-Dean,Perryport,Maldives,+1-682-908-8438x4085,001-458-005-6048x7732,whitney01@kirk-kline.com,2021-03-14,https://www.bradford.com/
16-Aug-2021,Bill,00.00,"29,661.30","266,951.66",5bA6D911cAfE8ae,8764,Loretta,Sullivan,"Collier, Kidd and Singleton",Gabrielberg,French Polynesia,+1-894-764-9275x0638,068.059.3739,kbarrett@calderon-lynch.info,2021-04-25,http://www.wu.com/
16-Aug-2021,ATM,367.30,00.00,"267,318.96",32e78699553B7DE,1703,Daryl,Harrell,Bean Group,Lake Belinda,Serbia,001-164-645-0236x1029,382-774-6433x35682,kirbysylvia@houston-hebert.com,2020-09-02,https://www.hardin.biz/
16-Aug-2021,Reversal,"3,519.21",00.00,"270,838.17",a3aCDdFA3fbCe1c,5425,Faith,Cohen,"Frazier, Russell and Bridges",East Jimmymouth,Japan,+1-893-467-7354x41283,146.330.2439x19960,fhammond@huynh.com,2021-08-17,https://garrett.com/
16-Aug-2021,Tax,"1,841.33",00.00,"272,679.50",18beD7B01DaFFD1,6624,Vickie,Gamble,"Moran, Hendrix and Porter",Staceyside,Gibraltar,(861)422-2092,229.540.0115x4573,ypoole@ruiz.com,2020-07-04,http://terry-singleton.com/
16-Aug-2021,Purchase,00.00,"272,679.50",00.00,c88dBd6DD2dE58D,5285,Bobby,Spence,Durham-Hess,Hartmanport,San Marino,956-045-1315,(455)405-8205,deanna41@shea-newton.org,2021-03-09,https://fisher.com/
16-Aug-2021,Commission,00.20,00.00,00.20,EF78b8Cb47a0D7f,9746,Francis,Phelps,Morse-Dorsey,Mccormickmouth,Latvia,067.174.1997x6490,(271)526-1827,hesterkim@sanders.com,2021-03-10,https://rangel-schmidt.com/
16-Aug-2021,Tax,00.00,00.05,00.15,FcEfF23bf73fbf2,2837,Debra,Juarez,Erickson-Cook,Lake Anneshire,France,022-784-3257,+1-138-118-8731x43961,sheryladams@best.com,2021-08-05,https://www.davidson.com/
16-Aug-2021,Cheque,06.50,00.00,06.65,A3d3B2Ffea9946d,6129,Madison,Thompson,"Clark, Crane and Hanna",North Christinaland,Comoros,734-151-3999x70972,001-099-343-6167,shellyconner@jefferson-lowe.com,2021-07-23,https://lin.com/
16-Aug-2021,Bill,00.00,01.66,04.99,8bebEEd1A3D8108,4065,Jesus,Marsh,Washington-Thornton,Lake Shawnamouth,Mauritius,(045)364-4689x018,709.091.2452x913,ana28@griffin.com,2020-07-09,http://www.graves-yates.com/
16-Aug-2021,NEFT,00.00,00.62,04.37,406e575A1ac25b4,2870,Gregg,Patrick,Guerrero-Bowers,Jodiborough,Saint Pierre and Miquelon,+1-106-591-5768,001-285-655-7431x596,faulknerkara@wade.info,2020-07-30,http://eaton-ho.com/
16-Aug-2021,IMPS,05.70,00.00,10.07,7Ad7a3eB29216A1,5938,Kendra,Evans,Little Ltd,North Destiny,Malta,815-471-7619x463,(502)534-8449x3569,pattonnina@bradshaw-krause.com,2021-03-20,http://nash.biz/
16-Aug-2021,Tax,00.00,01.26,08.81,6fA35a6AC521fA4,9708,Rachel,Joyce,Wade PLC,West Brendan,Western Sahara,001-130-468-9523x0039,001-422-222-2402x3379,emilydougherty@knox.com,2020-10-26,https://barnes.com/
16-Aug-2021,Bill,00.00,00.88,07.93,F4A35f06EF4c308,8625,Sydney,Cochran,"Horne, Rose and Roberts",Gutierrezfurt,Greece,034.341.6865,001-227-986-7381x2578,zashley@kerr.com,2020-06-03,http://www.ward.info/
17-Aug-2021,Commission,00.00,00.99,06.94,6BEe552cf85f65a,7610,Miguel,Bruce,Weaver-Cain,Tommystad,Guadeloupe,826-807-0954x089,473-989-7930,benjamin38@jordan-meyers.com,2020-04-29,https://greene.com/
17-Aug-2021,Reversal,02.51,00.00,09.45,d5FeC90c8efd78a,9576,Adrienne,Barron,"Campos, Kennedy and Newton",Cobbburgh,United States of America,(415)819-6928x63838,397-847-4546,ayerssara@baker-aguirre.com,2022-03-28,http://pollard-jefferson.com/
17-Aug-2021,Reversal,00.00,01.89,07.56,9ADA2BD0Be9D72b,3916,Misty,Malone,Rivera Ltd,West Marissa,Tuvalu,+1-549-017-1307,(898)177-6989x435,charlenerichardson@singh.com,2020-12-15,https://lam-moore.com/
17-Aug-2021,Cheque,00.00,00.00,07.56,7aa0bBb2c8afBfc,1273,Robin,Bernard,Hayes-Conrad,New Bob,Macao,+1-179-164-4027,(566)245-3647,pbentley@jensen-marshall.org,2020-07-30,http://www.manning.com/
17-Aug-2021,IMPS,"1,807,427.00",00.00,"1,807,434.56",2BC658cB6F0bad7,8469,Richard,Ford,Grant Ltd,South Miranda,Sao Tome and Principe,190-501-1172x868,236.052.9385x020,robersonhelen@campbell-zhang.biz,2020-07-04,https://www.huber-page.info/
17-Aug-2021,Miscellaneous,"2,114.73",00.00,"1,809,549.29",56CBAE374fF1Fe2,6434,Derek,Navarro,"Benitez, Kim and Harvey",East Eileenview,United Kingdom,001-961-776-3313x384,(679)572-7705x9537,tpham@downs.com,2020-08-21,http://bullock.net/
17-Aug-2021,RTGS,00.00,"226,193.66","1,583,355.63",Aa69F3fDa2FC90C,5024,Bryce,Pope,Graves Ltd,North Kari,Ukraine,001-840-865-5420x7234,(825)471-4806,paige75@mitchell.com,2020-09-04,http://short.org/
17-Aug-2021,Cheque,"11,643.19",00.00,"1,594,998.82",FaD7BcB59a69F04,5344,Cole,Mcdowell,Martinez-Casey,Dillonview,Reunion,091.366.5461,+1-173-411-6745,drewknight@mckenzie.net,2021-06-01,https://silva-gates.com/
18-Aug-2021,Reversal,27.00,00.00,"1,595,025.82",E3F17cB68a26fb1,5901,Jaclyn,Foley,"Pierce, Herrera and Lozano",South Luis,Guyana,+1-899-472-9928,001-562-627-2928,katelyngordon@decker-reed.info,2021-04-25,http://lang-dennis.com/
18-Aug-2021,Cheque,61.30,00.00,"1,595,087.12",617BEdC1Fe048bD,8677,Frederick,Esparza,"Branch, Cummings and Doyle",Villanuevaborough,Trinidad and Tobago,001-223-837-0084x201,(583)237-3171,freysherri@mcguire.org,2021-08-30,https://www.peters.net/
18-Aug-2021,NEFT,"25,532.70",00.00,"1,620,619.82",47d35349E691a5F,5306,Yvette,Roberson,Gregory Inc,Rossmouth,Holy See (Vatican City State),(665)501-9229x8851,(497)411-9460x821,emilygarner@wiley.net,2020-04-26,http://melendez.com/
18-Aug-2021,ATM,"224,670.00",00.00,"1,845,289.82",d5DbC9CCF8cbCb3,8198,Russell,Cantu,"Clements, Mcconnell and Stanley",Lake Joyceport,Vietnam,001-524-885-5623,(530)197-6842,heidi47@lucas.info,2021-06-28,http://www.pineda.com/
18-Aug-2021,IMPS,00.00,"263,612.83","1,581,676.99",83b0F8CfDB1E906,6714,Lauren,Rasmussen,Barajas-Gonzalez,North Allisonside,Italy,(142)379-4118x875,+1-203-895-8769,ldavidson@glass.net,2020-06-28,https://beck.info/
18-Aug-2021,Bill,"28,311.59",00.00,"1,609,988.58",F59426F9cbF6a5c,4265,Elijah,Lester,Bernard-Mosley,North Kurtshire,San Marino,+1-756-507-8050,649.228.4082,kwagner@mays-fox.com,2020-04-03,https://www.edwards.net/
18-Aug-2021,RTGS,00.00,"402,497.15","1,207,491.44",fAc9CfAc327d9b8,8431,Lacey,Cabrera,Mora LLC,North Isabellabury,Liberia,001-528-077-0999x699,3687586645,cameron90@barrett.biz,2020-07-09,http://larson.net/
18-Aug-2021,Bill,"2,007,474.00",00.00,"3,214,965.44",fe048d410CEAcC4,8250,Tracy,Ryan,Farmer PLC,Waltersfurt,Mauritius,723.026.1773,001-201-237-6247x184,montoyajoan@rich.biz,2021-11-01,http://hobbs.com/
18-Aug-2021,Interest,"8,437.10",00.00,"3,223,402.54",6DBC18e5EAc8Ce0,6747,Mikayla,Shaw,"Sparks, Snow and Gaines",Tammieside,Russian Federation,(509)852-4640,3529268071,rpacheco@blanchard.info,2020-08-07,http://www.moore-prince.biz/
18-Aug-2021,Interest,392.10,00.00,"3,223,794.64",a0Bcd6Bc84eb834,9947,Maria,Mercer,Leblanc-Beard,North Vincenthaven,Marshall Islands,+1-042-805-8353x68690,663.910.1919,kdougherty@alexander.com,2022-04-18,http://www.bartlett.com/
18-Aug-2021,ATM,00.00,"805,948.66","2,417,845.98",AacfDF795bFAC0f,6067,Alfred,Porter,Vaughn Ltd,Freyville,Comoros,+1-557-089-7966x56454,446.483.5460x6395,dzamora@mayer.biz,2020-07-06,https://garner-andrews.com/
18-Aug-2021,ATM,01.45,00.00,"2,417,847.43",119AbFA21C7aaeE,7897,Kristina,Maddox,Mcpherson PLC,Kurthaven,Falkland Islands (Malvinas),822-567-7729x5545,495.670.7564x22299,vtaylor@boyle.com,2021-07-24,https://carter-hoover.biz/
18-Aug-2021,Interest,00.00,"268,649.71","2,149,197.72",0eb8FccC3bCE1B9,3699,Andrea,Franklin,Padilla Group,Wolfhaven,New Caledonia,(071)003-2126x68784,8210383101,qsanchez@silva-roberson.com,2022-01-04,https://rollins-moyer.net/
18-Aug-2021,RTGS,"2,283.26",00.00,"2,151,480.98",47b3F290AD653e8,6841,Kylie,Harmon,Gaines-Stephenson,Woodsville,Guernsey,001-358-557-2875,(946)356-2435,kathrynburns@perkins.biz,2022-02-10,http://www.mccarty.com/
18-Aug-2021,NEFT,32.99,00.00,"2,151,513.97",5F2faA929AD5dC7,2179,Anne,Michael,Henderson-Vargas,Shelleyville,Costa Rica,684.430.1980x01442,2770418829,gshort@mckay-garrison.com,2020-08-19,http://buckley-jones.com/
18-Aug-2021,ATM,323.00,00.00,"2,151,836.97",E17d7e2d2950901,8365,Scott,Keller,"Wallace, Mccarthy and Mills",Hollyville,Guinea,439.116.4201x12871,6780902475,pennyjoyce@mendez.com,2020-02-28,http://www.wilkerson.com/
18-Aug-2021,IMPS,00.00,"307,405.28","1,844,431.69",1eB174E4ffaE708,1184,Roger,Bradshaw,Trevino Ltd,Port Tim,Northern Mariana Islands,+1-193-060-4099x1470,+1-573-198-3965x5967,hayden87@tate.com,2020-01-17,http://www.floyd.info/
18-Aug-2021,Tax,00.00,"368,886.34","1,475,545.35",8aD42aF7E5BBbEB,9586,Kirk,Orr,"Allen, Potts and Knox",South Tami,Belize,(159)332-6651x541,372-323-5195,ydavila@prince.com,2021-07-03,https://hammond.net/
18-Aug-2021,Debit Card,00.00,"184,443.17","1,291,102.18",9163deeC45020Fe,7635,Emily,Sharp,Anderson Inc,South Edwin,Taiwan,898.240.8662,358.268.7598,iwatkins@sanchez.com,2020-07-01,https://www.cantu.org/
18-Aug-2021,Interest,00.00,"258,220.44","1,032,881.74",edbbCB5cc47f6Bd,9802,Eileen,Wiley,Moyer Group,New Kristieburgh,Uruguay,651-778-9885x393,+1-411-206-6449x891,cmerritt@wheeler.info,2022-02-04,http://finley.com/
18-Aug-2021,Cheque,00.00,"147,554.53","885,327.21",Ac483f4f19F8DF1,8731,Gene,Knapp,"Huff, Valencia and Donaldson",North Karlborough,Cambodia,(563)983-3373,993-838-3787x746,charlotte91@brennan.net,2020-02-04,http://www.bernard-ramsey.com/
18-Aug-2021,Reversal,00.00,"442,663.61","442,663.60",F2E4AbEDEEefc6A,8987,Sherry,Weaver,"Bishop, Frye and Herman",Alvaradoland,Antigua and Barbuda,744.429.9012x302,001-070-534-4655x343,robynpugh@kidd-taylor.com,2021-02-05,https://www.evans-carlson.com/
18-Aug-2021,Commission,"193,866.81",00.00,"636,530.41",1d4eDF4394eEdBF,719,Matthew,Valdez,Garrison-Larson,North Dwayne,Vietnam,198-844-7879x2559,412-910-3872,destiny53@rivera-davenport.com,2022-04-29,https://rich.com/
18-Aug-2021,Cheque,"16,796.00",00.00,"653,326.41",5a5eed7ccFd7A0F,2971,Jasmine,Kim,Logan-Hayes,Bradfurt,Saint Pierre and Miquelon,817.159.6830x1206,517.367.3585x840,shirleyfitzgerald@levine-stanley.net,2020-11-10,https://moon.com/
18-Aug-2021,Miscellaneous,00.00,"163,331.60","489,994.81",4Aa0DeFBCfFbADe,2247,Carly,Cabrera,"Ali, Wells and Blanchard",Copelandland,Denmark,(480)293-6769x305,(420)953-5385,zortega@cannon.info,2021-10-26,https://www.griffin.info/
18-Aug-2021,Commission,00.00,"48,999.48","440,995.33",FDf385eFBfA3e1e,6835,Sandra,Mcintosh,Potter-Meadows,Mckayshire,American Samoa,149-765-7021x0721,8956532266,nallison@mcmillan.biz,2020-03-04,http://www.castro.com/
18-Aug-2021,Cash,00.00,"220,497.67","220,497.66",EF0dcDf4EeF1CC6,9036,Toni,Nash,Davis Group,Owenschester,Madagascar,623.835.5112x8429,001-236-711-1266x89503,autumnbrennan@estrada.org,2021-10-06,https://www.carter.net/
18-Aug-2021,Purchase,00.00,"36,749.61","183,748.05",73CEbfAaaDDFC4c,528,Gabriella,Powers,Joyce-Faulkner,East Glen,United States Virgin Islands,(519)333-2073,068.530.1503x787,dfreeman@blackwell.net,2020-05-01,https://sherman-curry.net/
18-Aug-2021,IMPS,"5,000.00",00.00,"188,748.05",2Ad0F4eecaacED0,1938,Alexis,Ferrell,Andrade-Orozco,Port Katieville,Central African Republic,+1-079-614-6908,001-712-846-4941x4473,dakotamadden@singleton.com,2022-04-01,https://melton.com/
18-Aug-2021,Purchase,00.00,"31,458.01","157,290.04",354C4e22BBffb20,8195,Jessica,Mora,Hubbard Inc,Lake Whitney,Romania,001-946-765-1450x447,(919)200-5148x058,owarner@hinton-sloan.com,2021-12-06,http://schmitt-oconnor.org/
19-Aug-2021,IMPS,37.30,00.00,"157,327.34",2dcb34Dcf3290dA,2988,Ruben,Horn,Weaver Inc,Bushmouth,Algeria,1661391606,994-852-9369,zunderwood@odom.com,2020-11-20,https://sweeney.com/
19-Aug-2021,Bill,00.00,"15,732.73","141,594.61",1da7746cdC969bD,8327,Douglas,Rodgers,"Curry, Yoder and Roth",Lake Jadeton,Papua New Guinea,853-800-6613x449,+1-885-479-8734,lgonzales@moon.com,2020-04-03,https://www.nolan.biz/
19-Aug-2021,Transfer,06.00,00.00,"141,600.61",82D0CabBb9829aa,4946,Anthony,Knight,Washington Inc,Fuenteston,Cape Verde,911.063.2233,974.907.0055x707,kwalter@cardenas.net,2020-01-17,https://www.rollins.com/
19-Aug-2021,Cash,"878,049.75",00.00,"1,019,650.36",83BC5c5dDFb512c,7045,Nicole,Hicks,Juarez-Eaton,Eileenmouth,Belarus,387.012.2204x387,047-154-3706x6260,christie55@ramsey.com,2022-01-16,http://shah-mcdonald.com/
19-Aug-2021,Miscellaneous,00.00,"145,664.34","873,986.02",D9c4B9c32cDe980,8332,Sara,Yoder,Garrett Group,Philipside,British Virgin Islands,(063)711-7752x60359,470-883-0227,pinedaearl@mcgee.net,2021-06-28,http://bridges-huang.info/
19-Aug-2021,Interest,00.00,"218,496.51","655,489.52",C59D0C66209d40d,2082,Marilyn,Carrillo,Henry Inc,West Aaron,Jamaica,+1-752-470-5610x1241,(508)753-1617,wallsmargaret@day-woodard.com,2020-07-30,http://www.jordan.com/
19-Aug-2021,RTGS,"15,825.00",00.00,"671,314.52",bffF52a944A3652,8254,Dean,Bruce,Cabrera Ltd,Wernermouth,Antarctica (the territory South of 60 deg S),762-256-4477x67554,(772)855-7711x83954,omckay@daugherty.com,2020-12-01,http://www.kelley.com/
19-Aug-2021,NEFT,"2,229.40",00.00,"673,543.92",ca750CCfBbEDc4D,8827,Ray,Cobb,Mccall PLC,South Terrence,Niue,823-942-0556,(928)354-2092x03308,carolvasquez@keith.info,2021-11-15,http://www.donaldson.com/
19-Aug-2021,ATM,00.00,"74,838.21","598,705.71",9e0D2B59C3f5EcD,8798,Hayden,Weeks,Berger LLC,Katieton,Nepal,+1-036-657-4722x0770,422.206.3424x74151,brittney86@jacobson-suarez.biz,2021-04-07,https://jackson.net/
19-Aug-2021,Bill,00.00,"85,529.39","513,176.32",8b3D1009Aac9d2a,4093,Peggy,Harrison,Cochran-Silva,North Desireemouth,Albania,459.908.5695,(147)705-8895,iblair@duran.org,2022-05-04,https://www.cameron.com/
19-Aug-2021,NEFT,"442,908.00",00.00,"956,084.32",eE803B9eF6F8e8B,7620,Miguel,Walter,Fry Ltd,Aliceberg,Norfolk Island,+1-034-326-9194x883,+1-011-643-9978x6458,littlemichael@villanueva.com,2022-03-24,http://www.ramos.biz/
20-Aug-2021,Cheque,00.00,"239,021.08","717,063.24",D8cE5a78DF28b8D,8771,Sheryl,Montes,Harper-Henry,East Philip,Turkmenistan,(046)398-3706,(343)312-8671x9480,kwilliamson@sheppard.net,2020-05-09,http://walls.com/
20-Aug-2021,Commission,425.01,00.00,"717,488.25",3F6df9C42AAD5E1,4507,Samantha,Whitehead,"Shelton, Booker and Morales",Riggsburgh,Mexico,283.215.7200x7282,+1-448-131-8298x6715,ericksonmakayla@acosta.org,2022-05-03,https://harrington.com/
20-Aug-2021,Tax,00.00,"358,744.13","358,744.12",1ECAA049CCaAA7B,131,Brady,Mckay,Decker Group,East Brady,Cape Verde,1934272027,+1-248-385-9619x891,travisfoley@brandt.com,2021-05-25,https://blake.net/
20-Aug-2021,Reversal,00.00,"35,874.41","322,869.71",2A4AE5dE3fbfAE6,1664,Ashlee,Dixon,Reese Ltd,Mcmahonborough,American Samoa,001-674-243-7422x57501,001-078-052-4654,jorgenewman@bullock-welch.com,2020-09-07,https://www.boyle-berry.com/
20-Aug-2021,NEFT,00.00,"161,434.86","161,434.86",bBac21fE82CEf2e,3575,Tiffany,Wong,Curtis-Peters,Calhounborough,British Virgin Islands,533-880-2876x68452,290-942-0744x9844,cmarshall@richardson.com,2020-05-03,http://www.mayer.com/
20-Aug-2021,Cheque,"26,125.40",00.00,"187,560.26",b0BAD45C54EdAaC,3533,Kerri,Livingston,"Gould, Brooks and Randall",Lake Raymouth,Taiwan,001-615-265-5364x839,746.669.5758,barrymanning@estrada.info,2020-10-13,https://levine.com/
20-Aug-2021,Reversal,"1,101,232.00",00.00,"1,288,792.26",0DBfD7D7Cd3CA18,9347,Ray,Conley,Le LLC,South Christopherstad,Madagascar,001-908-611-3506x71290,001-095-912-0829x864,heidi50@duran.com,2021-05-02,https://www.robles.com/
20-Aug-2021,Commission,33.00,00.00,"1,288,825.26",c3D48ADF3FBDa6E,7764,Ricky,Pineda,Yu LLC,Port Carlyberg,Wallis and Futuna,165.792.2309x258,701.381.3488x6460,judyfletcher@tapia-lang.org,2022-03-13,https://www.allison-vasquez.com/
20-Aug-2021,Purchase,00.00,"257,765.05","1,031,060.21",ABDfB9aE6FE5Bbf,391,Ana,Lopez,"Gentry, Carr and James",Barnettmouth,Angola,(999)273-7424x0499,(443)757-1385x002,bwalter@church.net,2021-10-26,http://jones-hendrix.com/
20-Aug-2021,ATM,00.00,"257,765.05","773,295.16",Ec45066Afeee0e4,7911,Kristina,Woodard,"Foster, Nunez and Wallace",East Leonard,Botswana,001-467-368-8765x021,001-510-198-0584x053,bmaddox@moreno.com,2020-08-12,http://www.benitez.net/
20-Aug-2021,Reversal,00.00,"128,882.53","644,412.63",41FB63B1bcA71F6,2230,Makayla,Shelton,"Lopez, Oneal and Giles",Marcoberg,Cambodia,001-037-345-2027x37133,036-696-4965,meredith21@mills.org,2021-06-24,http://maynard.info/
20-Aug-2021,NEFT,00.00,"322,206.32","322,206.32",cd28082B13585dF,4551,Bradley,Howell,Massey LLC,New Allenfurt,Holy See (Vatican City State),431-216-5729x59675,001-197-630-3073x7698,bergerjaclyn@cannon.com,2020-12-29,http://www.gates.org/
20-Aug-2021,Miscellaneous,00.00,"40,275.79","281,930.53",EfDb96CC2abA50A,3028,Sydney,Rosario,Sweeney Ltd,New Audreyfort,Vanuatu,049.318.8103,355.449.1449x994,parksmax@castaneda.com,2021-09-08,http://branch.com/
20-Aug-2021,Reversal,00.00,"40,275.79","241,654.74",67477242A28FE61,9065,Jill,Nichols,Montoya LLC,Victorberg,Wallis and Futuna,455.560.8474,576.066.1484,peggy91@sheppard-knapp.net,2022-04-07,http://dawson-stanley.com/
21-Aug-2021,Interest,"2,487.80",00.00,"244,142.54",779182BA7a34B61,8103,Hayley,Ward,Bradley-Marks,North Oscar,Nicaragua,(803)895-5209x51454,+1-247-504-2605x45004,juanweaver@terry.info,2021-12-22,http://deleon.com/
22-Aug-2021,Tax,00.00,"61,035.64","183,106.90",37deC3815ed60b0,6328,Morgan,Horn,Frederick-Baker,Lake Juliemouth,Azerbaijan,001-317-950-6893x346,552-312-9142,powersmelissa@barrett-hays.com,2021-11-03,http://www.perkins.com/
22-Aug-2021,Interest,00.00,"22,888.36","160,218.54",12CC251DE0d12b4,6740,Dillon,Johnson,"Brock, Jimenez and Mosley",Bellview,El Salvador,(631)503-2472x99128,+1-438-558-1862x555,maytanner@tanner.com,2020-11-05,https://bowers.net/
22-Aug-2021,Tax,"38,489.19",00.00,"198,707.73",e29487E9f050c6C,6882,Shaun,Travis,Suarez-Cruz,Erikamouth,Saint Kitts and Nevis,+1-126-765-1506,+1-684-799-1765,geraldmichael@santos.biz,2020-05-06,http://haney-richmond.com/
22-Aug-2021,ATM,"50,127.20",00.00,"248,834.93",7fD6b78E5647793,3708,Sophia,Parker,"Johnston, Moss and Chase",North Valeriemouth,Estonia,423.574.3684x703,001-678-159-8315,annettebailey@sanders.com,2022-04-19,https://contreras.com/
22-Aug-2021,IMPS,00.00,"31,104.37","217,730.56",C93115b3AF9A5bC,8925,Alexa,Roberts,Harrell Inc,West Kendra,Netherlands Antilles,+1-635-101-9334x5690,103.499.4881x582,crodriguez@ellison-archer.org,2021-09-27,https://braun-pierce.com/
22-Aug-2021,Commission,00.00,"21,773.06","195,957.50",7eE45FfefF86E9D,8490,Mario,Rivas,Stephens-Lucero,South Lisaberg,Saint Martin,739-670-4073x6755,025.905.1257x54331,rochaselena@shaw.biz,2021-02-20,http://www.little-jacobs.com/
22-Aug-2021,Interest,00.00,"195,957.50",00.00,FFC3CEF8f775799,7052,Jill,Branch,Heath-Pearson,Lake Trevor,Equatorial Guinea,399.826.9583x30860,(843)973-9485,clarkcathy@booth-barker.com,2021-09-08,http://norris.com/
22-Aug-2021,Purchase,"86,912.00",00.00,"86,912.00",DB5A95dDB20C56c,7732,Cristina,Boyer,Carey-Coleman,Brandonborough,Zimbabwe,001-164-067-5117,743.279.2331,valeriecervantes@gibson.com,2022-02-15,https://www.mays.com/
22-Aug-2021,Purchase,07.29,00.00,"86,919.29",5Ba3a87e1F5B5B0,7009,Mitchell,Donovan,Dougherty-Yates,Carmenbury,Guinea,+1-640-524-9357x901,632-577-9383x46705,suarezjaclyn@cochran.com,2021-09-10,http://www.mcneil.com/
22-Aug-2021,Transfer,00.00,"28,973.10","57,946.19",Ea4d54a76DF734e,3579,Isaac,Villarreal,Brooks-Nicholson,Salinasland,Burundi,426.649.6501x1887,001-400-715-3609x67437,bridgethardin@morales.net,2020-08-20,http://www.clarke-hayden.info/
22-Aug-2021,Cheque,273.12,00.00,"58,219.31",2Dbea9dBC2FE0D3,9209,Luke,Whitaker,Hanson LLC,Carlaport,Venezuela,001-912-230-0189x07363,001-046-870-8180x5047,mariamoreno@flores-thompson.com,2020-07-05,http://weeks.com/
22-Aug-2021,Interest,00.00,"29,109.66","29,109.66",f5F8CAFa0D8eFc9,6117,Benjamin,Juarez,Sparks LLC,Sheilafort,Morocco,369-099-3833x385,001-311-050-2840x1727,costapaula@mayo.com,2020-06-28,https://buckley-acosta.com/
22-Aug-2021,NEFT,00.00,"7,277.42","21,832.24",0D1d34f47a5BC8a,5908,Lance,Wong,Clark-Herring,South Gilbert,Turks and Caicos Islands,+1-170-713-9393x261,294-122-6004x8891,aimeedougherty@berg-huynh.com,2020-03-23,http://www.hanna.com/
22-Aug-2021,Commission,"14,883.70",00.00,"36,715.94",d1b0da8Ee08B3Fa,7845,Jeremy,Cunningham,Mcdonald-Ortiz,South Lucasshire,Moldova,082-547-8036x60655,001-387-785-4631x822,yvonne57@lawrence-lawson.org,2020-10-01,https://sampson.net/
22-Aug-2021,ATM,49.50,00.00,"36,765.44",1F08cfc8b04Ad1c,4756,Isabel,Mccall,"Baldwin, Patterson and Hatfield",South Shawn,Sierra Leone,(208)592-3315x159,148.860.0450x5700,iriley@west.com,2020-08-22,http://www.forbes.com/
22-Aug-2021,Cheque,"87,644.00",00.00,"124,409.44",Fc1AEA19E7D000B,2003,Jade,Oneal,Harding-Barber,South Mikaylabury,Estonia,(259)793-8011x185,001-792-433-2130x76837,dshaw@baker-morris.com,2020-07-01,https://cervantes.com/
22-Aug-2021,Miscellaneous,00.00,"12,440.94","111,968.50",4BA7abBe5fA514B,8218,Alvin,Medina,"Esparza, Caldwell and Levy",Higginston,Cambodia,478-379-1865x8412,+1-774-206-2552x4434,margaret75@phillips.com,2021-08-23,https://www.carter.biz/
22-Aug-2021,Commission,00.00,"18,661.42","93,307.08",0d17bEee6CcAe22,834,Jennifer,Booker,"Hopkins, Frederick and Wall",South Rachel,Reunion,342-905-6732,+1-430-361-1703x4186,ronnie20@sharp-foley.com,2021-03-09,https://taylor.biz/
22-Aug-2021,RTGS,493.00,00.00,"93,800.08",2CD6A8fd5F1aAcf,7190,Kristopher,Donovan,Mcdaniel-Allen,South Sophia,Chile,(081)152-2488,324-541-9916x86686,brandon14@maxwell.com,2022-05-25,http://www.mata-fuller.com/
22-Aug-2021,Interest,00.00,"13,400.01","80,400.07",9feCdcdF90BCbfB,821,Barbara,Mayo,Nixon Group,New Lorrainefort,Tonga,596.996.9057x743,119-132-4717x11846,kevin88@simon.com,2022-03-16,https://www.grant.com/
22-Aug-2021,RTGS,"196,411.88",00.00,"276,811.95",64619Ffb49EcFcf,4863,Jeff,Bolton,"Duke, Fritz and Elliott",East Mikaylaberg,Malawi,625.357.5746,001-582-662-6994x687,watsonsarah@tucker.com,2021-01-15,https://chan-rodriguez.biz/
22-Aug-2021,Debit Card,27.99,00.00,"276,839.94",aB2AbD6FB3E8A68,5228,Stefanie,Cisneros,Branch-Reid,New Catherine,Solomon Islands,001-023-249-6424x271,134-915-5394,gail17@davies.net,2020-03-20,http://www.carpenter.info/
22-Aug-2021,Commission,00.00,"276,839.94",00.00,59f2ca9Fc663CDb,4003,Samuel,Turner,Odom-Conrad,Lake Jesse,Cameroon,(757)093-5050,426-546-1647x04275,jfischer@mays.org,2020-06-22,https://www.gay.com/
22-Aug-2021,ATM,"1,053,768.00",00.00,"1,053,768.00",0b9374586BC8257,3266,Randy,Woodard,Rojas-Knox,West Adrienneside,Niue,(786)655-9630,+1-247-888-9663,mereditheaton@richardson.com,2022-04-02,http://stanley.biz/
22-Aug-2021,Transfer,501.65,00.00,"1,054,269.65",b52B9003Cf493D0,5580,Willie,Bird,Andrews Ltd,Joannamouth,Cote d'Ivoire,628-113-0516x92684,302.480.9289,nathan18@hayes-bradford.com,2020-11-27,http://holland-walter.net/
22-Aug-2021,Transfer,00.00,"263,567.41","790,702.24",947E3b94CAeCEef,7442,Whitney,Neal,Flynn Inc,Freyborough,Romania,219.950.3125,001-499-049-3288x316,gonzalezmarco@moody-madden.org,2021-01-22,https://www.nunez.net/
22-Aug-2021,Cheque,"43,377.00",00.00,"834,079.24",4E2A194a47c3C94,223,Holly,Ford,Walker Group,Mcgeemouth,India,674-359-8368x3113,001-386-467-9110x19533,sabrinaerickson@wise.info,2020-09-10,http://odom.info/
22-Aug-2021,Reversal,"1,095.50",00.00,"835,174.74",0fdCdc9c49C089A,95,Greg,Cortez,"Barajas, Hale and Ferguson",Knightmouth,Mayotte,579.250.1047,001-620-909-8580x84663,bonillaalex@cervantes.org,2021-03-20,http://www.mayer.com/
22-Aug-2021,RTGS,00.00,"83,517.47","751,657.27",33a4dDc2287eDC0,3291,Victor,Middleton,Mosley and Sons,Louisview,Anguilla,047.136.2632x37904,0618417074,jennarodgers@farmer.com,2021-10-04,http://summers-coffey.com/
22-Aug-2021,Debit Card,00.00,"375,828.64","375,828.64",0F116b0fA9632cB,6121,Edwin,Santos,Tran-Anthony,West Theresachester,Gibraltar,601-927-4898x85682,+1-604-991-4692x43657,nathaniel16@downs.com,2021-03-12,http://www.webster.com/
22-Aug-2021,RTGS,00.00,"187,914.32","187,914.32",c67A24bBdF7B3d7,9041,Dan,Blanchard,Romero-Le,South Debraland,Bermuda,576-466-1267,(763)637-7952x04286,eddiepotts@ayala-austin.com,2021-09-16,http://ayala-porter.com/
22-Aug-2021,ATM,00.00,"18,791.43","169,122.89",6BfB1CdA8DBF6dd,1563,Tony,Fuller,Hendricks-Dominguez,Frazierside,Barbados,001-482-957-9722,236.887.3293x61516,steve28@everett.com,2020-09-16,http://www.cain-colon.com/
22-Aug-2021,Miscellaneous,281.00,00.00,"169,403.89",bF2DF581FD0DC5a,4825,Sherri,Frey,Hardin Group,Mooreburgh,Congo,(062)211-5026,252.155.3997x5653,bryantmolly@brewer-yates.com,2020-09-16,http://riggs-cherry.com/
22-Aug-2021,RTGS,04.00,00.00,"169,407.89",AFCEA430Faa17aB,782,Johnny,Maddox,"Richard, Gomez and Carlson",North Sergio,Canada,000.513.1822x923,+1-721-314-8684x7898,cfinley@estrada.com,2021-09-17,https://cameron.com/
22-Aug-2021,Cash,00.00,"84,703.95","84,703.94",c6b9C45cA9cCf52,2661,Brandy,Hull,"Erickson, Gay and Madden",South Susantown,India,4245889803,875.089.4360x00349,nfrancis@cruz.com,2020-10-30,https://boyd-huffman.com/
22-Aug-2021,Reversal,361.00,00.00,"85,064.94",edfef6DBaF4ADA2,7465,Richard,Stark,"Kane, Solis and Becker",North Lindsay,Saint Barthelemy,140-119-1035x4211,+1-999-149-3335x87981,harringtonjose@cabrera-myers.com,2020-12-10,https://dawson.com/
22-Aug-2021,Debit Card,187.36,00.00,"85,252.30",3CaD177f2B4335e,6084,Stephanie,Roach,Mcmillan Ltd,West Bob,Palestinian Territory,234-014-2045x79138,(773)686-1215,tasha28@branch-dorsey.biz,2021-09-04,https://bell.info/
22-Aug-2021,RTGS,02.00,00.00,"85,254.30",Bf7cA8C3A47EdDe,7411,Christy,Dalton,Diaz Group,Lake Angelaview,Saint Vincent and the Grenadines,(065)391-0121x4428,2607822974,zclarke@clements.net,2020-02-08,https://www.dodson-woodward.org/
22-Aug-2021,RTGS,00.00,"10,656.79","74,597.51",d2F9EAFFD73E8A8,1425,Bryan,Cisneros,Bullock PLC,South Rodneyfort,Thailand,099.610.6865x71660,539-232-3180x4283,cesarthornton@dennis.biz,2020-04-20,http://hickman-gallegos.com/
22-Aug-2021,Purchase,00.00,"37,298.76","37,298.75",d83d4dEaDB1B320,900,Miranda,Callahan,"Pope, Adkins and Randolph",Haneybury,Bosnia and Herzegovina,623-353-5668,565-442-0573,pmccullough@allison.com,2022-03-19,http://www.davies.com/
22-Aug-2021,Debit Card,00.00,"5,328.39","31,970.36",a5Cfdaf71B6c3fe,6768,Katherine,Maddox,Hendricks LLC,Hughesfurt,Guyana,844.817.5403x29668,387-815-9829,wongeddie@wallace.biz,2020-04-13,https://norris-melton.com/
22-Aug-2021,Purchase,944.00,00.00,"32,914.36",67aAcA797fFB12B,4339,Martin,Duncan,Paul-Navarro,Tylerstad,Cayman Islands,001-726-143-8577x239,001-453-546-0800,vwalsh@tanner.com,2021-08-03,https://erickson.net/
22-Aug-2021,Cash,255.60,00.00,"33,169.96",eED91Fe6f1D6F7a,1380,Jermaine,Atkins,Durham-Gibbs,East Kathleen,Malawi,001-102-207-4760x75511,+1-274-968-4442x5787,cordovamolly@lloyd.com,2022-03-07,https://www.knapp-ellison.com/
22-Aug-2021,Reversal,07.96,00.00,"33,177.92",0c481c7F94a67FC,4327,Candice,Atkinson,Gillespie Group,New Alex,Ghana,435.283.7163x97137,(573)708-3164,durhamrickey@parrish.org,2020-12-26,http://andersen-salazar.info/
22-Aug-2021,Bill,00.00,"6,635.58","26,542.34",9CcaEF4adc094f1,9649,Alec,White,Bennett-Simmons,New Ivan,Uruguay,001-042-339-0660x39765,703-625-3541x955,alejandra30@jefferson-hester.com,2021-11-28,https://www.duffy-kirk.net/
22-Aug-2021,Miscellaneous,00.00,"4,423.72","22,118.62",E7D74f12DeA75FF,2177,Craig,Hoffman,Bowers-Cox,North Sallymouth,Lebanon,4225725307,001-775-854-9431x6922,ybrady@gilbert.com,2020-03-25,http://sellers-perry.com/
22-Aug-2021,ATM,00.00,"3,159.80","18,958.82",fbb8E90054AEFD4,2772,Cristina,Cox,"Kemp, Morgan and Harrell",Paulhaven,Guatemala,001-599-628-5603x5791,001-176-453-7030x67208,batessavannah@roberts.com,2022-04-30,http://www.beltran-caldwell.com/
22-Aug-2021,Commission,"2,523.70",00.00,"21,482.52",0DdF6Fe25EBb121,3626,Dana,Crane,"Le, Oliver and Hull",Haasfort,Iceland,558.227.9880,(824)406-3128x9078,qwiley@buck.net,2021-10-10,http://delgado-pacheco.com/
22-Aug-2021,Cash,00.00,"5,370.63","16,111.89",4Fc2AE0D62a61aB,5612,Mercedes,Mayo,Morris LLC,South Kaitlinview,Central African Republic,+1-874-931-8666x26485,475.558.4079x495,harrycarey@mccarty.com,2020-08-02,http://dominguez.com/
22-Aug-2021,Interest,205.30,00.00,"16,317.19",E6E45eBf1c0CdE3,5749,Jenna,Garrett,Guerrero-Combs,Estradaside,Niger,877.392.9112,+1-105-248-0807,rodgerspeter@arias-graham.com,2020-02-14,http://www.french.com/
22-Aug-2021,Miscellaneous,00.00,"3,263.44","13,053.75",35B456fFf617075,8553,Lisa,Hester,Fitzgerald PLC,Lake Blake,Turkmenistan,811-079-9113x952,573-672-9255,ralph11@soto.com,2021-08-13,http://chavez.com/
22-Aug-2021,Debit Card,00.00,"3,263.44","9,790.31",1aBF7f8f5bE294c,2648,George,Giles,Woodward and Sons,Gilesview,Jersey,(376)267-0467x343,001-703-256-0245,zmcintyre@conley.com,2021-01-01,http://moody.com/
22-Aug-2021,ATM,476.73,00.00,"10,267.04",4E6eEF1a78Ab0c5,8916,Theodore,Carson,"Mays, Johns and Landry",Port Laurieborough,United Kingdom,001-082-961-0596,530-044-8762x92319,rachaeldonaldson@byrd-schaefer.com,2021-02-03,https://www.hooper.biz/
22-Aug-2021,Commission,"3,899.20",00.00,"14,166.24",4F0ae76b2eA7e0C,984,Denise,Hendricks,"Brady, Schmitt and Baker",Wilkinsonmouth,Estonia,032.495.7453x2002,001-940-803-2437,jerome34@keller.com,2020-03-20,https://cole.net/
22-Aug-2021,ATM,00.00,"14,166.24",00.00,Aef541889C939f6,7258,Diana,Duran,Barry Inc,Spearstown,Denmark,135.963.5086x115,+1-115-925-6730x6549,jorgehess@key-fitzpatrick.org,2021-11-02,http://cook.org/
22-Aug-2021,Transfer,"656,096.00",00.00,"656,096.00",8C22EBC2100D1AB,6380,Shelley,Benitez,Levy-Oneal,Lanefurt,United Kingdom,(175)896-8255x1995,416-988-4394x66037,sjordan@obrien-wolf.org,2022-04-26,http://boone-salinas.com/
22-Aug-2021,Interest,00.00,"328,048.00","328,048.00",E3c7AD5Cde565cD,2516,Jesse,Marsh,May-Conley,Mcphersonshire,Marshall Islands,284-935-1119,505.619.7710,gabrielroach@jefferson-savage.info,2020-12-18,http://hardin.com/
22-Aug-2021,Commission,00.00,"46,864.00","281,184.00",F5Be8FFdeCFD3d9,9524,Rickey,Hebert,"Allen, Good and Rangel",Lake Lindsay,Puerto Rico,085-094-7540,362.316.2336x33861,ldunn@austin.com,2020-12-22,https://barron.com/
22-Aug-2021,RTGS,34.81,00.00,"281,218.81",b8bf7E6c86AE1cb,2443,Ricky,Daniels,"Burke, Cantu and Navarro",Hayleytown,Saint Helena,074-247-9621x87465,(412)754-9977x816,jonathon83@fitzpatrick.info,2022-04-08,http://reilly-pennington.com/
22-Aug-2021,IMPS,"1,729.00",00.00,"282,947.81",6D30DE16c37f3eC,5149,Sandra,Galvan,Burch-Horne,West Kathleen,Kuwait,(690)368-1888x027,+1-557-378-2255x4038,orrdanielle@welch.net,2021-11-08,http://www.hinton-lambert.com/
22-Aug-2021,Purchase,"251,149.62",00.00,"534,097.43",4EADd9328ed6D83,3511,Lee,Keller,Chapman PLC,East Norma,Tonga,+1-312-308-3209,+1-586-319-5277x96596,leonardmartha@hull.com,2021-11-26,http://stout.com/
22-Aug-2021,IMPS,02.00,00.00,"534,099.43",2D374DAfb707CE5,3094,Charlene,Schmitt,Landry-Robles,Haydenfurt,Nigeria,(344)847-7312,001-877-464-1586x09798,carriemckenzie@mcneil-nelson.com,2020-07-27,http://rodgers-taylor.com/
22-Aug-2021,Purchase,"3,957.00",00.00,"538,056.43",dd1d95ba2c7fCF8,2072,Jermaine,Welch,Rowland-Blackburn,East Brookestad,Mali,413-719-7610,455-465-2413x38231,jamespage@pope-jackson.com,2020-08-16,https://www.nicholson.com/
22-Aug-2021,IMPS,"751,814.20",00.00,"1,289,870.63",b0a0dfACe39e368,8777,Kaylee,Roberts,"Forbes, Meyers and Owens",North Wandafurt,Congo,990.616.5166,001-699-868-9084x5477,robertocaldwell@mccann.com,2021-08-28,http://www.hobbs-velez.com/
22-Aug-2021,IMPS,00.00,"161,233.83","1,128,636.80",82e520dcEe677ea,2817,Virginia,Pruitt,Floyd-Oneal,Madisonside,Congo,001-130-671-1393x420,+1-687-324-1565x1896,danharding@baldwin.org,2020-05-31,http://fuentes-beard.org/
22-Aug-2021,Commission,"1,890,083.80",00.00,"3,018,720.60",1eb9a595dea4aEA,6793,Damon,Galvan,Huber Ltd,Archerborough,Netherlands Antilles,851-076-5096x37877,001-564-547-9113x7592,darrenlewis@santiago.com,2021-04-02,https://www.benitez.net/
22-Aug-2021,Cash,"1,769,849.50",00.00,"4,788,570.10",feeDB184c9bebEe,6459,Jasmin,Townsend,Rocha-Fleming,Terrychester,Mali,900.798.5869x3194,752.240.5614,patrickwall@shea.com,2021-08-30,http://luna.com/
23-Aug-2021,ATM,00.00,"532,063.34","4,256,506.76",D0c4AD82CE491ed,7161,Eduardo,Pollard,Mccullough-Eaton,Nicholsbury,Portugal,072-510-5439x866,+1-932-054-1466x1485,albertkramer@cameron.org,2022-02-05,http://www.strong.info/
23-Aug-2021,RTGS,00.00,"532,063.35","3,724,443.42",a74d4b30DFA9047,3891,George,Pineda,Barron Group,New Lonniebury,Germany,228.503.7212x9942,(552)179-3490,darrylalvarez@lee.com,2022-03-16,http://khan.com/
23-Aug-2021,NEFT,242.00,00.00,"3,724,685.42",B1dFBfbe929ebA7,9416,Jackson,Bates,"Tran, Chambers and Shea",North Vanessahaven,Togo,+1-407-678-9401x416,(569)779-0752x9471,ojacobson@guerra.com,2022-04-21,http://www.washington-golden.biz/
23-Aug-2021,IMPS,04.90,00.00,"3,724,690.32",3fD8Fb092785f1f,3406,Ryan,Hartman,"Parks, Steele and Haynes",East Hayden,Nicaragua,001-879-688-7770,(553)155-1272,fishernicolas@gates-calhoun.com,2022-05-13,https://www.white.com/
23-Aug-2021,IMPS,00.00,"1,862,345.16","1,862,345.16",8D60704B7bF441F,1154,Judith,Griffith,"Ortiz, Cannon and Leonard",Mckenziebury,Monaco,4982011226,001-816-186-4122x834,gcarter@underwood.biz,2021-01-18,https://richardson.info/
23-Aug-2021,Tax,"31,262.70",00.00,"1,893,607.86",B62FfC93D6103c0,6388,Kerry,Martin,Rich-Dunn,Port Tamiton,Congo,+1-460-240-0628x5502,(592)973-8830x842,gallegostim@barrett.com,2022-03-07,https://bird.com/
23-Aug-2021,Reversal,00.00,"1,893,607.86",00.00,f1c44d0DB4c3BCa,3115,Alejandra,Rich,Townsend LLC,New Katrina,Canada,+1-246-983-7600,8486581549,boylenorman@yang-mueller.biz,2020-10-05,http://www.baldwin.com/
23-Aug-2021,Bill,"6,802.00",00.00,"6,802.00",63AfBfFC1Ea62b2,3011,Shane,Carson,"Hawkins, Petty and Bishop",North Tommy,Grenada,001-990-151-3942x679,565.635.3197,qcohen@nicholson.com,2020-11-11,https://www.mays.com/
23-Aug-2021,Reversal,"21,101.20",00.00,"27,903.20",b5fceAA9bdFa8ed,6612,Molly,Moreno,Arias Group,Ginaborough,Ethiopia,4096378199,(959)437-7243x658,piercecharlotte@oliver-clayton.com,2020-10-20,http://kelley.com/
23-Aug-2021,Debit Card,07.70,00.00,"27,910.90",baf2630E73Bcd41,7726,Harry,Newton,Herring Ltd,Monicatown,Cook Islands,(685)767-8271,229.947.1627x2216,steven58@casey-galloway.info,2020-06-14,https://kramer-castillo.com/
23-Aug-2021,Cash,"2,846.56",00.00,"30,757.46",bdaCc10A21Ffdab,7310,Kevin,Oconnell,Keller-Gallagher,Christieland,Belgium,+1-417-155-5387x450,(591)111-3392,neil42@mcdonald.com,2020-05-23,https://peters.biz/
23-Aug-2021,Miscellaneous,00.00,"7,689.37","23,068.10",AEBc2cbC73AB569,8576,Todd,Pace,"Ibarra, Oconnor and Mcdaniel",East Brucemouth,Myanmar,(929)772-9780,644-161-2685,kcisneros@rosales-kirby.com,2021-10-08,http://may-stevens.com/
23-Aug-2021,Purchase,00.00,"7,689.37","15,378.73",cfea97B3aB9E037,9615,Gwendolyn,Hartman,Leach Ltd,Christianfort,Mali,(294)869-6584,+1-961-090-7505x480,louisvega@lawson.com,2021-04-25,https://www.villanueva.info/
23-Aug-2021,RTGS,"49,316.00",00.00,"64,694.73",eB6EE0cA48c3F2f,3684,Louis,Skinner,Warner LLC,Parkerton,Aruba,001-728-602-6604x1056,+1-041-747-9787,lamtommy@church.com,2022-05-19,https://www.henry-brandt.com/
23-Aug-2021,Bill,"160,694.00",00.00,"225,388.73",E71b2840eDdf21c,1688,Tyler,Obrien,"Holland, Fry and Mckinney",South Carlos,Cambodia,049-955-1909,047.057.7267x7858,carolynjohnson@larsen.com,2020-06-08,https://blake.net/
23-Aug-2021,Cheque,"24,773.00",00.00,"250,161.73",Cc10fd55d3C7ac2,3132,Francis,Boone,Lawson Group,Lake Zacharystad,British Virgin Islands,001-737-604-7803x264,(304)259-7700,naguirre@spencer-mcneil.com,2021-01-25,https://buck.com/
23-Aug-2021,Tax,00.00,"125,080.87","125,080.86",B8EF5fa82Cf2eE5,2123,Andrew,Smith,"Myers, Sexton and Leblanc",Griffinton,Libyan Arab Jamahiriya,686-214-8507,001-448-962-3494,bsnyder@huff.com,2020-10-28,https://barton.info/
23-Aug-2021,Commission,00.00,"41,693.62","83,387.24",e6A4337A6bFDBb6,8040,Ralph,Beasley,Aguilar LLC,Port Tasha,Madagascar,0709460009,001-832-810-0936x9588,kerrytate@olson.info,2021-05-30,http://armstrong.com/
23-Aug-2021,Miscellaneous,00.00,"8,338.72","75,048.52",4322d1a5ea7E8BE,2758,Cassie,Wu,Travis-Black,Aliceberg,Greenland,246.767.1549x2705,779-541-0685,tiffanypearson@benson.com,2020-11-06,http://www.guerrero.com/
23-Aug-2021,Debit Card,00.00,"15,009.70","60,038.82",9df1C51847107D8,5176,Briana,Romero,"Wiley, Lucero and Delgado",New Jack,Turkmenistan,(230)019-6120x01529,214-947-3393,hallann@wilkerson.com,2021-12-11,http://www.owen-chandler.com/
23-Aug-2021,Transfer,"23,142.00",00.00,"83,180.82",a1F5BC70ef4AAfC,3367,Natasha,Hayes,Riley-Taylor,Tashaside,Bulgaria,001-433-991-3240x42563,895-508-8780x3821,arthur78@sandoval.com,2020-08-20,https://www.gallagher-levy.net/
23-Aug-2021,Interest,00.00,"20,795.21","62,385.62",c481C6D7Bc67E1E,794,Charles,Bradshaw,Mcdowell PLC,Thomastown,Benin,(383)738-7485,644.874.5744,avasquez@kidd.net,2020-02-18,http://gibson.com/
23-Aug-2021,Commission,00.00,"31,192.81","31,192.81",CCD016f5e064faF,1739,Gwendolyn,Foley,Heath and Sons,Emmaland,Turkmenistan,320.107.8978x2778,001-156-511-5085x73976,kara18@short.com,2020-03-10,http://donaldson-roach.info/
23-Aug-2021,Debit Card,"1,635,900.00",00.00,"1,667,092.81",Fb9eeb887CDBaFa,128,Glenn,Richards,"Francis, Bowen and Davis",West Sean,Turks and Caicos Islands,(898)998-1652,(983)573-0101,watkinsevan@ward.biz,2021-12-20,https://www.rojas.net/
23-Aug-2021,Debit Card,"24,696.40",00.00,"1,691,789.21",9EBdb20cb8Df48e,3973,Riley,Lopez,Solis and Sons,New Brendanview,Guadeloupe,028-060-3168x234,(767)072-7281,blankenshipkatrina@navarro-castaneda.info,2021-02-01,http://www.kidd.net/
23-Aug-2021,ATM,00.00,"211,473.65","1,480,315.56",35A70afdCF0bFe1,3077,Sherri,Dominguez,Rosales PLC,Kurtmouth,Ethiopia,819.440.6540,144.091.9104x0514,zavalamary@house.com,2021-03-09,https://beck-randall.org/
23-Aug-2021,ATM,00.00,"246,719.26","1,233,596.30",40b6054b6AF1f65,5868,Joseph,Hughes,Wiggins Ltd,Kevinstad,Myanmar,+1-017-852-9854x7783,053-701-5277,lynnhodges@madden.info,2020-06-11,http://logan.info/
23-Aug-2021,Interest,00.00,"411,198.77","822,397.53",D4CbCDE49e9ec16,4937,Craig,Hess,Fields-Mejia,Port Eugene,Bulgaria,8925640649,(636)960-7648x0343,hector51@hanson.net,2021-03-29,https://martin.org/
23-Aug-2021,Reversal,00.00,"137,066.26","685,331.28",2eD57cFCebf635B,8395,Kirk,Bennett,Norman-Dorsey,Howardland,Italy,(043)572-6548,+1-451-877-6763x00634,bailey74@obrien.biz,2021-09-18,https://bender.com/
23-Aug-2021,Tax,04.80,00.00,"685,336.08",6bF0C36DF0E9CdE,2019,Christine,Morrison,Weber-Giles,Isabellafort,Moldova,154.321.9140x451,695-246-1201x0155,willie82@benson.org,2020-04-20,https://sanders.com/
23-Aug-2021,Cash,"25,528.90",00.00,"710,864.98",3b8caCA4CEC452b,3057,Harold,Cabrera,Decker-Dean,North Victoria,Anguilla,188.976.7175,(772)442-0282x86312,sean25@grimes.org,2020-08-11,https://irwin-barnett.com/
23-Aug-2021,IMPS,00.00,"710,864.98",00.00,aDDAeE25Cbd1feA,5037,Jessica,Khan,Flores-Casey,Lake Triciaton,Singapore,+1-890-767-8102x52793,109.664.3155x974,travismoyer@gonzalez.com,2020-02-06,https://bennett.com/
23-Aug-2021,Cheque,"1,339.63",00.00,"1,339.63",8EBc8eFd3C603e4,8049,Christopher,Kline,"Wyatt, Lane and Odom",Lake Lindaburgh,United States of America,(058)994-3402x58412,+1-149-787-3446x66859,zbuchanan@chaney-may.com,2020-07-18,http://butler.com/
23-Aug-2021,Cheque,00.00,167.45,"1,172.18",Bec98f8CeD71A6c,3222,Glenda,Schroeder,Grant Inc,Port Marco,Congo,754-256-2155x82405,001-947-446-1697x6453,zhanna@summers.com,2020-10-28,http://greene.com/
23-Aug-2021,Miscellaneous,00.00,586.09,586.09,a5b4D563dcddAEa,6430,Isabel,Sheppard,"Walton, Frost and Hunter",Johnathanchester,Burkina Faso,927.933.9786,+1-045-632-6607x733,rickholt@pena.com,2020-08-19,https://www.carlson-moreno.biz/
23-Aug-2021,Miscellaneous,"81,586.00",00.00,"82,172.09",2e9d1d7eEeeE705,9984,Kristina,Mcbride,Mosley-Leblanc,Dawsonside,Peru,(978)364-6347x42361,(793)868-2981x26244,barbara02@frey.com,2022-02-13,http://nielsen-durham.org/
23-Aug-2021,Tax,"27,768.50",00.00,"109,940.59",C9F2caEBbD5d353,4181,Leon,Vega,Parsons Inc,East Isaac,United Kingdom,001-202-559-2980x597,(327)941-9788x239,mckenziewinters@marshall.org,2021-06-20,http://faulkner.net/
23-Aug-2021,Commission,"178,768.80",00.00,"288,709.39",e7D570aE4Fc1ab7,8043,Cheyenne,Daniels,Cobb LLC,Wadebury,Korea,001-055-528-2814x366,051.986.8855,cunninghamgabrielle@scott-norman.biz,2022-05-20,http://www.kirk.com/
23-Aug-2021,Tax,36.00,00.00,"288,745.39",fc94fcFCc5EF4e3,4395,Jennifer,Sherman,Barton Group,East Jaime,Pakistan,046-074-2754x6836,9521219091,trevor59@mooney-clements.info,2021-11-08,http://www.soto-shields.com/
23-Aug-2021,RTGS,01.00,00.00,"288,746.39",FACbB38ec0661F2,7032,Ivan,Lee,"Benton, Huynh and English",New Waltertown,Guyana,601.798.1663x82257,982.049.2044x24510,masonchapman@richard-miller.com,2022-02-17,http://www.myers.com/
23-Aug-2021,Bill,00.00,"32,082.93","256,663.46",df6Beba6f80EAAf,435,Marisa,Patrick,Roy Ltd,East Kara,Mozambique,6703662095,001-396-528-0814x06007,zwall@page.org,2021-12-15,http://www.mcdowell.net/
23-Aug-2021,Bill,00.00,"32,082.93","224,580.53",CedEF89c8fB6988,4357,Leslie,Richards,"Kim, Kelly and Freeman",Shafferfort,Morocco,436-977-0122,001-818-338-9698x28948,cameron42@gamble.net,2021-02-17,http://franklin.com/
23-Aug-2021,Miscellaneous,"137,830.59",00.00,"362,411.12",3B002Ca124e6a04,7192,Bridget,Branch,"Daugherty, Howell and Poole",Port Toni,Trinidad and Tobago,201.050.4291x408,(385)378-0018,julianmorse@castaneda-juarez.net,2021-10-01,https://warren.com/
23-Aug-2021,ATM,00.00,"60,401.85","302,009.27",65A708CD553C312,9644,Wesley,Nash,Tyler-Nolan,Wagnerport,Norfolk Island,001-941-319-3467x52638,(612)488-1258x05622,holtlarry@griffith.com,2021-03-13,https://schwartz.biz/
23-Aug-2021,Transfer,00.00,"151,004.64","151,004.64",D5e5fF1912D7B07,4152,Johnny,Montoya,Berry and Sons,Griffithside,Saint Martin,096-430-9218x11898,001-794-357-8961x74086,rodneylove@randall.com,2022-04-19,https://sherman-simmons.com/
23-Aug-2021,Commission,50.00,00.00,"151,054.64",7Ed614755a6fB40,9093,Adrienne,Grimes,Conley-Massey,West Carmenside,Cook Islands,001-470-380-0001x26435,(507)481-5526x599,daltonguzman@townsend.com,2021-08-13,https://www.duffy-oconnor.org/
23-Aug-2021,Debit Card,00.00,"15,105.46","135,949.18",B7dcD9aFE0FeA41,2062,Kiara,Charles,Long and Sons,Richardfort,Nauru,944.256.0846,(492)273-1599x40679,stephanieedwards@doyle-doyle.org,2020-01-31,http://cowan.org/
23-Aug-2021,Purchase,00.00,"22,658.20","113,290.98",C4D9DCcDf774Db5,6842,Darin,Lin,"May, Stanton and Goodwin",West Emma,Poland,001-841-325-5694,+1-102-939-9976x700,sue20@castro.com,2021-11-07,http://www.macdonald-goodman.com/
23-Aug-2021,Transfer,00.00,"18,881.83","94,409.15",34f4A71fBBa5C2A,1923,Sara,Heath,Molina-Wall,Staceyburgh,Angola,+1-473-858-2053,(569)112-3125,jaredshannon@shaffer.org,2020-11-16,http://hicks.com/
23-Aug-2021,Debit Card,00.00,"15,734.86","78,674.29",C39aAd76abA1059,5846,Whitney,Griffin,Larsen-Lin,North Wyattstad,Zimbabwe,3333956926,298-610-2753x70511,bailey04@pennington.biz,2021-12-19,https://downs-delacruz.com/
23-Aug-2021,IMPS,00.00,"9,834.29","68,840.00",eDBe8ceFF4cd853,5413,Shane,Gonzales,Vincent-Hanson,North Miguelville,Macedonia,+1-568-310-9711,001-031-100-9057x119,greggcontreras@hunt-stevenson.net,2020-04-19,http://anthony.net/
23-Aug-2021,ATM,"173,240.50",00.00,"242,080.50",3Fb763C591395Ba,8854,Alexa,Jensen,Reeves Group,Galvanside,Oman,(162)945-9855,941-188-0255,mike61@maxwell-mcmillan.info,2022-02-11,https://berger.com/
23-Aug-2021,Miscellaneous,"907,280.20",00.00,"1,149,360.70",bfD109ADdDD892a,5196,Nicholas,Velazquez,Newman-Dalton,South Deanstad,Cuba,390.395.3508,001-508-710-4119x8113,leedurham@mcmillan.net,2021-07-05,http://www.tanner.net/
23-Aug-2021,Tax,00.00,"287,340.18","862,020.52",b5F7F232df6C9fE,9734,Beth,Mack,Mahoney-Shannon,Mataland,Germany,531.212.5390,584.230.8499x43474,banderson@miles.info,2020-08-21,http://www.golden-vasquez.com/
23-Aug-2021,Bill,00.00,"107,752.57","754,267.96",CD841Cd2a9bb44D,3354,Danielle,Lynn,Solis-Jordan,Brandonfurt,Palau,230.528.1721x50561,682.641.8507,wvelez@reilly.biz,2022-04-14,http://www.yoder.com/
24-Aug-2021,Reversal,03.31,00.00,"754,271.27",14abfB44C5F38DC,3776,Kenneth,Li,Ball LLC,New Clifford,Azerbaijan,001-627-749-7814x8640,+1-695-037-5618x756,isabella25@williamson.net,2020-07-03,http://harding.com/
24-Aug-2021,Miscellaneous,"3,126.00",00.00,"757,397.27",Cb994EA466ae830,4743,Margaret,Carter,"Walton, Rowe and Hanna",Donaldland,Uruguay,634-283-6940x96754,(749)709-8352x581,cashley@bates.net,2020-11-28,http://www.herman.com/
24-Aug-2021,ATM,00.00,"252,465.76","504,931.51",97aF7BaB0Bee621,1337,Melvin,Duke,Levine-Kline,East Mathew,Niger,(268)239-6829x2059,790-754-2422x8206,lwoods@black.com,2020-09-12,http://velasquez.com/
24-Aug-2021,Bill,36.80,00.00,"504,968.31",D1fA32Dfc8369A8,1096,Kevin,Lucero,"Newton, Trujillo and Wiley",Kennethtown,Iceland,581.057.6836x739,001-991-455-4472x4719,fchurch@baxter-daugherty.com,2021-08-10,http://schroeder.org/
24-Aug-2021,Commission,"7,368.23",00.00,"512,336.54",3495F76c8FfF9c9,6762,Shari,Santiago,Reid-Gibbs,South Nicoleland,Cyprus,001-009-187-7301x49419,786-740-6466x990,timothypayne@estes-camacho.com,2021-10-09,https://haas.com/
24-Aug-2021,Purchase,98.00,00.00,"512,434.54",da5fB0c7F3d3b0A,4673,Matthew,White,Vasquez-Fleming,North Ianbury,Norway,001-009-592-2197x7672,(212)276-7240,cwatkins@gross.com,2021-04-25,http://www.downs-travis.com/
24-Aug-2021,Tax,470.00,00.00,"512,904.54",080a1101E4D8908,6403,Michele,Richard,Nixon Ltd,Gordonfurt,Palau,347-801-4787x441,047-917-8490,jaimeortiz@curtis.info,2022-01-14,https://www.ayers.com/
24-Aug-2021,Transfer,"1,781,076.00",00.00,"2,293,980.54",2E7b22f7456f1aE,5478,Danny,Callahan,"Calderon, Beck and Lindsey",Alexview,Slovenia,(156)077-1338x82255,829.767.3184x6253,ychoi@carpenter.org,2020-07-10,http://www.nichols.com/
24-Aug-2021,Transfer,00.00,"382,330.09","1,911,650.45",5Fe6A5796fc19c5,6991,Veronica,Prince,"Bennett, Allison and Brandt",Lake Hector,French Guiana,521-877-7221x7293,001-332-408-6052x2867,doughertyterry@bender.info,2021-06-11,http://spears-mccoy.com/
24-Aug-2021,Debit Card,"244,891.00",00.00,"2,156,541.45",8FC0AFb9B6fA8aF,8699,Kerry,Roth,Freeman-Oconnell,South Nicholetown,French Guiana,587.174.5267,496-569-2667,xpierce@brown.com,2020-01-12,http://www.keith-doyle.org/
24-Aug-2021,Interest,00.00,"2,156,541.45",00.00,fe8aBD23AD863eB,5387,Jeanette,Tanner,Miles Ltd,Rebekahtown,Austria,099.671.2570x16105,0070378809,kclay@nielsen-gray.biz,2022-03-11,https://www.brock.org/
24-Aug-2021,NEFT,10.80,00.00,10.80,be1cfe3c3c9Ff98,3664,Nathan,Cowan,Fritz LLC,Harveyborough,Fiji,954.480.8777x3072,(763)739-8687x242,alexandergarrison@tapia.com,2020-04-26,https://joyce-weaver.info/
24-Aug-2021,ATM,00.00,01.80,09.00,cc4AF4bDAedc57d,1271,Elizabeth,Avery,Maddox LLC,Sarahmouth,Guernsey,739-055-7614x58257,001-480-830-4807x690,joanna87@morales.net,2020-11-12,http://www.faulkner-nielsen.org/
24-Aug-2021,IMPS,399.40,00.00,408.40,fC49c3D4aFAD1Ab,1852,Faith,Conway,"Ball, Leblanc and Baxter",North Erikberg,Bolivia,565.087.9856x481,1947568597,karlahood@walls-massey.org,2021-05-24,http://hartman.com/
24-Aug-2021,NEFT,04.38,00.00,412.78,7Bd0fC9e49Beb35,575,Teresa,Drake,Riley-Ali,Lake Lucastown,Romania,001-771-089-7065x537,001-964-762-7963,qpierce@hoffman.com,2020-09-28,http://www.petty-shea.biz/
24-Aug-2021,Tax,03.00,00.00,415.78,5118ccfEcCFf92F,2447,Joanna,Salas,Morris-Brown,West Angel,Tuvalu,629-652-7192x06828,096-007-8323,vdyer@vega.com,2022-01-17,http://www.king-rivera.org/
24-Aug-2021,Interest,00.00,138.59,277.19,32d496aBa5120E0,675,Cristina,Barrett,"Contreras, Leblanc and Estes",Daltonfurt,Azerbaijan,+1-347-841-1509,(138)646-2543,jermainebryant@kline.com,2021-11-09,http://key-fischer.com/
24-Aug-2021,Tax,00.00,69.30,207.89,e10CdE4EAb446d7,7623,Greg,Schaefer,"Patterson, Horton and Booth",West Alexandraville,Tonga,(067)294-3803x5822,137-600-2560,abigailmcgee@bishop.com,2021-09-22,https://dominguez.info/
24-Aug-2021,Commission,32.73,00.00,240.62,0baBa8a3e0a46Ab,1769,Edwin,Winters,Grant LLC,Bridgetland,Uzbekistan,(594)874-7501,+1-534-915-3908x91188,fordantonio@adkins-krueger.info,2020-08-10,http://www.frazier.com/
24-Aug-2021,NEFT,00.00,26.74,213.88,44e4d6d857c3caA,8363,Gilbert,Conner,Patrick-Richards,Spenceborough,Ethiopia,001-151-625-3891x151,451-747-6580,claytonortiz@brandt.info,2020-09-25,https://gonzalez.com/
24-Aug-2021,Commission,00.00,213.88,00.00,cE26d5BBEc5aeeE,1834,Austin,Knight,Walter-Espinoza,Sheriville,Kazakhstan,+1-994-436-6664x6190,+1-716-520-9719x1785,herbert33@keller-morrow.org,2021-09-29,http://saunders.com/
24-Aug-2021,Transfer,"1,750,338.00",00.00,"1,750,338.00",B6Ef430Fdd87Cb4,7823,Mercedes,Thompson,Underwood-Gaines,Derekchester,Dominica,(235)129-6652,2938767088,ymelendez@mcgee.biz,2021-02-07,http://www.kelley.info/
24-Aug-2021,ATM,"750,164.00",00.00,"2,500,502.00",Bb66e8Ecea7E2eD,1053,Peter,Kennedy,Serrano-Parrish,Lake Leroyview,Italy,3109394825,4307402014,jesus85@spence.com,2020-08-30,http://downs.com/
24-Aug-2021,Debit Card,481.74,00.00,"2,500,983.74",EbAcd8Fbc4Cb53d,6002,Kurt,Morris,Boyer-Sloan,Port Warrenstad,Colombia,(857)195-1983x159,8530396172,qcastaneda@keller.com,2021-10-09,http://www.le.com/
24-Aug-2021,Debit Card,00.00,"312,622.97","2,188,360.77",999FA8efffEbBA4,2900,Sean,Roman,"Mata, Chambers and Calderon",Lake Karenside,Bhutan,086-141-3487,6696386786,nathangregory@ballard-davidson.com,2020-06-26,http://vasquez.org/
24-Aug-2021,Miscellaneous,00.00,"364,726.80","1,823,633.98",594Baf152FE9D31,2731,Michelle,Gay,Schaefer-Archer,Amberburgh,French Polynesia,(437)851-1584x5546,001-362-441-0969x891,jball@marsh.com,2022-01-26,https://pugh.com/
24-Aug-2021,Commission,"16,069.00",00.00,"1,839,702.98",3011adBC97dC143,2338,Angie,Shepherd,Cowan-Bray,Shepardview,Guam,+1-042-073-9603x491,+1-724-276-5178x01645,avilacarolyn@aguirre.com,2020-08-22,http://www.spence-briggs.com/
24-Aug-2021,Commission,08.00,00.00,"1,839,710.98",C4B4E97AFc7aDAC,616,Jimmy,Wade,Ellison-Bailey,Lake Dillonmouth,Cayman Islands,255.260.6606x343,863-328-5590x403,dawn23@watts-cohen.net,2020-08-21,https://www.barber.com/
24-Aug-2021,NEFT,00.00,"262,815.85","1,576,895.13",E3D5B6ee13A76eE,2255,Mitchell,Duarte,"Mcfarland, Boyle and Bender",Rickberg,Nepal,478.634.2906x2672,127-991-5720,kaylee69@george-gilmore.com,2020-11-30,https://gould-diaz.biz/
24-Aug-2021,Purchase,"7,931.00",00.00,"1,584,826.13",7a619E93F0cA947,5922,Leonard,Reid,"Vega, Carroll and Bell",East Michelle,Dominica,+1-301-236-6777x1811,753.267.0061x585,georgehayley@freeman-freeman.org,2020-05-09,https://www.crane-hamilton.net/
24-Aug-2021,Cash,00.00,"198,103.27","1,386,722.86",F899c0eB5F9f113,3875,Nicole,Levine,Odonnell Group,Cherylmouth,Gibraltar,799.729.8394x2456,(448)522-5524x20937,tomreynolds@pope.com,2021-11-12,http://www.arias.com/
24-Aug-2021,Cheque,53.40,00.00,"1,386,776.26",69Fc5Cc077bB27b,8658,Joseph,Baird,"Lutz, Butler and Sexton",New Johnny,Djibouti,(007)415-7670,001-442-775-9193,ncooper@cunningham.com,2021-09-28,http://pollard.com/
24-Aug-2021,Cash,00.00,"198,110.89","1,188,665.37",DE662Ecaa7A0cbf,8336,Lindsey,Benson,Mccoy-Weeks,Hooperbury,Latvia,301.026.7927x189,(497)678-6161x3375,jaclynchase@rangel.com,2021-07-17,http://www.pruitt.com/
24-Aug-2021,Purchase,00.00,"118,866.54","1,069,798.83",d7A2A88F6FB35cA,7580,Kiara,Ponce,Harvey PLC,Toddfurt,Korea,+1-995-009-7103x426,102-073-1162,dillon42@hickman.org,2021-02-23,http://bullock.info/
24-Aug-2021,IMPS,64.00,00.00,"1,069,862.83",d491CFa1E0CCa63,5833,Shelia,Swanson,"Rodriguez, Tanner and Buchanan",North Kelseyborough,Antigua and Barbuda,(929)901-4011x195,(012)127-3984,nbrennan@beck.com,2022-05-14,http://www.fletcher.net/
24-Aug-2021,Debit Card,00.00,"267,465.71","802,397.12",dFbC1EDEa186C2a,4782,Carrie,Merritt,Glenn-Chambers,Schaeferland,Bhutan,(018)626-6086,4738263512,latasha02@williamson.com,2020-03-10,https://www.hatfield.org/
24-Aug-2021,Purchase,00.00,"89,155.24","713,241.88",4Da30e84965430E,5680,Eduardo,Booth,Ewing-Dickson,Lake Margarettown,Saint Pierre and Miquelon,154.909.9706,734.652.6583x042,kelliemcbride@solis-small.com,2020-02-23,https://www.randall-schneider.com/
24-Aug-2021,Cheque,00.00,"356,620.94","356,620.94",485cb41C4af792C,5892,Kylie,Martinez,Bautista Ltd,New Elijahport,Guinea-Bissau,800.903.0807,186-214-0822x915,wmiddleton@winters.com,2021-08-11,https://www.richards.com/
24-Aug-2021,Debit Card,00.00,"71,324.19","285,296.75",C5DDd86f74EcCF4,8660,Nicole,Watson,Barker-Moody,Priscillafurt,Brazil,001-472-121-7688x9393,2319065584,yjacobs@sloan.com,2022-02-27,https://terrell.biz/
24-Aug-2021,RTGS,00.00,"31,699.64","253,597.11",e66014D2AB4cbd8,4768,Nicholas,Michael,"Thompson, Chen and Yoder",Christensenborough,Thailand,030-931-8083x792,450.931.7951x8622,chelsea39@torres.com,2022-02-04,https://jimenez.info/
24-Aug-2021,ATM,00.00,"25,359.71","228,237.40",6E2f5f6cdBBfD6E,6696,Gregg,Ritter,Evans Inc,Ronnieshire,Cambodia,924.099.7533x486,303-112-5557,jade57@sullivan.com,2020-12-15,http://www.johnson.biz/
24-Aug-2021,Debit Card,00.00,"45,647.48","182,589.92",F846fcB67Fc6D5e,3233,Hailey,Richard,Koch-Myers,Lake Bianca,Namibia,719-193-8587x6158,001-618-671-8661x42342,mccannherbert@dorsey.net,2021-03-29,https://wilkinson-mann.biz/
24-Aug-2021,Debit Card,00.00,"45,647.48","136,942.44",0d923eaA542cAF6,3613,Connie,Murray,"Green, Blanchard and Carey",East Jessicabury,Bhutan,001-092-067-1030,774.504.4427x2042,thernandez@odom.net,2021-05-12,https://www.lloyd-hull.com/
24-Aug-2021,Transfer,00.00,"68,471.22","68,471.22",FC7ce1F9A65eFca,1971,Crystal,Guerrero,Huffman Group,Stacyberg,Brazil,+1-491-410-8903x704,001-991-011-3725x40321,stephen66@nielsen.com,2020-08-07,http://www.hodge-brown.biz/
24-Aug-2021,Interest,112.90,00.00,"68,584.12",98d145000afe632,9263,Jean,Bishop,Dennis-Foster,North Austin,Iraq,001-559-490-1606x0571,876.928.1131,lamariel@reed.com,2020-09-04,http://www.dennis-mata.com/
24-Aug-2021,Cheque,00.00,"6,858.41","61,725.71",Ddd183Dc18780FC,3650,Kristopher,Lawson,Anderson-Leon,Port Tanya,Panama,+1-511-917-7464,758-964-8587,billmacias@shepard.com,2020-12-09,http://www.shah.com/
24-Aug-2021,Reversal,00.00,"15,431.43","46,294.28",4ede9D5B2cD79bd,2149,Joann,Mckay,Mckay PLC,Port Cole,Dominican Republic,+1-007-507-9444x917,037.504.6947x546,dlowery@austin.com,2020-12-26,https://www.knox.com/
24-Aug-2021,Interest,26.40,00.00,"46,320.68",7662Aee114DE1b1,520,Christian,Hansen,"Cohen, Zavala and Hodge",Russelltown,Thailand,875-297-1537x6615,465.146.2449,annettedavid@mcintyre.com,2021-10-08,http://blair.com/
24-Aug-2021,ATM,98.00,00.00,"46,418.68",EaF880AfB58bb2D,7250,Peggy,Blankenship,Greer and Sons,Lake Lindseyburgh,Eritrea,493-459-3330x7742,+1-210-782-2664,erinjoseph@tran.biz,2021-11-30,http://www.pope.com/
24-Aug-2021,Miscellaneous,00.00,"4,641.87","41,776.81",f2A9Fd74aAebb06,3657,Leah,Fernandez,"Powers, Johns and Mccoy",New Joel,Cayman Islands,001-566-415-1181x12795,336.200.0732,calvinavery@burnett-davies.com,2020-02-28,http://burch.info/
24-Aug-2021,RTGS,212.00,00.00,"41,988.81",881e35bac03aC94,7130,Francis,Esparza,Chang-Mcguire,Bethmouth,Sao Tome and Principe,(257)822-5470,3531277188,costacassidy@dunn.info,2021-09-25,https://schmitt.net/
24-Aug-2021,NEFT,00.00,"10,497.20","31,491.61",d0D0F0b144d26DE,2038,Ashley,Massey,"Carson, Hopkins and Cunningham",North Janechester,Djibouti,919.255.0384,259-123-6072x16797,hensonzoe@gaines.com,2020-04-15,https://www.reilly-terry.biz/
24-Aug-2021,IMPS,"2,313.00",00.00,"33,804.61",FeA461cdD0aBfBa,4977,Eugene,Atkins,Graham-Ray,West Derrick,Belarus,(158)309-8674,001-973-278-4961x8015,tharrell@price-chaney.com,2021-03-18,https://copeland.org/
24-Aug-2021,NEFT,"6,503.41",00.00,"40,308.02",AB2EDb72c2AcD24,1335,Kristen,Dunlap,Gordon and Sons,Billyberg,Western Sahara,+1-823-640-1196x567,(091)806-4617,makayla42@carr.com,2021-11-24,https://www.cuevas.info/
24-Aug-2021,Cash,"134,374.00",00.00,"174,682.02",5B8430b6B89BBfd,6856,Cheyenne,Knight,Harper PLC,Trevorfurt,Netherlands,3945869122,271.432.7045,gonzalesjonathan@wyatt.net,2020-09-09,http://www.novak.com/
24-Aug-2021,NEFT,13.18,00.00,"174,695.20",Ca39543a15fBe1f,5895,Marie,Baldwin,"Mccarty, Buchanan and Nunez",Jacobsonville,Saint Barthelemy,486-748-8458,+1-131-445-8873x78358,prattbruce@velez.net,2020-01-17,https://meadows.net/
24-Aug-2021,Bill,"6,801.00",00.00,"181,496.20",4cbeDDA73bEaFDC,4483,Martin,Stokes,Montes-Bowen,Reeveshaven,Paraguay,211.353.9768,074-412-2017x20399,wukerri@cole.com,2021-09-04,http://www.ramos.org/
24-Aug-2021,NEFT,05.60,00.00,"181,501.80",5eCa666ecDdBD51,2292,Kari,Vega,Woods Ltd,Kentfurt,Pakistan,129-845-6622,001-320-025-6512x9655,angelmosley@norris-garrett.com,2022-03-29,https://www.downs.biz/
24-Aug-2021,Tax,00.00,"20,166.87","161,334.93",DDaEB0Ade6E0EDf,2769,Tommy,Adkins,Olson-Thornton,Loriville,Iceland,1435993231,362-378-9427,lindsay57@kramer-chaney.info,2021-08-13,http://www.roach-calderon.net/
24-Aug-2021,Transfer,00.00,"16,133.49","145,201.44",6a0ACAe7A7cFd7E,1091,Hannah,Fisher,Horn Ltd,East Traceymouth,Croatia,294-949-2014x47890,(221)421-7569x244,rhull@hardin.com,2020-01-26,https://www.harper.biz/
24-Aug-2021,Transfer,00.00,"145,201.44",00.00,594Baf152FE9D31,2731,Michelle,Gay,Schaefer-Archer,Amberburgh,French Polynesia,(437)851-1584x5546,001-362-441-0969x891,jball@marsh.com,2022-01-26,https://pugh.com/
24-Aug-2021,Bill,452.83,00.00,452.83,DdCd40b5aEc3DD0,2736,Tara,Bowers,Moss Inc,South Glendaborough,Jamaica,(987)193-1940,001-249-967-5911x072,haroldmoody@olson-massey.com,2020-04-01,http://www.cline.biz/
24-Aug-2021,Bill,00.00,90.57,362.26,1d0D5dbCfB33Fb6,3491,Jacqueline,Yang,Durham-Frederick,Braunfort,Bhutan,(763)091-7981,(529)044-0294,pittsarthur@booth.com,2021-08-30,http://mcintosh.com/
24-Aug-2021,Commission,07.53,00.00,369.79,bA8addb8ABfbEAF,3849,Brent,Valdez,"Knight, Horn and Reed",West Xavier,San Marino,214-956-3703x0855,+1-318-423-0812,jillthornton@hardin.com,2020-03-20,https://mcknight-gilmore.com/
24-Aug-2021,Purchase,00.00,123.26,246.53,Af8ceBaEC0a8e23,3051,Meagan,Dillon,Holloway Group,Garymouth,Botswana,+1-132-860-7569x409,365.429.4821x143,oscar92@trujillo.com,2020-03-11,http://burke.com/
24-Aug-2021,Tax,00.00,61.63,184.90,54Be82FddFdACB1,6488,Ronnie,Hernandez,"Morrow, Sellers and Foster",South Darren,Liechtenstein,+1-937-832-0469x8399,666-291-1850x94830,bowersglenda@cowan-koch.com,2020-04-01,https://www.landry.net/
24-Aug-2021,NEFT,00.00,20.54,164.36,aE072dc97b13f9F,4839,Caitlin,Todd,Beard-Smith,Carlyhaven,American Samoa,(766)550-3988,0852449439,danielle89@norton.biz,2021-08-12,https://foster.com/
24-Aug-2021,Tax,161.59,00.00,325.95,da26FA89fda8aF7,3505,Emily,Finley,Harding Ltd,Karinachester,Cape Verde,+1-561-076-6490x857,001-377-302-6809x882,sierrahensley@wilkerson.com,2022-03-19,http://oneill-tapia.com/
24-Aug-2021,Bill,"246,999.80",00.00,"247,325.75",62153ef9c0Dfe01,9508,Ernest,Haynes,"Mccall, Downs and Hunt",Port Dorischester,Panama,834-570-1996x2860,4481404330,sheliahogan@villarreal.com,2020-04-14,http://www.juarez.com/
24-Aug-2021,ATM,"28,004.80",00.00,"275,330.55",31C0ADfa5F40c40,465,Shirley,Anthony,Maxwell Ltd,West Tonistad,French Polynesia,+1-193-838-3198x1601,5959421166,phillipshayley@carr.com,2020-05-08,http://mcdowell-pugh.info/
24-Aug-2021,Commission,00.00,"27,533.06","247,797.50",502eeD60cf21bef,8908,Tommy,Fields,Hanson-Cowan,East Mikaylaberg,Estonia,+1-690-620-6446,+1-909-505-0103x699,lgamble@stewart.info,2021-12-22,http://mccarty.net/
24-Aug-2021,RTGS,00.00,"41,299.58","206,497.92",97aF7BaB0Bee621,1337,Melvin,Duke,Levine-Kline,East Mathew,Niger,(268)239-6829x2059,790-754-2422x8206,lwoods@black.com,2020-09-12,http://velasquez.com/
24-Aug-2021,Bill,831.00,00.00,"207,328.92",9eCACF2A95A5C28,7020,Timothy,Le,Robbins-Benjamin,Jeanburgh,Armenia,190-292-5739,802.077.1351x0629,romantaylor@benjamin.biz,2021-11-01,https://www.pennington.com/
24-Aug-2021,Miscellaneous,"1,030,153.25",00.00,"1,237,482.17",97a4e7D22E1dA2c,9018,Carlos,Marshall,Rocha-Ritter,Curtisport,Macedonia,+1-096-697-9648x71558,+1-346-521-2288x015,bullockariel@butler.com,2022-01-13,https://www.macias-nolan.com/
24-Aug-2021,Debit Card,00.00,"247,496.43","989,985.74",5DdFD314FDFe3B1,2756,Natalie,Lynn,Mercado-Sosa,Mathisview,Cote d'Ivoire,+1-547-998-7744x17972,(329)145-4006,yangvictor@munoz.com,2020-03-15,http://bell.com/
24-Aug-2021,Reversal,00.00,"989,985.74",00.00,dA3738F8Fa334cE,1119,Jillian,Serrano,Hall Inc,Port Kerriberg,Russian Federation,(107)026-9838,281-162-3267x8555,wintersharry@sheppard.org,2021-12-29,http://www.tanner.biz/
24-Aug-2021,IMPS,"245,458.56",00.00,"245,458.56",59cdbf0F33e7bCB,8976,Karla,Scott,"Frye, Singh and Hale",Stefaniefort,Nigeria,714-355-3994,921.769.5064,gschneider@perez-beltran.biz,2021-07-30,https://www.garcia.net/
24-Aug-2021,Tax,"8,270.20",00.00,"253,728.76",dC26cDe880F3Cf7,1178,Glenn,Hartman,Mcknight-Giles,Perryville,Benin,001-986-894-8752x738,032-725-1174x4602,michaela64@schaefer.com,2021-03-06,https://roth-odonnell.info/
24-Aug-2021,Cash,00.00,"36,246.97","217,481.79",Ad3475Ab9D57a21,9580,Blake,Cuevas,Tran-Ross,North Gabrielamouth,Northern Mariana Islands,997-016-2288x8233,500-431-2197x56505,beverlyhull@sims.info,2020-03-10,http://bradshaw.com/
24-Aug-2021,RTGS,144.80,00.00,"217,626.59",a69FE7b7Bff9DE4,7611,Charles,Ibarra,"Buck, Travis and Kent",North Catherinemouth,Uzbekistan,587-944-5718,980-889-2048x349,calhounalejandra@silva.com,2020-04-04,http://fitzgerald.biz/
24-Aug-2021,Bill,00.00,"72,542.20","145,084.39",A1953df32D2D6Fd,5991,Robert,Salazar,Mullen-Weiss,Lake Omarfurt,Uzbekistan,9516428324,(895)804-2930x76806,brandymerritt@holder.com,2021-01-10,https://love.org/
24-Aug-2021,Debit Card,"543,151.00",00.00,"688,235.39",0c851DAE4231CcD,1222,Martha,Farmer,Le LLC,Morganfurt,Micronesia,965.794.9928,516-482-6162x66160,gstephenson@webb.net,2021-10-06,https://www.lowery-mclaughlin.biz/
24-Aug-2021,Cash,00.00,"68,823.54","619,411.85",A92054Cd8b9D34e,6879,Samuel,Mccormick,"Reed, Phelps and Gray",Claytonland,Thailand,+1-794-566-3044x91163,749-385-2991x87686,bonnie24@perkins.com,2020-05-24,http://www.caldwell.org/
24-Aug-2021,Purchase,00.00,"68,823.54","550,588.31",B21DeEaC7f6Cab9,2997,Cassie,Gonzalez,Rollins and Sons,Brittneytown,Saint Lucia,791.136.7606,+1-441-857-9225x6964,emaxwell@arias.info,2020-08-29,http://www.crawford.com/
24-Aug-2021,Tax,00.00,"61,176.48","489,411.83",AAaF6aaeed4D4CF,9285,Chelsey,Mooney,Norton-Kelley,Lorettafurt,United States Minor Outlying Islands,+1-317-733-5760x6858,(136)466-0566,glendawong@key-sherman.com,2021-08-18,http://crane-roberson.info/
24-Aug-2021,Purchase,61.30,00.00,"489,473.13",491aF3C0eE7cc30,3821,Shaun,Hood,Powell-Newton,Anitahaven,Macao,117-067-9129x81914,604-448-9164x55910,johnathan12@lutz.com,2022-01-12,https://www.frank-fischer.com/
24-Aug-2021,Debit Card,00.00,"48,947.31","440,525.82",Ca39543a15fBe1f,5895,Marie,Baldwin,"Mccarty, Buchanan and Nunez",Jacobsonville,Saint Barthelemy,486-748-8458,+1-131-445-8873x78358,prattbruce@velez.net,2020-01-17,https://meadows.net/
24-Aug-2021,IMPS,00.00,"73,420.97","367,104.85",16A42bAFA0fCc0e,1492,Monique,Todd,Brewer Ltd,West Ronniefurt,Timor-Leste,6421203313,(755)490-1137,linda68@allison-allison.com,2021-03-03,http://www.jensen.com/
24-Aug-2021,Bill,52.65,00.00,"367,157.50",8443442A3Be484a,3165,Adam,Castro,"Farrell, Duarte and Stokes",Hunterborough,French Polynesia,558.104.5793x9365,334-469-6915,princemark@avery-mejia.com,2020-11-28,http://www.richard.net/
24-Aug-2021,Tax,"3,578.90",00.00,"370,736.40",c2f673Ea671be42,7748,Lauren,Arias,"Ball, Santiago and Larsen",Port Gina,Morocco,052.002.8746x688,6591790707,aguilarerik@rodgers.com,2021-03-27,https://pope-hanson.org/
24-Aug-2021,Cash,00.00,"92,684.10","278,052.30",dEb2606bf822bc6,8159,Jonathon,Werner,"Lopez, Horne and Leblanc",Heathmouth,Thailand,+1-739-846-5147x74532,001-948-149-4364,campbellbridget@pierce.com,2022-04-11,http://myers-bartlett.net/
24-Aug-2021,Interest,00.00,"27,805.23","250,247.07",6719c486C8651e3,8486,Cassie,Boone,Armstrong and Sons,East Jerome,Botswana,7775384803,+1-487-743-8255x0225,beverlyhale@weaver.biz,2020-04-29,https://www.nguyen-gonzales.org/
24-Aug-2021,ATM,00.00,"27,805.23","222,441.84",ecf299F385ECf3d,2591,Eddie,Horn,"Mills, Yates and Shaw",Maddenshire,Iran,(998)075-2158x360,001-082-399-4675x084,davieskaylee@gates.info,2020-07-21,http://rose-winters.com/
24-Aug-2021,Commission,"28,795.00",00.00,"251,236.84",bdDAe02c37B399E,4025,Adam,Palmer,Richards-Underwood,New Baileybury,Bahrain,393.827.5715x715,(697)629-2853,xhudson@landry.com,2021-06-24,https://meyer-bryan.com/
24-Aug-2021,Cheque,"61,807.20",00.00,"313,044.04",A87ADB9f283fBBC,5774,Sandra,Fitzgerald,Vazquez and Sons,North Carlmouth,Taiwan,(354)535-0766x42008,4789416814,chobbs@richmond.biz,2021-01-29,https://www.ramsey.org/
24-Aug-2021,Interest,"1,060.00",00.00,"314,104.04",1ea3765332D9CbF,9256,Kent,Alexander,"Jennings, Robertson and Hobbs",Roseview,Iran,358-024-7612,154.544.5935x906,johnny08@jacobson.com,2020-06-30,http://huff.net/
24-Aug-2021,Reversal,00.00,"39,263.01","274,841.03",589BE2fdBAb3c55,8967,Shirley,Rivera,Miles PLC,Lake Debrafurt,Algeria,376.550.7943,001-905-185-6117,jcopeland@bartlett.com,2021-12-16,https://www.patel-li.org/
24-Aug-2021,Cheque,06.80,00.00,"274,847.83",5a3Ed08524aA9CA,423,Cole,Byrd,Dillon-Perry,Hansenhaven,Aruba,+1-987-530-4402x2205,958-830-8852x883,obrienisabel@braun.com,2020-02-01,http://hudson.com/
24-Aug-2021,Interest,00.00,"39,263.98","235,583.85",0C6Bce4E5a22882,5676,Gene,Farley,"Ruiz, Compton and Mcdaniel",South Bianca,Timor-Leste,823-176-5428x79975,+1-304-400-0507x8861,heathbrandi@key.org,2022-02-22,http://www.ramsey-mccann.net/
24-Aug-2021,Reversal,00.00,"39,263.98","196,319.88",4dCb1364f1D1656,2917,Isaiah,Walters,Aguirre-Mack,Scottbury,Turkmenistan,(541)187-6824x8078,468-581-9094x69759,donaldrandolph@cline.com,2021-01-06,https://graves.biz/
24-Aug-2021,Commission,00.00,"98,159.94","98,159.94",C4BA7bcACe4A939,8452,Jane,Vasquez,Bass LLC,South Robinburgh,Armenia,475.542.9046,790.656.5425x52031,adrian90@williams.com,2022-04-25,http://www.hays-winters.net/
25-Aug-2021,Interest,00.00,"10,906.66","87,253.28",216911fECD44D61,6248,Virginia,Gillespie,"Hodge, Finley and Pacheco",West Pamelaport,Togo,+1-284-763-8380,551.476.6477x2168,shafferbrett@holmes.com,2021-02-20,https://newton-russell.com/
25-Aug-2021,IMPS,"23,342.00",00.00,"110,595.28",c9Fc82D2C249a05,2960,Carolyn,Fields,Bird Group,Port Tommy,Central African Republic,+1-219-184-8925x2231,001-579-750-7399x692,jimenezshannon@miller-mendoza.com,2022-04-08,http://www.white.com/
25-Aug-2021,Commission,00.00,"13,824.41","96,770.87",8B8d0C970ef087e,659,Carol,Neal,"Daniels, Mcdonald and Zhang",New Shelly,British Virgin Islands,220.236.4003x99597,597-261-4214x784,rickygamble@may.com,2021-07-22,https://www.pacheco.net/
25-Aug-2021,Transfer,"3,729.00",00.00,"100,499.87",9c3b65de1d7BE54,527,Ellen,Rogers,"Melendez, Graham and Mullins",South Wandamouth,Montserrat,366.925.8628x93172,001-092-471-7968x5264,davidrogers@hernandez.net,2021-06-11,https://www.robertson.com/
25-Aug-2021,Debit Card,"3,854.81",00.00,"104,354.68",DFce3Baf57EE7dA,4637,Jordan,Mcintyre,Ewing Group,East Guyland,Russian Federation,001-960-317-6627x0049,712-704-0003x24872,wyattshelia@cunningham.com,2020-07-30,http://goodwin.biz/
25-Aug-2021,IMPS,00.00,"104,354.68",00.00,3deF6B4Db3908f2,8005,Penny,Hayden,"Wallace, Brown and Norton",North Franklintown,Northern Mariana Islands,402-309-7946x4651,994-869-2910x111,sergiojames@christensen-cohen.com,2020-09-17,http://www.burnett-murphy.com/
25-Aug-2021,Tax,183.10,00.00,183.10,6F9aCA7a4F014D1,2142,Kiara,Gentry,Grant-Barrera,East Kyle,Guernsey,+1-218-401-4412x281,+1-046-449-9589x1762,jordannavarro@moses.com,2020-06-25,https://www.henry-clements.biz/
25-Aug-2021,Commission,"129,245.56",00.00,"129,428.66",DfEcb07E5Eef1eC,9694,Aaron,Simpson,Cooley Inc,East Jeremiah,Mauritania,126.707.5199x465,+1-541-486-5690x96696,callahanvanessa@garner-daniel.biz,2020-05-04,https://hendricks-davenport.net/
25-Aug-2021,Interest,"1,154,596.25",00.00,"1,284,024.91",Fde2Ac280b148BD,8538,Melinda,Perez,Gomez LLC,Deniseburgh,Egypt,+1-406-193-7024x68516,506.984.2935,elaine43@barber.biz,2022-04-28,https://vaughn.biz/
25-Aug-2021,RTGS,00.00,"256,804.98","1,027,219.93",68fbb98f6EbD971,421,Jack,Robbins,"Choi, Galloway and Fox",Kevinbury,Norway,001-084-704-0454x28664,330.200.8023,haasderrick@ortega-kirk.org,2020-12-02,http://farrell.com/
25-Aug-2021,Interest,00.00,"128,402.49","898,817.44",21296ee3eE1Ff8a,87,Marcia,Vaughan,Yu-Roy,Petersbury,Equatorial Guinea,742.373.3173,001-302-878-6175x08344,ellen80@bonilla.com,2020-10-22,http://jefferson.com/
25-Aug-2021,Tax,"20,061.00",00.00,"918,878.44",9D9B2e5Be8847Df,6823,Bobby,Whitehead,"Allison, Goodman and Camacho",North Jaclyn,Antarctica (the territory South of 60 deg S),+1-471-424-7726,067-371-5960,rebekahlynch@gray.info,2021-10-12,http://www.mckinney.net/
25-Aug-2021,Transfer,"43,817.00",00.00,"962,695.44",5D29aB907d93eB7,6164,Wesley,Mendoza,Aguirre-Villa,Pachecomouth,Singapore,+1-353-821-1293x795,8033959254,goodwinanthony@kim.org,2021-04-13,http://clarke.com/
25-Aug-2021,ATM,00.00,"481,347.72","481,347.72",00Ba3F0aC1bDbaE,5779,Christina,Patterson,Livingston Inc,South Danielfort,Macao,001-006-772-8187x398,182-230-0952x903,ana02@tanner.org,2021-03-09,https://www.barnett.info/
25-Aug-2021,Reversal,01.00,00.00,"481,348.72",df0dC07031AfBBe,274,Kristina,Larson,Vargas-Garrett,Beltranland,Ireland,(843)172-1473,237.668.4393,sloanmeagan@key.com,2021-01-09,https://fowler.com/
25-Aug-2021,RTGS,05.00,00.00,"481,353.72",1332679d9CBD83D,1310,Glen,Stevenson,"Hodge, Long and Maddox",North Terriberg,Iraq,869.960.0800,758.792.0275,martha18@holland-robles.org,2020-11-28,http://www.owen.com/
25-Aug-2021,Purchase,00.00,"53,483.75","427,869.97",B01Ef88C8c7ee1F,8396,Jaime,Delacruz,"Bonilla, Sampson and Wiggins",Lake Haileymouth,Fiji,001-507-381-7959x264,+1-256-132-4798x2466,kaylee42@watkins-tran.com,2022-01-10,https://lutz.com/
25-Aug-2021,ATM,"143,643.50",00.00,"571,513.47",4bb7da595370acF,5455,Alejandro,Avila,Figueroa-Finley,North Lawrence,Myanmar,001-676-546-9252x8454,001-055-817-8171x0182,kellishaw@valenzuela-trujillo.com,2021-07-25,http://www.santiago-rios.info/
25-Aug-2021,Cheque,00.00,"81,644.78","489,868.69",BCb3f0dEBf64d1D,7229,Vickie,Ross,Li Ltd,Samanthamouth,Montenegro,365.465.8775,123-034-2521,debbie85@cole.biz,2021-01-02,http://www.norris.com/
25-Aug-2021,Transfer,00.00,"122,467.17","367,401.52",D972Fa94B3acCde,4845,Ariel,Whitehead,Rogers-Barber,Heidiport,Congo,891-113-5483x04696,001-359-776-1105x446,prichmond@dickerson.com,2020-08-12,http://www.gibson.net/
25-Aug-2021,Miscellaneous,00.00,"45,925.19","321,476.33",Fa08f2adbDa958a,6981,Travis,Duffy,"Chen, Shea and King",East Miafort,San Marino,134.270.0119x570,852.359.1371,pearsonalexandra@mcfarland-frye.biz,2021-04-08,http://hanson.info/
25-Aug-2021,Commission,00.00,"35,719.59","285,756.74",bBe2e6b601fA522,9004,Andres,Frost,Mccormick-Maynard,Rangeltown,Sudan,+1-652-018-2734,613-640-9657x05050,judyreynolds@griffith-carpenter.net,2020-08-14,https://wagner.com/
25-Aug-2021,Interest,00.00,"31,750.75","254,005.99",B13dB4aC1f3110F,856,Bianca,Campos,"Herman, Hanson and Contreras",West Karen,United States Virgin Islands,+1-572-022-2471x11856,001-468-705-0053,farleyariana@rivers-norman.com,2020-12-28,https://www.espinoza.com/
25-Aug-2021,Purchase,"215,235.00",00.00,"469,240.99",FccE8Bf3cecdBEb,175,Monique,Ewing,"Lester, Ayala and Harmon",East Maxborough,Antigua and Barbuda,972.635.8026,332.322.2094x970,evansstuart@griffin.org,2021-12-16,http://mata.com/
25-Aug-2021,Transfer,"1,401,456.25",00.00,"1,870,697.24",206BC3d36E2D937,3583,Jill,Church,Jenkins-Houston,South Tashaberg,Bangladesh,210.205.3360x4079,2903797817,lucasrichard@chandler-cross.com,2021-01-26,https://www.bradley-hodge.info/
25-Aug-2021,Purchase,00.00,"233,837.16","1,636,860.08",f63ac7B26d281e9,6785,Parker,Wilkerson,Walker Inc,Breannaburgh,Saint Barthelemy,+1-238-758-8654x7828,119-940-3839,jknight@hudson.net,2020-03-04,http://www.howell-joseph.biz/
25-Aug-2021,Purchase,00.00,"818,430.04","818,430.04",E2fEF1bA17A5A4B,2454,Drew,Rubio,Daugherty-Cruz,New Melaniefurt,Somalia,0394431738,001-865-775-3311,barrybrittney@ramsey-villegas.com,2020-02-14,http://sandoval.com/
25-Aug-2021,IMPS,05.90,00.00,"818,435.94",3240aC3deefc4e4,7198,Jerome,Hernandez,Moreno LLC,Eatonberg,Tuvalu,+1-854-348-2422x127,(287)660-3264,gina88@cowan-howell.com,2021-02-06,https://www.young.com/
25-Aug-2021,Purchase,"655,379.25",00.00,"1,473,815.19",4940D8Fb9BcF5b8,8518,Manuel,Figueroa,Mcbride-Douglas,Mccarthymouth,France,285-062-6048,095.758.8135,connor96@good.com,2020-08-15,http://www.bowers-booker.org/
25-Aug-2021,Bill,00.00,"147,381.52","1,326,433.67",9feCdcdF90BCbfB,821,Barbara,Mayo,Nixon Group,New Lorrainefort,Tonga,596.996.9057x743,119-132-4717x11846,kevin88@simon.com,2022-03-16,https://www.grant.com/
26-Aug-2021,Bill,"31,255.00",00.00,"1,357,688.67",94fd798dC0d7D55,7775,Dominique,Ferrell,"Roberts, Moss and Crosby",Marisamouth,Faroe Islands,842-950-3087x051,(391)829-3509,wardcharlene@becker-cortez.com,2021-12-29,http://www.henry.biz/
26-Aug-2021,Miscellaneous,00.00,"452,562.89","905,125.78",fE48ffc6070EFcB,8341,Brendan,Walsh,Powers Inc,Blackwellville,Kazakhstan,(851)895-5397,(512)174-3113x100,iobrien@fox-boyer.com,2020-05-18,https://singh.com/
26-Aug-2021,Cash,00.00,"452,562.89","452,562.89",5F131a198B25fDD,318,Derek,Soto,"Everett, Moran and Stone",North Gregg,Ireland,248.205.0443,301-878-9007x00289,kyates@holder-coffey.org,2021-03-12,http://guerrero.com/
26-Aug-2021,Bill,00.00,"56,570.36","395,992.53",eee808cAf64Ceb7,7836,Brandi,Rush,Hampton Inc,Port Laurenland,Cambodia,584.244.8567x393,(928)764-0220x0367,smoses@hunt-sanchez.com,2020-12-02,https://fitzpatrick.com/
26-Aug-2021,Debit Card,27.61,00.00,"396,020.14",Bca2d5CeeF19eaa,6103,Jessica,Giles,Donaldson PLC,Katieton,Latvia,145.495.3899x313,001-055-930-1041x3084,buckleyjames@gallagher-scott.biz,2021-06-29,https://www.scott.net/
26-Aug-2021,Cheque,"226,737.20",00.00,"622,757.34",A6279AfD61CdEEd,6184,Erik,Peters,"Daniel, Thornton and Beck",Loveton,Cameroon,626-028-0250x016,(202)139-3775x417,maria69@dunn.com,2022-03-29,https://www.barrera.info/
26-Aug-2021,Bill,00.00,"103,792.89","518,964.45",e9afebccEFCdDc3,6546,Aaron,Pena,"Pollard, Michael and Powell",Port Gavinville,Angola,001-177-689-2075x4203,174.951.0383x2871,yvettewalters@arias.net,2020-08-16,http://www.wilkinson.com/
26-Aug-2021,Bill,00.00,"51,896.45","467,068.00",a0eb3D0bDcfB8Bd,52,Judith,Fischer,"Oconnor, Glover and Park",Lake Joshua,Isle of Man,6570280667,001-929-759-1013x923,natasha83@delacruz-edwards.com,2020-01-26,https://spencer.com/
26-Aug-2021,Cheque,00.00,"46,706.80","420,361.20",ffAFa8e95099910,2690,Gregory,Mclean,"Mahoney, Buckley and Blanchard",Lake Cody,Gambia,518-744-1264x00276,385.242.6627x36292,sabrina74@steele.com,2020-12-29,https://www.short.com/
26-Aug-2021,Commission,328.00,00.00,"420,689.20",D4ccA95D79aa49E,4843,Carla,Best,Kaufman-Dougherty,West Sergio,Christmas Island,(031)257-4659,262-827-2570,sullivanglen@cummings.com,2021-03-28,http://khan.info/
26-Aug-2021,ATM,"18,242.94",00.00,"438,932.14",F3D4b4B8fEa3ad4,5988,Jade,Daniels,Blanchard Group,South Destinymouth,Belize,464-311-4296,001-775-052-5536,leonardbrady@hawkins-hill.com,2020-10-12,https://hess.biz/
26-Aug-2021,Transfer,00.00,"109,733.04","329,199.10",cbfcF1c0BAB625f,7408,Tabitha,May,Mendoza-Norris,Travisburgh,Moldova,200-986-4808,+1-961-100-0904x0807,hgriffith@duran.org,2020-08-08,http://www.castro-nixon.biz/
26-Aug-2021,ATM,"173,815.20",00.00,"503,014.30",aFeBE6Ffa4C3486,4329,Alisha,Daniel,Boyle-Garcia,Lake Isaiahtown,Saint Pierre and Miquelon,790-035-9112,(777)699-2015,rlyons@fuentes-rhodes.com,2020-12-09,http://www.chung.com/
26-Aug-2021,Debit Card,"244,627.90",00.00,"747,642.20",FBEBf1D6e9Bee98,4860,Antonio,Kirk,Gutierrez-Ferguson,West Erikfort,Panama,+1-708-514-8672x95048,001-891-340-1393x176,carmenstrong@landry.org,2021-02-26,http://www.rasmussen-love.com/
26-Aug-2021,NEFT,00.00,"186,910.55","560,731.65",FDE3CA49D4E0E47,230,Tricia,Barrera,"Parrish, Frey and Wiley",North Randallstad,Paraguay,+1-305-357-7846x89244,001-745-690-6733x89839,philip88@carr.biz,2021-12-29,http://www.boyle-archer.net/
26-Aug-2021,Commission,"12,466.00",00.00,"573,197.65",2CF975b751Db0Cf,7729,Tammie,Peterson,Lamb Ltd,Salinashaven,Palestinian Territory,(732)832-6458x43282,763-662-8626x542,dodsonkirk@clarke.org,2022-03-20,http://frye-garcia.biz/
26-Aug-2021,Cheque,00.00,"71,649.71","501,547.94",2B6ceDcabC0Cd1C,8124,Diamond,Mcneil,Benton-Craig,Oliverport,Montenegro,650-598-5901,(153)853-5869x5693,ballholly@wilson.com,2020-10-07,https://www.boone.com/
26-Aug-2021,Bill,"3,193.00",00.00,"504,740.94",54C9fAb4E24375B,1512,Clifford,Perkins,"Oconnell, Lam and Petty",Kristophertown,Slovakia (Slovak Republic),205.569.6200,(119)665-8553x2647,cisnerosbrianna@larsen-payne.com,2020-02-07,http://haney.com/
26-Aug-2021,Cheque,00.00,"72,105.85","432,635.09",AeEaeDc36fAa1BC,6409,Jade,Sweeney,Rowe Ltd,Karenton,Cayman Islands,653-114-8608,(103)292-6514x7370,jose41@mora.com,2020-02-09,https://www.harmon.com/
26-Aug-2021,IMPS,"30,422.81",00.00,"463,057.90",7eDeE5dBFEaBD9C,5838,Jasmin,Cuevas,Wyatt-Walter,Orozcoshire,Kiribati,(905)027-3698x19725,001-341-012-5973x197,staffordsavannah@jarvis.org,2022-04-24,http://www.rojas-reeves.biz/
26-Aug-2021,ATM,00.00,"92,611.58","370,446.32",d2cFcbC9ebdA7Ad,4814,Joseph,Flynn,"Davis, Joyce and Molina",Charleston,Congo,+1-892-940-4763x656,(371)644-4246,woodwardjoanna@butler-mckenzie.biz,2021-02-18,https://sullivan-whitaker.com/
26-Aug-2021,Purchase,03.00,00.00,"370,449.32",FdF7F6e6D49739a,7420,Jorge,Maddox,Hodge LLC,West Francistown,Faroe Islands,(820)794-9460,(472)778-2822x628,adrienneescobar@gardner.com,2020-05-02,http://www.davenport-gray.com/
26-Aug-2021,Commission,776.51,00.00,"371,225.83",dea3eFB3b564FEe,8238,Dean,Dyer,Ryan PLC,Chenfurt,Barbados,(093)320-7714,6264712740,marc69@duran.org,2020-04-19,https://johnston-wong.info/
26-Aug-2021,Bill,00.00,"37,122.58","334,103.25",14BEc500d6A777d,2491,Rebecca,Sampson,Cameron-Moyer,Beardchester,Isle of Man,+1-690-922-4618x82795,306-928-2344x098,meyersrobin@vazquez.com,2021-08-05,https://www.scott.com/
26-Aug-2021,Interest,00.00,"66,820.65","267,282.60",a1Adf3271aBdd04,6457,Bryce,Gill,Sexton-Lowery,Port Lauren,Gambia,1915035103,+1-098-458-8627x2541,whiteheadtaylor@grant-olsen.com,2021-11-16,https://santana.biz/
26-Aug-2021,Miscellaneous,00.00,"33,410.33","233,872.27",fdf93ecBB75e990,3625,Dominic,Fuller,"Harmon, Navarro and Winters",South Earl,Italy,(846)203-9829,328-584-9755x5174,mackenzie79@rowe.com,2020-06-04,http://www.glenn-benjamin.com/
26-Aug-2021,Miscellaneous,00.00,"58,468.07","175,404.20",482f1a8fdCbAA58,8379,Tabitha,Hendrix,Conrad Ltd,Philipstad,South Georgia and the South Sandwich Islands,(479)448-1861,001-689-296-2105,frazierdenise@branch.info,2021-02-14,http://www.elliott.org/
26-Aug-2021,Interest,00.00,"21,925.53","153,478.68",aC3E4d6Ceedca2b,5581,Brenda,Ford,Madden-Livingston,West Raymondmouth,Chad,004-455-0074x784,(930)341-7583,villareginald@taylor.com,2020-02-14,https://boyle.com/
26-Aug-2021,Miscellaneous,"4,014.00",00.00,"157,492.68",CFe80D9710d755f,2641,Harold,Andrews,Guerra Inc,Blairview,Japan,001-243-352-5681x4855,001-031-615-8617,kirkchristensen@andrews.info,2022-04-21,https://grant-dorsey.com/
26-Aug-2021,Purchase,00.00,"157,492.68",00.00,B15BB5D1225eFFE,8417,Cynthia,Short,"Krueger, Sanders and Jefferson",North Ann,Ethiopia,757-267-4926x34356,234-177-7759x8830,sampsonvictor@hurley.org,2020-01-23,http://www.rhodes.biz/
26-Aug-2021,Interest,"1,862.00",00.00,"1,862.00",6CFAA9f71E9423B,855,Judy,Rogers,Meyers and Sons,Cliffordborough,Saint Helena,(181)997-7317,+1-610-634-3284x8288,vernon50@dennis.biz,2021-04-10,http://davenport-jefferson.com/
26-Aug-2021,Bill,45.00,00.00,"1,907.00",FbEbaf3dfC9CcD8,1658,Savannah,Singh,Hess and Sons,North Annette,Saudi Arabia,(721)685-8782,001-523-145-3751,tammy98@donovan.biz,2021-05-06,http://clay.com/
26-Aug-2021,RTGS,00.00,953.50,953.50,2cfDE68A372cC7A,16,Larry,Newton,Downs PLC,Mannstad,Belize,(216)514-1412,001-449-365-5864x147,ypayne@gaines.biz,2020-08-09,https://figueroa.com/
26-Aug-2021,Interest,00.00,953.50,00.00,A8fcB4B7e9a922F,3395,Gina,Villegas,Moss LLC,Ewingville,Nigeria,001-773-752-0453,399-500-4358,diazalvin@barrera-ferrell.org,2021-01-28,http://www.harrell-atkinson.com/
26-Aug-2021,Transfer,41.00,00.00,41.00,0d36A1739B6B148,5915,Sophia,Archer,"Andersen, Bradshaw and Coleman",Williamland,Saint Lucia,+1-110-399-0304x6469,0417597298,anewton@burke.info,2020-11-27,https://hooper-moody.com/
26-Aug-2021,NEFT,00.00,06.83,34.17,ddBE7127F64A81B,7616,Sonia,Velez,"Myers, Mcknight and Ross",South Maryborough,Romania,+1-195-695-9309x872,310.977.2600,biancadoyle@oliver.biz,2021-03-15,http://moreno-barton.com/
26-Aug-2021,IMPS,00.00,08.54,25.63,dE1Ae4fea53eaC2,1890,Sarah,Leblanc,Ashley-Melton,Daltonville,Sudan,317.783.1164x385,2227393195,jimbailey@hays.org,2020-02-07,http://www.acevedo-allison.biz/
26-Aug-2021,Tax,"1,712,353.50",00.00,"1,712,379.13",4FbFAFDfF28d6b4,6893,Caroline,Blackwell,Rangel-Curry,East Diane,Haiti,592-549-0967x51402,223-260-1311,bondapril@richardson.com,2021-09-24,http://www.montoya.com/
26-Aug-2021,Cheque,59.80,00.00,"1,712,438.93",AdAdE69E6a75FAa,4954,Shawn,Horton,Mason-Clarke,Lake Jefferyshire,Cyprus,927.485.9116x054,463-428-8804,sabrina20@maddox.info,2021-04-13,https://galvan.com/
26-Aug-2021,Tax,00.00,"171,243.89","1,541,195.04",dfB583F38c289Cc,5530,Dominique,Gay,Farmer-Moses,Copelandport,Cameroon,2552418437,001-188-066-5156x4861,wilkinssylvia@mercer-page.com,2020-04-17,https://mcgrath-suarez.biz/
26-Aug-2021,Reversal,"174,159.80",00.00,"1,715,354.84",83d5b6bba5dC1FD,8691,Darlene,Blevins,"Castillo, Collier and Gibbs",Yufurt,Austria,340.117.4220x05591,237.409.0906,angie51@pacheco.biz,2022-04-27,https://glover-rosales.com/
26-Aug-2021,Debit Card,08.20,00.00,"1,715,363.04",BAde9dd1bc068BD,7988,Julie,Peck,"Wolfe, Lane and Garrison",Stevensville,Israel,555-133-0499x250,(705)911-6516x3346,kirkleonard@serrano.com,2020-05-16,http://www.garcia.net/
26-Aug-2021,Interest,00.00,"1,715,363.04",00.00,AF64c02A20410f5,1925,Susan,Faulkner,Dillon Ltd,Port Kirstenmouth,Zimbabwe,+1-491-811-4201x4025,(325)759-9729x95975,leroymeyer@beard.com,2021-02-01,http://www.berg.biz/
26-Aug-2021,Bill,782.00,00.00,782.00,a7A58daFFa207BD,2783,Kathryn,Clay,Garrison-Bond,Kurtburgh,Tajikistan,075.981.0402x6410,+1-698-265-4956x1457,rileyyvette@kane-ruiz.org,2021-11-16,http://www.mills-harper.com/
26-Aug-2021,Tax,"2,756.41",00.00,"3,538.41",da33dd230Ffd7c5,3045,Bryce,Lara,Kaiser-Hardin,Ellenton,Croatia,001-406-297-9725,622.954.8682,philip29@english.com,2020-01-26,https://nixon-cline.org/
26-Aug-2021,Commission,"3,845.00",00.00,"7,383.41",b19bCAF021ecE2C,6538,Amber,Nguyen,"Abbott, Sampson and Huynh",Brendanland,Albania,751-762-9417x80561,(557)201-2638x9992,shelley60@ryan-rosario.com,2020-06-11,http://www.santana.com/
26-Aug-2021,Tax,"167,438.91",00.00,"174,822.32",979cAb2Bb00CD2c,225,Breanna,Gaines,Holland-Burgess,Whitneyburgh,Maldives,361.882.3352x1956,210.320.8584x3668,yolanda53@thomas.info,2022-01-26,https://www.marshall.com/
26-Aug-2021,Reversal,19.28,00.00,"174,841.60",A634Af2aBBD3dE4,3433,Calvin,Murphy,Cardenas and Sons,Timothyborough,Latvia,(292)171-3250,(146)921-2142x885,elijah44@lambert.com,2021-11-16,http://www.holloway.info/
26-Aug-2021,Reversal,"1,482,692.75",00.00,"1,657,534.35",743E069Ac5AEe8B,2144,Meghan,Stone,Rollins Group,Bettyton,Uruguay,001-544-676-1642x779,565-690-3393,dfaulkner@hogan.com,2022-03-19,http://flynn.com/
26-Aug-2021,Tax,"3,718.00",00.00,"1,661,252.35",50c1bAd0B750cB9,7125,Bill,Conner,"Odom, Serrano and Gregory",Malikland,Portugal,1071527957,001-388-791-3939x9695,dawnponce@jacobs.com,2020-01-06,https://lawrence-costa.com/
26-Aug-2021,Commission,00.00,"830,626.18","830,626.18",b0a33aE58BC7903,4699,Colton,Pennington,Pace LLC,Johnathanhaven,Pakistan,426.361.9567,(642)874-1363x57314,tammiecortez@chen.biz,2022-02-20,https://oliver.net/
26-Aug-2021,NEFT,"3,621.27",00.00,"834,247.45",aCF2Cb91eCB8508,417,Hayley,Swanson,Sellers-Martin,Lake Terrencemouth,Sri Lanka,+1-437-602-5300,(092)476-1804x587,rickybarrera@mathis-nicholson.com,2022-02-11,http://schroeder-schmitt.com/
26-Aug-2021,Purchase,00.00,"166,849.49","667,397.96",82A64F4BffBC8D0,4110,Isabella,Washington,Taylor and Sons,Dicksonshire,Netherlands,001-606-930-0114x500,+1-021-380-3389x1414,umoody@sheppard.com,2020-06-20,https://figueroa.org/
26-Aug-2021,Reversal,07.20,00.00,"667,405.16",30F0323e54c375A,8613,Dawn,Boyle,Powell-Lynn,Kristyville,Costa Rica,001-183-046-7726x764,+1-756-792-6041x628,tbowers@trevino.com,2021-09-21,http://www.graves-mercer.com/
26-Aug-2021,Transfer,00.00,"74,156.13","593,249.03",4D215934249B53f,7673,Nathaniel,Cline,Cobb-Chapman,Averytown,Sierra Leone,001-409-497-0979x7262,(709)916-1660x75883,jacksontiffany@levy.biz,2022-02-15,http://weber.com/
26-Aug-2021,Purchase,00.00,"118,649.81","474,599.22",D51b40267112fB9,2163,Shaun,Beard,"Carpenter, Reid and Thornton",North Megan,Korea,+1-905-612-0020x639,651-541-2714x76210,alvin02@allison-barker.com,2020-08-15,https://mckenzie-horne.com/
26-Aug-2021,Purchase,190.97,00.00,"474,790.19",EEf8d89988c36Fc,8696,Sherry,Atkinson,Alvarez-Wall,North Candice,Denmark,001-377-614-6491x646,001-091-598-8770x131,alijo@livingston.com,2021-05-11,https://booth-martin.net/
26-Aug-2021,Miscellaneous,"127,193.00",00.00,"601,983.19",52ba3D9f457bbAE,8110,Lucas,Ryan,Burke Inc,North Pamela,Slovenia,122-563-1073x607,+1-227-041-7200x9613,michellecontreras@chase-flowers.info,2020-09-25,http://www.franco-duncan.info/
26-Aug-2021,NEFT,"25,694.50",00.00,"627,677.69",F81ABF4F815CE97,4148,Geoffrey,Wright,Kirby-Knapp,Mcclainmouth,Cuba,4861561140,+1-856-841-8569x2916,ellisclinton@conley-cisneros.org,2021-11-23,http://orozco.info/
26-Aug-2021,Cash,00.00,"627,677.69",00.00,3B49CEBA7cf85bA,9918,Sally,Stephens,Weber-Whitney,Robertaside,Brunei Darussalam,(408)640-1653x78247,(085)243-7158x2466,xhamilton@berger.com,2020-08-18,http://padilla.com/
26-Aug-2021,Tax,172.00,00.00,172.00,031e4fa6ab0a228,4847,Nicholas,Ortega,Castro PLC,Marshview,Benin,001-126-447-4201x693,+1-957-881-8781x52507,stuartrice@berry.com,2021-08-20,http://gardner.com/
26-Aug-2021,NEFT,00.00,34.40,137.60,4C7a746f04E4a2A,132,Suzanne,Rhodes,"Sparks, Floyd and Barnett",Earlberg,Kazakhstan,6513845571,763.204.0066,hmccarty@sharp.biz,2022-01-15,https://atkins.com/
26-Aug-2021,Purchase,765.10,00.00,902.70,5aFAadaE373EbFD,7172,Kellie,Golden,"Johnson, Byrd and Wilkerson",Schmidtside,Madagascar,(873)617-6107x8721,150-234-8604,landryevan@shannon.net,2020-10-09,http://mendez.com/
26-Aug-2021,Cash,"17,052.70",00.00,"17,955.40",ed91594c5aFFdAE,3564,Maureen,Haley,Webster PLC,New Debbieside,Cape Verde,713.649.4493x257,+1-008-697-4739x45151,beardcassidy@parker.com,2021-12-07,https://www.ross-suarez.biz/
26-Aug-2021,IMPS,"32,327.30",00.00,"50,282.70",Ac0edeD9D6d5e0A,4228,Shawn,Cervantes,"Blankenship, Mcdowell and Hayden",Jeffreyside,Congo,(921)701-6557,417.437.6674,heidi97@morgan.com,2020-10-14,http://gallagher.biz/
26-Aug-2021,Reversal,00.00,"16,760.90","33,521.80",eEb1aaDd31c8Fd6,9308,Sheryl,Huff,"Hanna, Foley and Avery",West Dalton,Christmas Island,(655)914-7614,+1-124-882-0755x6669,qwall@klein.com,2020-08-02,https://www.johnson.com/
26-Aug-2021,Debit Card,00.00,"16,760.90","16,760.90",f21CF91B332Dac8,9967,Margaret,Hines,"Wilkinson, Lamb and Holt",Gouldview,Guyana,727-808-0986x9527,868.979.0956,cheyenneboyd@tucker.biz,2022-01-15,https://www.mann.com/
26-Aug-2021,ATM,"654,328.00",00.00,"671,088.90",5fcb4b2EAb8A38c,7874,Zoe,Cochran,Harrington Ltd,New Alexisburgh,Tuvalu,308.604.9871,669.993.2856x91657,leonardcalhoun@edwards.biz,2022-02-19,http://velasquez.com/
26-Aug-2021,Transfer,00.00,"167,772.23","503,316.68",fe403A083051df0,9583,Robyn,Gardner,Young LLC,Kelleytown,Maldives,(479)941-1731,001-222-217-8671,lsparks@pollard.com,2021-10-17,https://www.kaiser.com/
26-Aug-2021,Purchase,"1,080,377.50",00.00,"1,583,694.18",3EACEbD1eAd2B5F,4810,Sharon,Ford,Silva-Rodgers,Gileston,Albania,938.521.3394x83041,(396)811-0521,xwarren@rowland.com,2020-01-05,https://www.cunningham.info/
26-Aug-2021,ATM,"2,047,593.20",00.00,"3,631,287.38",1ACdeF80EF0d1Bf,9871,Craig,Chen,Mullins-Chung,Shirleymouth,Georgia,(779)012-4865x71465,001-651-205-6731x5817,chelsea72@alvarado-melendez.com,2021-03-09,http://www.best.biz/
26-Aug-2021,ATM,00.00,"453,910.92","3,177,376.46",FcFcd5CCC5aB946,5049,Kayla,Stephenson,Larsen PLC,North Natalieside,Afghanistan,804-244-4792x978,547-726-4799,jeffpowell@ho.com,2022-05-28,https://www.newton-mcdonald.com/
26-Aug-2021,Reversal,00.00,"1,588,688.23","1,588,688.23",415cBaD5FCECaBf,6854,Glenda,Irwin,Hartman Group,South Kellitown,Fiji,533-155-7888,(865)032-1734,jenniferharmon@schultz.biz,2020-11-13,https://harrell.net/
26-Aug-2021,Bill,00.00,"198,586.03","1,390,102.20",151c881FAd91AB2,8679,Alexander,Beltran,"Vang, Skinner and Fletcher",Lake Reginald,Slovakia (Slovak Republic),5378749671,(772)403-5979x823,marcuscrane@holmes-valencia.com,2020-01-15,https://schmidt-perkins.com/
26-Aug-2021,Cheque,"2,839.00",00.00,"1,392,941.20",FEaFEfC0Fab0825,9778,Preston,Forbes,Cherry LLC,East Vickie,Grenada,293-049-6130x9998,+1-877-997-5760x038,rfrench@weeks-sherman.com,2022-03-14,https://yang-guzman.com/
26-Aug-2021,Cheque,05.10,00.00,"1,392,946.30",72bAfd3bacbd3Da,8919,Debbie,Hurley,Bowman PLC,Joneshaven,Myanmar,(131)846-4194,275.865.9682,lebob@fleming.com,2020-08-26,http://www.norton-acevedo.net/
26-Aug-2021,Miscellaneous,288.00,00.00,"1,393,234.30",CFefa76aB91EaD6,1621,David,Figueroa,Coleman Ltd,New Vicki,Norfolk Island,128.691.1808x0491,+1-251-523-4339x2439,maxwell03@whitaker-shaffer.com,2022-02-19,http://www.green.com/
26-Aug-2021,IMPS,194.00,00.00,"1,393,428.30",c1507112b25cEc2,6287,Andre,Patrick,Bullock LLC,New Dianeville,Myanmar,(632)073-9601x757,316-199-1863,sergio85@webster.com,2022-03-05,http://rodgers.com/
26-Aug-2021,Transfer,"23,008.00",00.00,"1,416,436.30",Cc69A154c8EDAa3,5247,Regina,Richmond,Frazier-Peters,Averyville,Dominica,+1-653-583-4993x0746,667.682.3769x671,harpermarvin@browning.com,2020-03-30,https://boyle-sanders.com/
26-Aug-2021,Cheque,"1,475,609.00",00.00,"2,892,045.30",C17E6eD3beCFb7B,9623,Grant,Vazquez,"Parker, Curtis and Dean",North Jermaineburgh,Congo,3417293827,001-162-494-1579x125,fred86@dickson.com,2021-04-02,http://adkins-kennedy.biz/
26-Aug-2021,Transfer,308.90,00.00,"2,892,354.20",290BcDc2eE7fFCB,1527,Renee,Savage,"Miles, Thornton and Acevedo",East Margaret,Cuba,(913)010-2190x0091,(217)453-1175x7948,hermanmolly@brown.com,2020-02-06,http://ortega.org/
26-Aug-2021,Purchase,"213,449.30",00.00,"3,105,803.50",5Ef3A983bDdBBEB,9853,Aimee,Barnett,Berry-Huff,South Bonnie,Malta,1771102499,522.377.7061,franciskristi@walsh-shaw.org,2022-02-22,https://parsons.com/
26-Aug-2021,Bill,60.82,00.00,"3,105,864.32",f6077990DDBC0Fe,7403,Max,Martin,"Nunez, Phelps and Gross",East Latoya,Iraq,+1-240-523-8852x504,772-693-6499,tiffanyfrey@pierce.biz,2020-01-05,https://taylor.org/
26-Aug-2021,Commission,10.56,00.00,"3,105,874.88",Aa45dE7769DfEa6,1836,Aaron,Horn,Callahan Inc,Sydneyport,Timor-Leste,(846)730-1820,(446)611-2429,ckemp@travis.info,2022-01-06,http://khan-arias.info/
26-Aug-2021,Commission,00.00,"517,645.81","2,588,229.07",AFCF9ffB711C3a2,8602,Sheri,Ponce,Rangel LLC,Kristinbury,Mozambique,972.567.3853x64005,(042)504-6336,candicecase@luna-caldwell.com,2021-06-27,https://fletcher.com/
26-Aug-2021,Reversal,"2,064.00",00.00,"2,590,293.07",A5f31BFf9AaF3ED,5920,Jesus,Valenzuela,Mclaughlin-Copeland,New Pamela,Luxembourg,005-311-4973x26930,238-283-7720,dillon76@vance-gonzalez.com,2020-04-23,http://www.jarvis.com/
26-Aug-2021,NEFT,"121,222.66",00.00,"2,711,515.73",13fc1339AB7BA79,3616,Francis,Montoya,"Pollard, Decker and Young",New Kerri,Saudi Arabia,8324909128,796-533-2047x7347,vbuck@guerrero.com,2022-01-05,http://rocha.net/
26-Aug-2021,Cash,00.00,"1,355,757.87","1,355,757.86",eCEEDF8c49bac82,8676,Julie,Neal,Andrews-Kidd,Simmonsport,Belize,541-899-8390x29996,7822165687,mortonkristie@snow-kirk.com,2021-03-31,http://bass-beard.net/
26-Aug-2021,Reversal,32.30,00.00,"1,355,790.16",0b840987F99B954,8394,Diamond,Salas,Martinez Group,West Vanessa,Paraguay,345.624.0903x801,+1-719-260-1582x08621,sarah48@brock.com,2021-11-22,http://patrick.org/
26-Aug-2021,RTGS,41.00,00.00,"1,355,831.16",ee2BD270eBf2F75,8189,Sally,Mann,"Riddle, Huber and Schmitt",Antoniomouth,Egypt,6031834584,713-547-8396,franciscofields@carr-wyatt.org,2020-11-23,http://www.christian.com/
26-Aug-2021,Interest,00.00,"150,647.91","1,205,183.25",5bA6D911cAfE8ae,8764,Loretta,Sullivan,"Collier, Kidd and Singleton",Gabrielberg,French Polynesia,+1-894-764-9275x0638,068.059.3739,kbarrett@calderon-lynch.info,2021-04-25,http://www.wu.com/
26-Aug-2021,IMPS,00.00,"301,295.81","903,887.44",41e6283b4456f0E,9772,Alicia,Whitney,"Mcclain, Villanueva and Mcgrath",Port Mandy,Ethiopia,665.776.9309,6470630722,eduardo87@galloway.com,2021-04-13,http://lloyd.info/
26-Aug-2021,Purchase,00.00,"90,388.74","813,498.70",5B8Ffc59EeBd87D,9994,Bernard,Wolf,Huynh-Best,Port Barryborough,Bhutan,977.287.5016x4827,337-342-2622x707,rmorse@lane.com,2021-04-29,http://www.sweeney.com/
26-Aug-2021,IMPS,00.00,"116,214.10","697,284.60",B77Fde32070A50A,8561,Frederick,Chandler,Cochran-Mercado,Ortizton,Gambia,(708)995-4120x952,001-691-103-6146x3894,joann13@mathis.com,2021-10-23,https://flowers-serrano.com/
26-Aug-2021,Bill,"1,612,507.20",00.00,"2,309,791.80",DD0caa06ebf217c,9996,Meghan,Cline,Richardson LLC,Petersport,Cote d'Ivoire,001-270-136-4738x419,001-349-692-1755x055,nicolasandrade@bates.info,2022-04-27,http://thomas-ramos.com/
27-Aug-2021,Commission,00.00,"1,154,895.90","1,154,895.90",3Bc7c07439054AC,5849,Randall,Simon,Jennings Group,Paulton,Papua New Guinea,(180)818-9854x65763,425.859.0592x6023,mccallclaire@howard.biz,2021-09-03,http://www.vasquez-hall.com/
27-Aug-2021,Reversal,00.00,"577,447.95","577,447.95",d1dbAE8d0e9FbA0,6308,Jody,Hodges,Vance-Hart,Harryville,Gambia,8048211608,(566)628-8053x97612,lutzbrandi@mcpherson.com,2020-10-29,https://lindsey.net/
27-Aug-2021,Debit Card,00.00,"96,241.33","481,206.62",0aAAF98fCe94C84,2964,Yvonne,Merritt,Coffey PLC,North Julian,Cyprus,001-305-007-5864x9495,205-532-4745,tammystevenson@mcgee-hoffman.org,2021-07-03,http://www.davis.com/
27-Aug-2021,Interest,32.24,00.00,"481,238.86",cDBacB5be591eCa,2515,Kara,Jarvis,"Rollins, English and Dean",Carlhaven,Ethiopia,(769)516-1091x06408,(645)137-9673x9175,sheriprice@tapia.com,2021-04-23,https://carter.com/
27-Aug-2021,Transfer,00.00,"60,154.86","421,084.00",7d242beed810a1c,7855,Darryl,Werner,Ayala-Delgado,Marshallstad,Isle of Man,690-783-1453x132,797-543-9493,charlesblevins@newton-perry.com,2020-05-13,https://www.case.org/
27-Aug-2021,Cheque,05.82,00.00,"421,089.82",11d2AfE7dfc9D0d,4348,Anita,Howe,Key-Howard,Port Sarah,Puerto Rico,820-002-2359x068,001-064-691-6262,philipknight@grant.com,2020-01-03,https://www.bishop.com/
27-Aug-2021,IMPS,"2,912.00",00.00,"424,001.82",fdf04eb1b5E9Cdd,9723,Grant,Barker,Church PLC,Omartown,Ghana,2395193177,001-723-800-3778x9234,kristydelacruz@mcdonald-landry.com,2020-10-07,http://richards-chapman.net/
27-Aug-2021,Commission,"803,841.00",00.00,"1,227,842.82",B47fFCC5Ab3Af5a,4733,Hector,Benton,Harding Inc,Port Cheryl,Burkina Faso,+1-392-192-3013x3379,+1-449-598-4729x14208,sharon69@reese.com,2021-08-15,http://mckenzie.com/
27-Aug-2021,Cheque,00.00,"1,227,842.82",00.00,CfbFcfa71D6aEfa,5117,Michaela,Archer,Lewis-Gamble,Colleenside,Falkland Islands (Malvinas),(694)317-7514x325,+1-985-424-0369x781,braunmelissa@chapman-townsend.biz,2020-08-29,http://www.chang.com/
27-Aug-2021,Tax,59.17,00.00,59.17,dAe274Cf1298F71,4389,Sandy,Vazquez,"Espinoza, Moreno and Hensley",Traceyfort,Holy See (Vatican City State),001-619-199-1457,131-812-2942,yesenia80@combs-joseph.biz,2020-12-19,http://www.leonard.net/
27-Aug-2021,Commission,66.00,00.00,125.17,e5f16d8A2AA0B5b,2704,Louis,Powell,"Hunter, Potter and Rodriguez",Ferrellshire,Bolivia,+1-930-118-6965x06080,419.703.3124x64785,kylienichols@gibbs-duran.net,2020-08-06,http://www.pollard.com/
27-Aug-2021,Miscellaneous,00.00,31.29,93.88,BAA4B9B03b4fBec,5955,Robert,Glenn,Molina-Munoz,Helenland,United States Virgin Islands,(716)435-1599,599.192.4682x99017,breannachan@hays-chaney.org,2020-03-09,http://bradshaw.org/
27-Aug-2021,Debit Card,"969,030.00",00.00,"969,123.88",77CFE746376c133,5038,Ebony,Hendrix,Rich Group,Port Chelsey,United States Virgin Islands,632-567-6839x8265,462-577-1832x8794,juan08@kennedy-steele.com,2021-01-08,http://madden-grimes.com/
27-Aug-2021,Bill,00.00,"969,123.88",00.00,7EF2D48BB07438C,5658,Benjamin,Cortez,"Yu, Hodges and Vaughn",North Victor,Antarctica (the territory South of 60 deg S),232.585.0830x497,+1-290-297-6278x6425,shaun72@daniel-bowman.com,2020-02-11,https://keith.com/
27-Aug-2021,Bill,00.00,00.00,00.00,7CB6Cbef2B741bD,7746,Mikayla,Walls,Everett-Jennings,Nicoleside,Cameroon,848.164.0265,+1-121-219-4274x1206,bellarthur@hamilton.info,2021-10-30,http://www.stephenson.com/
27-Aug-2021,Transfer,"1,300.00",00.00,"1,300.00",A3aD83Bd350cCEE,8094,Leslie,Woodard,"Archer, Woodward and Campbell",Lake Peter,French Southern Territories,7615170620,543.461.3354x30936,mroth@travis.info,2020-03-10,https://khan.com/
27-Aug-2021,IMPS,00.00,325.00,975.00,0F0f20CF7DF6c11,5961,Terrance,Hutchinson,"Arnold, Odonnell and Miranda",West Stuartmouth,Nigeria,972.277.0999,3164582252,priscillazavala@gallagher.biz,2021-07-12,https://www.gallegos.com/
27-Aug-2021,ATM,00.00,325.00,650.00,Dd3e8A60Fd757Df,5146,Cesar,Gomez,"Pitts, Martinez and Barr",Cuevasville,Afghanistan,335-832-7844x91725,0606321132,gbenton@goodwin.com,2021-04-23,https://kelley.com/
27-Aug-2021,Miscellaneous,128.00,00.00,778.00,ECD05B505Ba76ec,1079,Renee,Lang,Daniel Inc,East Steven,Philippines,+1-515-849-4431,195.887.3616x453,clogan@estes.com,2020-09-18,http://www.mclaughlin.biz/
27-Aug-2021,Debit Card,480.00,00.00,"1,258.00",DEEf3D49A8E6F7F,4157,Ana,Pineda,"Haney, Mack and Campbell",Onealville,Cote d'Ivoire,689-804-8098,+1-972-642-1247,robertnguyen@christensen.org,2020-02-24,http://vargas-thornton.com/
27-Aug-2021,Bill,"17,072.90",00.00,"18,330.90",69Fc5Cc077bB27b,8658,Joseph,Baird,"Lutz, Butler and Sexton",New Johnny,Djibouti,(007)415-7670,001-442-775-9193,ncooper@cunningham.com,2021-09-28,http://pollard.com/
27-Aug-2021,Commission,"1,888.80",00.00,"20,219.70",aB61e30bBB4Ae9c,4675,Christian,Sutton,Savage-Waters,Campbellfort,Somalia,+1-657-786-9541x4533,+1-582-545-1632x1070,bridgetkline@galvan-crawford.com,2020-03-20,https://gomez.com/
27-Aug-2021,ATM,00.00,"2,021.97","18,197.73",Aa467C093831CA9,9258,Caleb,Daniels,Frazier Group,Bradymouth,Dominican Republic,(835)333-0959,490-260-3299,asteele@conner.com,2020-05-02,https://www.montoya-lambert.org/
27-Aug-2021,Cash,53.00,00.00,"18,250.73",adbCFFfBF1eABF0,1988,Wesley,Keith,"Vang, Shaffer and Gilmore",Suemouth,Ghana,+1-687-922-6577,(676)161-8782,kdominguez@moore.info,2021-02-14,https://case.info/
27-Aug-2021,Miscellaneous,"1,660,455.00",00.00,"1,678,705.73",379dE6F9a6BBa9e,4435,Harold,Greer,Robertson and Sons,Erikborough,Seychelles,001-301-0925x28554,818-698-9893,belindamoses@rubio.info,2020-02-19,http://www.welch.com/
27-Aug-2021,RTGS,00.00,"279,784.29","1,398,921.44",AFfcf8CFA19F5CA,7135,Mackenzie,Summers,Wilkins LLC,Walterfurt,Finland,+1-785-182-3455,(050)868-4564,selenashields@hopkins-proctor.com,2020-08-26,http://www.perkins-reeves.net/
27-Aug-2021,Debit Card,00.00,"1,398,921.44",00.00,f612fDc204BDfdd,3229,Raven,Hughes,Liu-Perez,Curryburgh,Finland,001-865-313-3310x498,174.140.7461x521,tanya20@jacobs.org,2021-11-17,https://www.drake.net/
27-Aug-2021,ATM,"60,826.03",00.00,"60,826.03",2406FCF72298AbD,3114,Felicia,Powell,Little PLC,Grimeschester,Montserrat,+1-676-565-6158x4320,593.697.3612x370,williamolson@lawson.biz,2022-03-17,https://crawford.com/
27-Aug-2021,IMPS,00.00,"15,206.51","45,619.52",B8e3201eADEA40d,4356,Tanner,Vang,Patterson Group,Thomastown,Bulgaria,001-431-103-3813,+1-500-826-4721x625,alishadickson@shaw.com,2022-02-10,https://www.meadows-santos.com/
27-Aug-2021,NEFT,288.16,00.00,"45,907.68",6b62f128fECfdFC,2048,Gregory,Greer,"Stanton, Foley and Freeman",North Tracey,Kuwait,001-508-010-4129x85155,857.070.1813,norriscolleen@jensen.biz,2022-01-14,http://wilkerson-hess.com/
27-Aug-2021,RTGS,00.00,"11,476.92","34,430.76",D3Ad7c5856dbEfd,5919,Rhonda,Lutz,Arnold PLC,East Erik,Uganda,(050)579-3402,800.156.9570,christensenmackenzie@gay-zhang.com,2022-04-18,http://hebert-mercer.info/
27-Aug-2021,Interest,225.90,00.00,"34,656.66",afcACDAae7ae7cC,6951,Bob,Bonilla,Sawyer-Acevedo,North Terrance,Barbados,+1-954-175-5823x340,(987)517-1030,opalmer@cooke.net,2020-11-14,http://www.ray-cochran.com/
27-Aug-2021,Purchase,00.00,"6,931.33","27,725.33",b9072cb30eCd8F4,4565,Ryan,Carter,"Marsh, Phelps and Landry",Hudsontown,Georgia,406-002-1444,904-259-6390x5643,tonifrey@moses-price.com,2020-08-23,http://williams.net/
27-Aug-2021,Miscellaneous,03.31,00.00,"27,728.64",0FC6E0b89B147CD,4704,Lee,Blake,Melendez-Wang,Marvinfurt,Belarus,544-874-1893x6310,7847573968,sherri05@leonard.org,2020-09-21,http://www.fernandez-buck.net/
27-Aug-2021,IMPS,06.20,00.00,"27,734.84",a0df65cFec6dDC0,8506,Dylan,Crawford,Hancock-Mooney,Port Kimberlyland,Reunion,184-460-7393,001-384-200-4601x2611,rodneyclayton@zhang-lin.com,2020-07-17,http://www.dean-mays.com/
27-Aug-2021,Cash,"11,290.80",00.00,"39,025.64",ff28b6945C09a02,7660,Carol,Owens,"Hardy, Greene and Sloan",South Peggychester,Pakistan,001-960-645-1285x98644,+1-748-098-9268,makayla68@murillo.com,2020-05-10,http://schroeder-collins.com/
27-Aug-2021,RTGS,46.00,00.00,"39,071.64",e99C712DCAeD0D3,3672,Erica,Bates,Lamb-Weiss,Savannahtown,Indonesia,250.123.3787,837-071-6153x80676,alvin46@humphrey-adams.com,2020-10-09,http://burch-tapia.com/
27-Aug-2021,Debit Card,22.00,00.00,"39,093.64",E9C8790fD0dD6DC,6193,Tristan,Mccoy,Silva-Barnes,Franklinville,Portugal,001-021-023-7986,381-553-4337,wgreer@mckenzie.info,2021-05-17,https://www.murphy.com/
27-Aug-2021,Reversal,00.00,"19,546.82","19,546.82",01F682209D1F28d,2013,Evelyn,Khan,Grimes-Reese,West Monicafurt,Algeria,(531)374-1346x935,520-585-1658,floreszachary@salas.info,2020-08-05,https://www.schroeder-alvarado.net/
27-Aug-2021,Tax,"237,107.20",00.00,"256,654.02",b2963C78A280FA1,5874,Bob,Rojas,Simon LLC,South Rickeyfurt,Kiribati,+1-710-208-4619x8422,(477)174-4360,obarron@hays.com,2020-03-05,https://franco.com/
27-Aug-2021,Miscellaneous,00.00,"36,664.86","219,989.16",da83EB51FaCBC8B,6506,Sheryl,Christensen,"Ayers, Zuniga and Lee",Rowlandside,French Polynesia,860.813.2730x9964,022.001.0617x272,nicholasbradley@lutz-roman.net,2021-05-18,http://costa.com/
27-Aug-2021,ATM,00.00,"54,997.29","164,991.87",E3D5B6ee13A76eE,2255,Mitchell,Duarte,"Mcfarland, Boyle and Bender",Rickberg,Nepal,478.634.2906x2672,127-991-5720,kaylee69@george-gilmore.com,2020-11-30,https://gould-diaz.biz/
27-Aug-2021,Tax,00.00,"82,495.94","82,495.94",2f9991CfE9c2Ff2,6873,Holly,Finley,Ellison-Hutchinson,Joanneport,Bhutan,+1-582-086-3133x755,(852)329-8904x65732,wrowland@leon.biz,2021-04-28,https://www.hester-ellison.org/
27-Aug-2021,Debit Card,00.00,"11,785.13","70,710.81",C795d33EFa0E2F1,376,Caitlin,Hendrix,"Valentine, Hinton and Schwartz",New Edwardberg,Poland,936.599.8937x35672,019.248.1683x1364,barrybecker@bauer.com,2020-10-19,http://www.tran-dawson.net/
27-Aug-2021,Tax,"112,516.00",00.00,"183,226.81",d8cCD02E409D5F2,66,Gene,Wu,"Chambers, Nielsen and David",Noblefort,Bulgaria,+1-956-239-0423x80834,001-414-382-8351,nataliefarley@richardson.com,2021-10-05,http://carrillo.com/
27-Aug-2021,Bill,00.00,"18,322.68","164,904.13",2A319D00aa0AAfd,4878,Dean,Houston,Floyd-Norton,East Alejandraborough,Hungary,(861)123-9006x3852,+1-192-586-6661x142,fwise@herman-lutz.com,2021-01-16,https://johnson.biz/
27-Aug-2021,NEFT,00.00,"27,484.02","137,420.11",eF28AcC4D6d40C2,9724,Victor,Rasmussen,"Cortez, Shepherd and Love",Chloefort,Cote d'Ivoire,129.629.4288x1670,+1-541-855-4042,melaniesanchez@walton.com,2021-07-23,http://www.parsons-pratt.com/
27-Aug-2021,Cash,120.00,00.00,"137,540.11",0c7cE200C288D83,2174,Sarah,Combs,Mills-Davila,North Teresaburgh,Hungary,309-811-9174x03152,(005)640-0371,riverscarmen@wyatt.com,2020-01-27,http://foley.com/
27-Aug-2021,NEFT,00.00,"13,754.01","123,786.10",6E8BC71Da4a716b,710,Darrell,Mcneil,Hubbard LLC,North Garrett,Iran,820-265-6563x42062,001-460-889-5334x59702,yangrebekah@obrien.info,2020-08-31,http://mitchell.net/
27-Aug-2021,ATM,"1,297.00",00.00,"125,083.10",aeFbeDF92fdbFd3,9027,Thomas,Schneider,"Massey, Warner and Knapp",Port Bradleyfort,Norway,768-743-4708,0490679065,cunninghamkyle@rocha.info,2020-05-04,http://www.peters.com/
28-Aug-2021,Bill,00.00,"12,508.31","112,574.79",90D853A55e68d3e,5702,Regina,Wheeler,"Sims, Hardy and Esparza",Clairehaven,Guinea-Bissau,2979664806,559.551.0348x515,isaacmercer@kelley.com,2021-10-19,http://www.douglas.com/
28-Aug-2021,Debit Card,00.00,"12,508.31","100,066.48",6FE085Fa4358e72,8438,Michael,Hodges,Fuentes PLC,Marissaland,Ireland,687-929-6903,284.586.3693x000,avilachris@blanchard-parrish.com,2021-02-12,https://www.mcclain.net/
28-Aug-2021,RTGS,"2,876.50",00.00,"102,942.98",f2E28322dFaBaA3,8501,Carlos,Heath,Leblanc-Sloan,Port Andre,Cape Verde,893.570.9880x57114,(398)638-3365,iarnold@mcconnell.com,2021-10-14,https://hickman.org/
28-Aug-2021,Debit Card,"1,987,743.80",00.00,"2,090,686.78",96b9f9af21eBC93,9211,Juan,Kelly,"Roberson, Hartman and Graham",Port Evelynshire,Mauritania,+1-899-632-7517x4940,001-793-819-0908,ghogan@browning-stephenson.biz,2021-06-20,https://www.cantrell.biz/
28-Aug-2021,Bill,00.00,"2,090,686.78",00.00,52860F8FF6EDC10,6482,Gregg,Fleming,"Mcneil, Page and Huber",East Sarahmouth,Burundi,(167)325-4980,6401499215,breannasaunders@hull.biz,2020-04-12,http://bridges.com/
28-Aug-2021,Debit Card,"2,835.70",00.00,"2,835.70",0Df13a2dCeCF9CF,8411,Kristopher,Mcgee,"Green, Cardenas and Mayo",Moraburgh,Sao Tome and Principe,(551)640-3344,7312767380,stefaniegray@cowan.biz,2020-12-20,http://valentine.com/
28-Aug-2021,Reversal,00.00,"2,835.70",00.00,290BcDc2eE7fFCB,1527,Renee,Savage,"Miles, Thornton and Acevedo",East Margaret,Cuba,(913)010-2190x0091,(217)453-1175x7948,hermanmolly@brown.com,2020-02-06,http://ortega.org/
28-Aug-2021,Cheque,"66,042.00",00.00,"66,042.00",0aad7ED3Fe3DaF1,3801,Lynn,Trujillo,"Booth, Velez and Gibbs",Fisherland,Malta,+1-937-120-4252x567,8791410284,ldunlap@carlson.com,2020-08-16,https://www.bell-warner.com/
28-Aug-2021,Commission,"1,433.91",00.00,"67,475.91",803e5ed400fF3AF,1623,Bobby,Cervantes,Hicks-Hoover,East Levi,South Georgia and the South Sandwich Islands,001-432-239-2866x38094,8505627187,gabriela69@thomas.com,2020-08-09,https://www.rios-morgan.com/
28-Aug-2021,Cash,"184,941.00",00.00,"252,416.91",d0B5aadc6E28c77,611,Veronica,Conley,"Jackson, Davis and Potts",New Gabrielleshire,Timor-Leste,(802)825-7221x09743,+1-604-175-6309x062,douglas36@white-oconnor.com,2020-10-12,http://conrad-branch.com/
28-Aug-2021,Transfer,00.00,"25,241.69","227,175.22",cC0cBBa88DEe269,8931,Grant,Frost,"Rodgers, Washington and Key",Joanmouth,United Kingdom,351-660-8868x687,001-704-828-7421,clementsleon@sexton.com,2020-01-28,https://www.boyle-barnett.biz/
28-Aug-2021,Bill,00.00,"22,717.52","204,457.70",9B6d4BCbF8B43E2,6052,Terrance,Cline,Williams Inc,Nataliebury,Gambia,522.205.4731,+1-276-416-1838x655,eaustin@mullins.biz,2021-06-17,https://duncan.com/
28-Aug-2021,IMPS,27.34,00.00,"204,485.04",F05C7931b54d6E9,7975,Kristie,Holder,"Becker, Mendez and Hudson",North Danatown,Solomon Islands,001-066-251-0277x2791,(202)326-0805x47762,lucasmelendez@daniels.net,2022-01-31,http://boyd.biz/
28-Aug-2021,Bill,"3,237.00",00.00,"207,722.04",5AcfF0eb57d778d,3769,Caroline,Carlson,Moreno-Hancock,South Brandyland,Guinea,171.168.9151,(080)483-8998,alexa22@stark.org,2020-10-16,https://www.wolf.com/
28-Aug-2021,IMPS,00.00,"103,861.02","103,861.02",8D0bCEDAA2b6E32,7260,Penny,Farrell,Juarez-Levine,Daltonport,Cameroon,490-388-8228x3811,4298155748,saustin@buck-jefferson.biz,2020-08-04,https://cannon.com/
28-Aug-2021,Debit Card,00.00,"17,310.17","86,550.85",7C08F48aaEf7Ac4,8566,Katrina,Benjamin,Holden Ltd,Lake Jackson,Heard Island and McDonald Islands,001-923-084-6290x5195,023-976-4720,tchambers@garcia.biz,2022-05-23,http://chung-wade.com/
28-Aug-2021,Debit Card,"21,548.60",00.00,"108,099.45",c2B4aCe2a0b2F3C,5582,Joy,Levine,Washington Inc,Oliverbury,Puerto Rico,805-359-1808,001-054-788-3116x5619,richsamantha@adkins.com,2020-09-23,https://www.page.com/
28-Aug-2021,Transfer,29.00,00.00,"108,128.45",24C00CDEB96dc3E,2801,Cassandra,Odom,"Butler, Kim and Morrow",South Blakefurt,Albania,(716)565-6625,(289)641-6875x05319,lorraine83@molina.net,2021-08-21,http://www.mosley.com/
28-Aug-2021,Cash,00.00,"12,014.27","96,114.18",fe58c05B5AE1c72,2466,Mary,Francis,"Carter, Whitney and Summers",Davetown,Poland,372.266.4657x7993,+1-271-464-4234,iyates@frederick.org,2021-01-08,https://www.odom.com/
28-Aug-2021,Transfer,"232,869.47",00.00,"328,983.65",4dde8bc4BF7f0d0,8381,Angie,Oliver,Morrison-Mcdowell,Webbton,France,001-837-155-6953x8908,608.003.3191x5940,fgarner@acevedo-hines.com,2020-06-01,http://www.knight.com/
29-Aug-2021,Reversal,05.00,00.00,"328,988.65",aB2AbD6FB3E8A68,5228,Stefanie,Cisneros,Branch-Reid,New Catherine,Solomon Islands,001-023-249-6424x271,134-915-5394,gail17@davies.net,2020-03-20,http://www.carpenter.info/
29-Aug-2021,RTGS,148.45,00.00,"329,137.10",af7F8FFfC17014E,1511,Grace,Thompson,Barajas-Houston,New Adrian,Taiwan,626-451-6922,(590)461-8969x099,salinasolivia@kane-hubbard.com,2021-07-23,http://arnold.info/
29-Aug-2021,Purchase,00.00,"82,284.28","246,852.82",B6Ef430Fdd87Cb4,7823,Mercedes,Thompson,Underwood-Gaines,Derekchester,Dominica,(235)129-6652,2938767088,ymelendez@mcgee.biz,2021-02-07,http://www.kelley.info/
29-Aug-2021,Cheque,364.00,00.00,"247,216.82",Ef03b9DcbFbe3Cd,1841,Yvette,Phillips,Dickerson and Sons,New Caitlinburgh,Montenegro,001-828-468-3820x51710,7632323716,tballard@carey.com,2020-03-22,http://carter.com/
29-Aug-2021,Commission,"2,008.00",00.00,"249,224.82",8B8d0C970ef087e,659,Carol,Neal,"Daniels, Mcdonald and Zhang",New Shelly,British Virgin Islands,220.236.4003x99597,597-261-4214x784,rickygamble@may.com,2021-07-22,https://www.pacheco.net/
29-Aug-2021,RTGS,04.00,00.00,"249,228.82",E6d4b802f69cBE7,4585,Todd,Huff,Harding-Garner,Batesstad,Brunei Darussalam,+1-118-741-3029x2047,001-459-484-5733,rbates@brock.org,2022-01-15,http://goodwin-arias.org/
29-Aug-2021,ATM,00.00,"83,076.27","166,152.55",64d1148118e9e08,4738,Reginald,Holder,"Sims, Mooney and Hampton",Nunezburgh,Somalia,410.676.0341x25813,+1-513-175-0832x485,slin@bartlett-anthony.com,2021-09-15,http://www.jones.org/
29-Aug-2021,Purchase,46.60,00.00,"166,199.15",8F37E9Cb539Ab37,4624,Sandra,Herman,"Hughes, Bullock and Mayo",Lake Cole,Denmark,001-228-563-0044x89663,153.691.9404x0311,graypam@pruitt-benjamin.com,2021-06-18,http://www.torres.biz/
29-Aug-2021,Cheque,"3,303.70",00.00,"169,502.85",a3AC64E3e9D9DfF,4948,Frederick,Marks,"Shields, Garcia and Browning",Pennyburgh,Trinidad and Tobago,(283)555-5229,9348738998,ubanks@black.com,2020-11-16,http://www.flowers-sutton.com/
29-Aug-2021,Miscellaneous,"53,210.90",00.00,"222,713.75",dFEe227EEB6Db9b,4758,Johnathan,Alvarado,Rasmussen-Campos,South Kiara,Libyan Arab Jamahiriya,(916)216-1638,+1-885-803-6119x8162,toddsydney@yoder.info,2021-12-12,https://www.mullins.com/
29-Aug-2021,Tax,00.00,"74,237.92","148,475.83",A4Ef3Aa048c01Ba,2920,Helen,Mercer,Gaines Inc,Mcclurebury,Peru,605-520-0709x3077,259-534-8034x865,kellerkevin@hancock.biz,2021-02-25,http://bowman.biz/
29-Aug-2021,Commission,"2,596.00",00.00,"151,071.83",aF79d768eecCDeF,9799,Beth,Chandler,"Lin, Jefferson and Cunningham",East Evanmouth,United Kingdom,(826)644-4597x3318,(300)646-7455x598,gcarr@blanchard.org,2021-10-21,http://huynh.biz/
29-Aug-2021,NEFT,00.00,"18,883.98","132,187.85",bd2FCeDCa54DA5a,5819,Geoffrey,Logan,Poole-Bowen,East Betty,Fiji,+1-362-389-3511,001-836-852-1579x270,kathleenjames@wilson.org,2021-07-10,https://www.rivera-maynard.com/
29-Aug-2021,RTGS,"11,386.00",00.00,"143,573.85",27D970AE9DeaFCd,1786,Eileen,Knight,Jackson Ltd,Valerieport,India,2676815326,126-758-7046x060,woodsshawna@alvarado.net,2020-10-14,https://dillon.com/
29-Aug-2021,Debit Card,00.00,"28,714.77","114,859.08",b6A81E7b5e1c90c,3504,Christie,Logan,Marsh Ltd,Lake Catherinehaven,Congo,935.974.6105x772,638.692.4489,nathan96@ortiz-hendricks.com,2020-11-25,https://www.brewer.com/
29-Aug-2021,Tax,"3,080.00",00.00,"117,939.08",FE7E7fDb64CFb85,6045,Gregg,Turner,"Oconnell, Ingram and Higgins",New William,Aruba,001-650-863-6115x22914,263-932-9436,rpeck@mccormick.com,2021-08-25,http://www.nixon-hodges.com/
29-Aug-2021,Miscellaneous,00.00,"19,656.51","98,282.57",20284c34EcbE37D,1897,Gregg,Shaffer,"Roberson, Mcclain and Bradshaw",West Kelly,Poland,229.729.0761x958,6189627017,travisstacy@orozco.com,2022-03-19,https://olson-gray.org/
29-Aug-2021,NEFT,00.00,"12,285.32","85,997.25",21F4586e5aEBA7E,709,Jasmine,Lutz,Boyd Group,Huberville,Haiti,+1-124-988-9229x4595,(163)520-0326,kevin30@ferguson.com,2022-04-15,https://www.archer-fuller.com/
29-Aug-2021,Miscellaneous,00.00,"10,749.66","75,247.59",08B2937A4d50FEd,1948,Melanie,Mcneil,Burch-Dodson,West Mercedes,Poland,712.040.5163x85264,(481)826-0039x71519,nbarber@kerr.net,2021-08-30,http://boyer.com/
29-Aug-2021,Cash,00.00,"18,811.90","56,435.69",B4d02ec0f67FdDd,4008,Isabel,Spence,Melendez-Hobbs,West Nicholas,Thailand,(940)558-2369x91831,872.351.2292x05858,drichardson@thompson.net,2021-01-10,https://gill-stout.com/
29-Aug-2021,Debit Card,00.00,"11,287.14","45,148.55",3f8f26799a8aA42,8543,Cassidy,Bush,Pittman LLC,Tylerland,Korea,9523568511,001-291-424-6590x7698,wooddarlene@stout.com,2020-07-03,http://www.turner.net/
29-Aug-2021,Transfer,00.00,"45,148.55",00.00,aBb40F04d1F5A0A,3903,Tyler,Dyer,Galvan Group,Moranview,Iraq,349.660.5542,001-369-699-8295x24013,jon39@merritt-deleon.net,2022-05-07,http://www.dalton.com/
29-Aug-2021,ATM,"1,633,122.00",00.00,"1,633,122.00",a9D37eB293B7fBC,6079,Ann,Mora,"Reeves, Duffy and Santiago",South Jaredtown,Micronesia,684.461.8519,954.008.2684x4434,kaitlinestes@rhodes-shaffer.net,2020-07-25,http://www.peck.org/
29-Aug-2021,IMPS,51.79,00.00,"1,633,173.79",32034fDa1b49F43,4542,Patricia,Sweeney,Stout-Townsend,Lake Daltonview,Benin,028.910.3308x8733,209.828.8296,miguel40@leon.com,2020-05-11,https://www.riley-church.biz/
29-Aug-2021,Interest,04.40,00.00,"1,633,178.19",5bbB2caA615b33c,2250,Earl,Oconnor,Krueger and Sons,Port Donald,Iraq,001-048-723-5763x010,(676)301-3438x84807,arielschroeder@heath.com,2021-11-29,https://pennington-miller.com/
29-Aug-2021,Transfer,36.00,00.00,"1,633,214.19",e144acaeAC1CAac,5515,Kathy,Brewer,Hughes-Riley,New Tara,Uganda,001-558-882-8195x4006,164-433-1760,mpowell@moreno-villa.com,2020-06-21,http://bradley.com/
29-Aug-2021,Transfer,54.80,00.00,"1,633,268.99",638cd6ffAA83Afc,1473,Ronald,Barrett,"Richard, Galvan and Ballard",Ritaland,Sao Tome and Principe,001-450-180-3290x8634,580.773.7190,tannerweber@proctor-adams.biz,2020-05-15,http://robertson.com/
29-Aug-2021,IMPS,15.00,00.00,"1,633,283.99",074A2bEbfcA81F7,3961,Logan,Gross,Bautista-Avila,Danielstad,Belarus,(779)157-4807x6133,001-083-032-4921,willie03@brandt-kline.com,2020-02-28,http://www.arias-pruitt.com/
29-Aug-2021,IMPS,00.00,"163,328.40","1,469,955.59",a5c987D279DefEe,4297,Misty,Calhoun,Bauer-Jones,Lake Genemouth,Saint Helena,(939)577-8179x1544,001-478-853-3627x1759,corozco@davenport.biz,2020-07-10,https://www.williams.com/
29-Aug-2021,ATM,00.00,"244,992.60","1,224,962.99",F47934cb9b80133,7564,Kyle,Mills,Elliott-Becker,Port Frances,Saudi Arabia,001-831-990-2887x7156,278.878.4154x6222,stephaniebarker@franklin-horne.com,2022-05-24,http://vance.org/
29-Aug-2021,Purchase,00.00,"122,496.30","1,102,466.69",f150abFaf6Ba34C,2668,Christie,Davenport,Cummings PLC,Rollinsburgh,Heard Island and McDonald Islands,001-277-499-4246x60739,+1-125-811-3763,juarezmaria@cross.org,2021-10-17,http://www.flynn-ellis.com/
29-Aug-2021,Cash,68.00,00.00,"1,102,534.69",88A2e7C1918B4e9,8149,Daniel,Frye,Carson-Weber,Sethhaven,Antigua and Barbuda,(378)185-0220x6923,001-794-708-2224,jeremiah69@murphy.info,2022-04-04,http://salinas.info/
29-Aug-2021,Debit Card,00.00,"137,816.84","964,717.85",A1b76D766d08e97,7223,Heidi,Harper,Underwood LLC,Isabellaville,Trinidad and Tobago,+1-189-516-1899x90474,885.089.6948,rferguson@benton-christensen.com,2021-12-22,https://ray.net/
29-Aug-2021,Cheque,00.00,"321,572.62","643,145.23",e3e9DDFdD8eCEF9,9185,Sandy,Robinson,Edwards-Villegas,West Feliciachester,Macedonia,+1-889-902-6495x56455,552-759-8897,evelynalexander@edwards.com,2020-11-05,https://shannon.net/
29-Aug-2021,Interest,00.00,"80,393.15","562,752.08",Ce5b0D0f4232Dc1,1518,Leonard,Nicholson,Franklin-Holland,Lake Raymond,Ethiopia,210-224-7594x50383,+1-702-089-4083,rossspears@sherman-simpson.info,2020-02-23,https://www.cochran.com/
29-Aug-2021,Debit Card,00.00,"62,528.01","500,224.07",d9aC4EefF0a36E4,6587,Matthew,Savage,"Freeman, Woods and Drake",Cannonland,Saint Vincent and the Grenadines,313.864.8069,(538)600-6306,darrenduarte@boyer-freeman.com,2021-04-30,http://petty.com/
30-Aug-2021,Transfer,00.00,"50,022.41","450,201.66",e3E846defcaC4Fa,2157,Tabitha,Mendez,Faulkner-Novak,Katrinaton,Bahrain,071.074.5629,929-840-2669,markscaleb@diaz-roth.com,2021-10-23,http://sutton-perry.biz/
30-Aug-2021,Purchase,30.00,00.00,"450,231.66",aD6f31e9Fcfed2a,6350,Randy,Cervantes,Ball-Torres,Dunnmouth,British Indian Ocean Territory (Chagos Archipelago),373.524.4064x8002,001-284-112-2711x68790,medinagavin@alexander.com,2021-04-29,https://www.bonilla.net/
30-Aug-2021,Tax,00.00,"56,278.96","393,952.70",faF03D51fef9128,1188,Joanne,Andrade,Fields Inc,Paceberg,Austria,(673)170-7064x965,6017910429,kaitlin99@maynard.com,2020-11-19,http://woods.com/
30-Aug-2021,ATM,"1,930,826.00",00.00,"2,324,778.70",F91F83c423F5bD4,3275,Herbert,Livingston,Huber Group,Jesseview,Ecuador,+1-691-779-7932x599,223.793.5696,harrissean@wise-sloan.biz,2021-11-14,https://cochran.net/
30-Aug-2021,Commission,"1,986.00",00.00,"2,326,764.70",883fFc24DAbc45a,8226,Valerie,Hale,Mckenzie Group,Estradashire,Sudan,4095475948,232-629-2115x78637,gallaghergavin@chang.com,2021-12-11,https://www.serrano.com/
30-Aug-2021,Cash,00.00,"232,676.47","2,094,088.23",f377Be635b8C0F1,8137,Sylvia,Hansen,Molina LLC,East Darrenton,Niue,9693572360,8910662770,nixonbrian@patton-hancock.com,2021-04-25,http://www.lowery.com/
30-Aug-2021,NEFT,00.00,"1,047,044.12","1,047,044.12",ebA778dc69aaF48,8889,Tim,Silva,Cantrell-White,Boltonside,Syrian Arab Republic,020-249-1615x7738,5394195194,dan16@stanley-dixon.com,2020-06-28,https://www.boone.com/
30-Aug-2021,Interest,"3,787.00",00.00,"1,050,831.12",bB74ca44dcF7ED1,2919,Bill,Bauer,Wood Group,Peggyfort,Niue,+1-417-610-6866x08946,279-113-5193,hoodroberta@ware-sanford.com,2022-05-24,https://sexton.com/
30-Aug-2021,Tax,00.00,"350,277.04","700,554.08",F7CFa3DA1a6Fceb,7881,Jeremiah,Brock,"Hart, Bates and Sanders",Port Kristenfurt,Malawi,001-741-915-9694x19681,001-531-716-1358x947,sally78@curry.net,2020-04-29,http://little.com/
30-Aug-2021,Interest,02.00,00.00,"700,556.08",9fBd5F9EeAe3B78,8946,Dillon,Jefferson,Booker-Patrick,West Steven,Bhutan,001-430-432-6706x0224,+1-975-635-4491x593,chasegriffin@estes.net,2021-02-14,https://osborne.com/
30-Aug-2021,Cash,00.00,"116,759.35","583,796.73",079a058B89CB7EB,2912,Isaiah,Simpson,Wilcox-Mcmahon,New Russell,Solomon Islands,3972154028,001-053-590-3980x76529,bondcathy@combs-donaldson.com,2020-10-27,https://goodman-madden.com/
30-Aug-2021,ATM,05.00,00.00,"583,801.73",f900721a6CAD4bc,2403,Edward,Compton,Daniels-Ponce,Steveland,Kazakhstan,317-847-3021x374,850-681-6365x88112,nduarte@guzman-griffin.com,2021-12-14,https://villanueva.net/
30-Aug-2021,Commission,00.00,"291,900.87","291,900.86",c14e74C2AFcc2DB,661,Gabriel,Day,Mccarty PLC,South Kristie,Lithuania,(661)314-0847,676-142-0275,tamiwilkerson@schneider-howard.com,2020-02-08,https://www.short.net/
30-Aug-2021,RTGS,00.00,"32,433.43","259,467.43",E2Db2C74d54fD8E,774,Crystal,Wilkinson,Buck-Good,Port James,Bulgaria,040.967.3830x85094,869.043.6506,nathaniel99@rubio.info,2020-12-06,https://diaz.com/
30-Aug-2021,Reversal,"175,478.00",00.00,"434,945.43",5eA5225D9ccAca1,5393,Kirsten,Arnold,Ritter Group,Lake Misty,Latvia,+1-501-352-5655,001-078-276-8961x9578,uvalenzuela@chung.com,2021-03-09,http://hutchinson-hudson.org/
30-Aug-2021,IMPS,00.00,"62,135.06","372,810.37",B0fecEcD5b24d6A,623,Jill,Saunders,Haney-Lutz,Port Jasmin,Liberia,+1-791-579-4498x189,500.536.6575,riveraleah@caldwell.com,2020-10-06,https://www.rivas.org/
30-Aug-2021,Miscellaneous,59.00,00.00,"372,869.37",FfDE7aac4cfeA1a,2079,Stephanie,Fitzgerald,Carlson-Reid,Valenzuelaside,Georgia,(205)142-7751,3839038964,oliviaware@vaughan.com,2021-02-19,http://www.allison.org/
30-Aug-2021,Interest,00.00,"37,286.94","335,582.43",3EeA72C861AA184,4204,Bonnie,Beltran,Hale LLC,Aguirrebury,Angola,026.300.9604x49372,742-453-0457,joneslauren@cameron-hensley.com,2022-02-15,https://www.raymond.com/
30-Aug-2021,Bill,318.10,00.00,"335,900.53",Dd6Ddd2214c3E9B,204,Leroy,Hamilton,Shields-Whitehead,Wandastad,Ghana,+1-901-250-3282x38700,926.331.8840,edward56@parks.biz,2020-10-02,http://jones.com/
30-Aug-2021,Debit Card,08.00,00.00,"335,908.53",B1DD1d3B1E1bB5b,4451,Cameron,Duke,Stephens-Cunningham,North Rileymouth,French Southern Territories,(353)324-2876x437,979.512.9622x934,wtate@patterson.com,2022-01-19,https://www.snow.com/
30-Aug-2021,RTGS,"123,595.00",00.00,"459,503.53",bdFfFD052b758d6,997,Elizabeth,Montgomery,Benitez PLC,West Pennyfurt,Sweden,001-068-514-7902x5706,945.165.4632x9029,seanhebert@bryan.com,2020-12-16,http://www.huffman.net/
30-Aug-2021,Interest,00.00,"76,583.92","382,919.61",2c5eBF3da13Ee49,1655,Bob,Oconnell,Mills LLC,North Jordantown,Namibia,(517)321-9679x21611,552.734.8814x704,yreid@salazar.org,2020-05-14,http://www.rollins-mayo.com/
30-Aug-2021,NEFT,233.65,00.00,"383,153.26",F71d5C3bcDcddEc,3090,Herbert,Williamson,"Richmond, Padilla and Kane",Lake Brentberg,Hong Kong,882.063.9229x91736,440.434.4361x0547,nguyencody@case.org,2020-04-03,http://irwin.com/
30-Aug-2021,ATM,02.36,00.00,"383,155.62",7BFEBba0A0C6aa2,3224,Stacy,Cordova,Prince-Guzman,Port Gilberthaven,British Indian Ocean Territory (Chagos Archipelago),455-801-2551,001-738-367-2160x8687,felicia08@rose.com,2022-01-19,https://nielsen-peters.net/
30-Aug-2021,Tax,03.00,00.00,"383,158.62",42eAF89915dD6C9,6004,Devin,Reynolds,Austin-Wilkins,Stoutmouth,Namibia,009.876.8912x29513,921-793-7636x0041,hooverdebbie@hess.com,2020-09-06,http://www.rogers.com/
30-Aug-2021,Interest,31.40,00.00,"383,190.02",1b9CDDceC017308,4324,Emily,Yang,Richards Ltd,Port Karen,Holy See (Vatican City State),924.290.7172,(205)466-3521,pwhitney@sharp-powell.net,2022-01-09,https://gonzalez-lucero.org/
30-Aug-2021,Bill,06.00,00.00,"383,196.02",6cd647EbF5111c8,301,Brooke,Dominguez,Strickland-Ramos,West Heidiborough,Albania,(119)228-4507x009,391.740.8097,elijah82@chambers.org,2020-03-19,http://www.roy-mata.com/
30-Aug-2021,Debit Card,00.00,"42,577.34","340,618.68",FF6daEa6ca4EA3d,6110,Michele,Cobb,Villa Ltd,South Elizabeth,Yemen,645-037-5269,507-803-9608x567,kristaerickson@lucas.com,2020-09-10,https://griffith.com/
30-Aug-2021,IMPS,00.00,"68,123.74","272,494.94",f8e9987B620cCcb,4247,Amber,Simon,Lynch-Wilcox,North Meganview,Guinea-Bissau,855.449.4884x5481,001-934-722-7319,mitchellvernon@wilkins.org,2021-10-21,http://www.boone.com/
30-Aug-2021,Cheque,"21,417.50",00.00,"293,912.44",f41dF8Fd2aF69d5,2248,Haley,Davies,"Hendrix, Meyers and Braun",North Albertborough,Guinea-Bissau,351.505.8558x6249,001-992-635-7508x439,camachooscar@clark.com,2021-11-05,https://www.kirby.com/
30-Aug-2021,ATM,50.00,00.00,"293,962.44",C350cDb6C99Bf1D,1738,Chase,Campbell,Pollard Inc,Rodgersshire,Luxembourg,001-635-091-3667x287,103.916.4971x702,lydia08@shelton.info,2022-04-24,http://www.mccarty.net/
30-Aug-2021,Cheque,00.00,"58,792.49","235,169.95",0dF4C59eB1DDd03,1553,Bobby,Riddle,Knapp Ltd,Hesterhaven,Gibraltar,903.584.2655x7147,341-669-7893,reginald04@conner.net,2021-11-15,http://www.lozano.com/
30-Aug-2021,Cheque,00.00,"78,389.98","156,779.97",55C6ef3A04Bf0e8,9178,Eugene,Townsend,"Bright, Parrish and Figueroa",Orrview,Bermuda,001-918-435-4268x804,001-876-352-6464x22109,adrienne41@gilbert.org,2021-12-25,https://english.com/
30-Aug-2021,ATM,"889,572.00",00.00,"1,046,351.97",849E8AF7D48dA2c,2207,Juan,Stark,Skinner PLC,West Brucebury,Sierra Leone,(855)565-8753x49134,001-849-906-1900x96554,alecbrooks@huang-tate.com,2021-07-14,http://mendoza-wood.info/
30-Aug-2021,Commission,00.00,"149,478.85","896,873.12",72bAfd3bacbd3Da,8919,Debbie,Hurley,Bowman PLC,Joneshaven,Myanmar,(131)846-4194,275.865.9682,lebob@fleming.com,2020-08-26,http://www.norton-acevedo.net/
30-Aug-2021,IMPS,00.00,"179,374.62","717,498.50",1EABC7bcC8105a0,176,Dominique,Pacheco,"Reid, Simmons and Burgess",Sierraton,United Arab Emirates,511-933-2365x60056,(445)618-5895x1819,kristina23@carr-arias.com,2020-05-05,https://galvan-lucero.org/
30-Aug-2021,ATM,00.00,"179,374.63","538,123.88",Aded8E3B7b2e48D,2855,Dennis,Sweeney,Kline and Sons,Mosesmouth,Guam,973.269.7007,001-335-095-1632x9832,cliffordcisneros@mcintyre-watts.com,2021-02-17,http://campos.com/
30-Aug-2021,Purchase,"9,688.10",00.00,"547,811.98",E6eECBCdb9Db2aC,8247,Martha,Salazar,"Kirk, Clay and Schmitt",Laurenton,Serbia,001-960-731-8882,001-113-255-3700x213,crawforddaniel@norman.org,2022-05-11,https://www.yang.com/
30-Aug-2021,Commission,96.00,00.00,"547,907.98",fabcc7BEE2dfDfd,6093,Jaime,Mccormick,Sweeney-Wright,Cameronchester,Antarctica (the territory South of 60 deg S),+1-610-309-7813,013-061-1425,andrea32@sanchez-michael.com,2021-02-17,https://mayer.net/
30-Aug-2021,Commission,00.00,"54,790.80","493,117.18",CAcaAD99EF3c2D4,488,Tricia,Waller,Bradford-Bush,Rhondaborough,Uruguay,001-401-481-6270x0994,828.889.7561x52807,gilesjamie@hall.com,2020-09-01,http://www.vazquez.com/
30-Aug-2021,Bill,17.00,00.00,"493,134.18",af3AC5aB1aD8eBC,8761,Steven,Carroll,"Barr, Tanner and Soto",Maureenton,Gibraltar,426-394-9604x4952,903.519.2512x896,probertson@lopez.info,2021-10-13,http://www.cisneros.info/
31-Aug-2021,Commission,00.00,"123,283.55","369,850.64",6EA771E9ADdDbC5,7094,Fernando,Calderon,Lowe and Sons,Katiemouth,Monaco,+1-346-822-0129,(040)121-1334,smccann@lawrence-george.com,2021-07-03,http://www.moyer-ponce.com/
31-Aug-2021,Miscellaneous,00.00,"52,835.81","317,014.83",Fec624bb6ca55AC,5174,Joanna,Moon,Baker and Sons,Port Kaitlin,Jersey,(301)135-9206,+1-857-829-3270x09561,josephroy@boyle.com,2021-10-27,https://www.arellano.net/
31-Aug-2021,IMPS,00.00,"79,253.71","237,761.12",9AeB0cd91C1cABB,5163,Cameron,Hardin,"Simmons, Cabrera and Johnson",Lake Emilystad,Mali,184-641-2858,(329)130-7515,reeseshelly@travis.info,2021-03-15,https://www.dominguez.com/
31-Aug-2021,Cheque,00.00,"33,965.87","203,795.25",cecEcB86fd8fe2a,4335,Shannon,Jenkins,Vang Group,Port Fernando,Korea,(437)767-0545,3843960784,vancelori@mcdowell-gray.org,2021-12-30,https://mccarthy.com/
31-Aug-2021,RTGS,00.00,"25,474.41","178,320.84",f0bFeBE2EcC6E44,308,Elijah,Wagner,Snyder-Mccoy,West Diane,Somalia,151-710-4724x7177,+1-904-493-3489x267,opace@conway.net,2021-06-06,http://haley.net/
31-Aug-2021,Purchase,00.00,"35,664.17","142,656.67",81edA8bf788Fb5D,4284,Barbara,Duke,Mayer PLC,West Tylerport,Mali,+1-603-025-9942x6515,(886)335-1044x223,krivas@eaton-stanton.com,2020-12-03,https://www.acosta.com/
31-Aug-2021,RTGS,"1,742,874.75",00.00,"1,885,531.42",9699fEa7feB322d,5467,Bobby,Estes,"Allison, Norris and Roberson",South Alexandraton,Tuvalu,647.789.1274,001-668-574-4783x89943,donnadyer@bullock.info,2022-04-03,https://johns.com/
01-Sep-2021,Reversal,00.00,"269,361.63","1,616,169.79",5EFecD4Ffdfe83B,6031,Clayton,Hanna,"Frank, Cooper and Fisher",Meghanmouth,Vanuatu,848-883-4894x699,(066)198-7738x3268,uramos@dalton-mullen.org,2021-08-25,https://www.ashley.info/
01-Sep-2021,RTGS,00.00,"808,084.90","808,084.90",1CcBD7160dB1Fcb,9213,Felicia,Barry,Romero-Farley,Port Jackie,Faroe Islands,309.277.3004x105,+1-997-825-3776x0028,maciasaimee@singh.com,2021-06-27,http://sandoval-silva.com/
01-Sep-2021,Cheque,00.00,"269,361.63","538,723.27",9CDa6CDB6AACfDa,1701,Felicia,Townsend,Obrien-Webb,Patrickbury,Cape Verde,(582)975-3462x08382,(932)539-6455x79440,curtisroberson@travis.com,2020-02-14,http://carter.org/
01-Sep-2021,Reversal,00.00,"538,723.27",00.00,67ABEC77D7D7E1E,7142,Kurt,Mcfarland,Pugh-Holden,Haleychester,Madagascar,068.324.2011x82140,001-552-079-9641,hopkinsconnie@oneal.com,2021-05-23,http://moyer-jordan.com/
02-Sep-2021,NEFT,"3,924.00",00.00,"3,924.00",Ab81AbCD48C3ebd,7968,Adam,Thompson,Obrien Ltd,Grantchester,Cuba,001-273-434-5500,097.697.9900x56715,max16@kim.com,2020-01-30,http://larsen.com/
02-Sep-2021,RTGS,00.00,981.00,"2,943.00",182Cd4CF0E7eC38,7801,Wyatt,Clay,Moore-Rush,New Haydenbury,Saint Kitts and Nevis,992.458.3122x5861,588-455-4244,yvonnechapman@oliver.net,2020-12-08,https://haley.com/
02-Sep-2021,Reversal,00.00,420.43,"2,522.57",f41e42cD2F27EBA,6359,Dustin,Potts,Escobar Inc,South Rickstad,Vietnam,510-683-8211x6018,+1-323-292-3260x15194,terrence35@decker-hughes.net,2020-06-07,http://www.petty.info/
02-Sep-2021,Purchase,"14,809.50",00.00,"17,332.07",E14daBBEEA2EC9b,3882,Martin,Davenport,"Patton, Ward and Allen",Cooperville,Australia,246.246.3740x9934,+1-927-798-3230x920,patrick44@cortez.biz,2020-02-01,https://www.peterson.com/
02-Sep-2021,Reversal,00.00,"2,166.51","15,165.56",6a0ACAe7A7cFd7E,1091,Hannah,Fisher,Horn Ltd,East Traceymouth,Croatia,294-949-2014x47890,(221)421-7569x244,rhull@hardin.com,2020-01-26,https://www.harper.biz/
02-Sep-2021,RTGS,07.00,00.00,"15,172.56",7fe381D16fDFbdC,8554,Cassidy,Huff,Boyer-Fisher,Desireebury,Nepal,498-496-1543,001-418-521-2049x8125,cannonshane@ritter.com,2020-07-28,http://roy.com/
02-Sep-2021,IMPS,07.00,00.00,"15,179.56",3dFcB1a64c96bfA,135,Shaun,Marsh,"Lester, Murphy and Garner",East Maureen,Svalbard & Jan Mayen Islands,+1-859-923-2981x21277,001-991-038-5566x12302,damonhowe@larsen.org,2021-07-15,https://newman.com/
02-Sep-2021,Reversal,"1,462,900.00",00.00,"1,478,079.56",CCFCB3eA1F52Eb7,721,Ralph,Ballard,Walter-Reid,West Isabella,Guernsey,001-394-648-5035,+1-671-258-8279x6873,humphreylorraine@eaton-mcintyre.net,2020-02-12,https://www.hartman.com/
02-Sep-2021,IMPS,"103,689.20",00.00,"1,581,768.76",edecD07D8BbD8Ce,7765,April,Jacobson,Maynard Inc,West Susanborough,Ireland,+1-023-215-2948,286.887.9438x127,jodimadden@downs-russo.net,2020-11-11,http://www.vance.net/
02-Sep-2021,IMPS,"34,559.20",00.00,"1,616,327.96",a8f99f638c810a5,6413,Grace,Palmer,"Dalton, Edwards and Banks",South Matthewfort,Congo,906-758-5313,(573)416-3224,uarcher@pugh.info,2020-04-20,http://becker.com/
02-Sep-2021,Tax,"144,755.00",00.00,"1,761,082.96",Eb307A7082Cd6Fe,918,Maria,Robertson,Zimmerman Ltd,Bobshire,France,697-591-1231x62667,647.924.7139,snowsheryl@eaton-foster.com,2021-09-11,https://www.thompson.biz/
02-Sep-2021,Tax,"12,317.00",00.00,"1,773,399.96",61c701dBDBe2C4F,8796,Annette,Willis,Sims PLC,Phillipschester,Tajikistan,653-983-4471,2096038004,cdelgado@dunlap.org,2022-03-03,http://cook.org/
02-Sep-2021,Tax,00.00,"1,773,399.96",00.00,3A29b3AD81d1607,2611,Kenneth,Preston,Mckay and Sons,Stephenport,Antarctica (the territory South of 60 deg S),+1-675-438-9203x169,062-726-6020x9927,bettycampbell@short-lawrence.com,2022-02-11,http://www.ramsey.info/
02-Sep-2021,ATM,06.00,00.00,06.00,eE718cdA1CCaA91,6195,Bradley,Clayton,Ramos Inc,Barberstad,Luxembourg,360.797.7453x7457,5987632252,mcclurejoel@hubbard-lawson.info,2021-01-14,https://www.ferguson.com/
02-Sep-2021,NEFT,00.00,00.86,05.14,6f4cc20ddA6B8E2,9473,Adrian,Estes,"Barrett, Brady and Krause",Miamouth,United States of America,001-081-060-8929,379-845-0437x883,adrianawalton@briggs-blackburn.org,2021-08-13,http://www.bradley.biz/
02-Sep-2021,Interest,00.00,01.29,03.85,A7D6E4EBB69e0fB,6274,Jeffrey,Johns,"Hester, Best and Short",Glenton,Lesotho,(308)569-6779x589,+1-351-504-3031,kanegary@malone-horne.net,2020-07-16,http://www.meyer.info/
02-Sep-2021,Transfer,74.00,00.00,77.85,0EEd0FAbc4fbBeB,8631,William,Greer,Powell-Floyd,Port Laurabury,Niue,541.506.7432x6879,(324)443-7606x0558,lauriereilly@stokes-hoffman.com,2021-02-18,https://thomas.com/
02-Sep-2021,Cheque,00.00,07.79,70.06,AE8ac9a0B48e3Fd,5129,Ethan,Hayes,Hester LLC,North Tommy,Solomon Islands,518-357-2198x748,910.157.0086,lindseyconner@wood-wagner.com,2020-01-30,https://www.good-swanson.org/
02-Sep-2021,Debit Card,"59,749.00",00.00,"59,819.06",4EdbcFcfdEEA1bf,7394,Alice,Flynn,"Sandoval, Riley and Blair",South Sharonshire,Ecuador,+1-418-528-0742x805,+1-362-609-1060x134,darylhogan@morrison.com,2020-10-09,https://jefferson.com/
02-Sep-2021,Tax,00.00,"11,963.81","47,855.25",E325c8d31857cEf,2167,Patty,Barrett,Hoover Ltd,New Arthur,Isle of Man,+1-755-739-4688,230.009.0939,dave21@dickson.com,2022-01-21,http://hahn.biz/
02-Sep-2021,Commission,"156,811.00",00.00,"204,666.25",c998c52B60B8e15,3436,Karen,Huff,Whitney-Palmer,Suzannebury,New Zealand,039-510-0761x926,433-110-9261x95190,casey02@barry.info,2020-09-20,https://www.prince-campos.org/
02-Sep-2021,IMPS,"79,756.28",00.00,"284,422.53",D8FFFCe05E0B8eA,2813,Pam,Sawyer,Fletcher Ltd,West Chloe,Gabon,425-354-3409x974,+1-082-567-4353,john34@black.com,2020-11-25,http://www.horne-quinn.com/
02-Sep-2021,Purchase,00.00,"40,631.79","243,790.74",7830fDDeB2394FD,7450,Gary,Pollard,Richards-Sosa,Candacefurt,Russian Federation,2312035566,467-115-8736x46087,billysantos@dawson.net,2021-04-11,https://www.english-moreno.info/
02-Sep-2021,Miscellaneous,00.00,"40,631.79","203,158.95",0B5b43F7a9C25EC,8465,Isabella,Manning,Mayo LLC,Nguyenmouth,Azerbaijan,(875)367-3648x2498,001-100-494-5599x78753,pkeller@jimenez-becker.com,2020-10-10,http://white.org/
02-Sep-2021,RTGS,00.00,"29,022.71","174,136.24",BDB71E4ed782fEa,7678,Bryan,Fowler,Reese PLC,West Patricia,Bulgaria,124-270-7759,234-321-0605x41385,chapmannoah@mayer-terry.com,2020-11-12,http://www.grant.com/
02-Sep-2021,Debit Card,00.00,"174,136.24",00.00,379c7bB7CDb3AC2,4437,Dustin,Velasquez,Pace-Melendez,South Elaineside,Taiwan,+1-371-857-0128,129-007-2393,smalone@greer.net,2020-06-23,http://navarro.com/
02-Sep-2021,Purchase,"30,557.00",00.00,"30,557.00",F2E4AbEDEEefc6A,8987,Sherry,Weaver,"Bishop, Frye and Herman",Alvaradoland,Antigua and Barbuda,744.429.9012x302,001-070-534-4655x343,robynpugh@kidd-taylor.com,2021-02-05,https://www.evans-carlson.com/
02-Sep-2021,Tax,00.00,"4,365.29","26,191.71",048B21bB4E5BC9b,5635,Sherri,Mooney,Mccoy-Wheeler,Breannaborough,Northern Mariana Islands,945.860.2420x5819,(875)960-3336x05798,shawnblair@murphy.com,2021-09-05,https://www.edwards-molina.com/
02-Sep-2021,Reversal,183.30,00.00,"26,375.01",bB60D35a77Ce07F,8780,Sydney,Mcclure,"Dennis, Mueller and Ponce",Port Frankshire,Cameroon,347.959.3820,001-982-921-1877x51003,sophiacantu@mckee.com,2022-05-04,http://holland.com/
02-Sep-2021,Miscellaneous,27.00,00.00,"26,402.01",4DCb2a22eDFe4bA,3574,Carmen,Keller,Valentine Group,North Valerieport,Uganda,(983)139-4030,001-733-030-3370,tim15@prince.info,2021-03-06,https://blair-humphrey.net/
03-Sep-2021,ATM,02.76,00.00,"26,404.77",Ff17C5290ADCc5C,4549,Sabrina,Barajas,Vaughn Inc,South Kyle,Yemen,(479)374-5020x24597,001-840-151-2675,hunterrhonda@curry.info,2021-05-23,https://www.cohen.com/
03-Sep-2021,Debit Card,00.00,"2,640.48","23,764.29",0778d8Decad8147,107,Christine,Manning,"Carr, Harvey and Webb",East Eduardo,Slovenia,(099)652-7937,0410407343,toddmcmahon@beard-lambert.com,2021-01-24,http://hurley.org/
03-Sep-2021,Reversal,"197,665.00",00.00,"221,429.29",Da1ad9A4F7AF6c6,6514,Melanie,Ortega,Cox-Shepherd,Bonnieview,Guam,(193)065-2728x320,001-784-256-1124x8941,vangross@wolfe-mccarty.com,2021-02-19,http://cooper.com/
03-Sep-2021,Transfer,00.00,"22,142.93","199,286.36",Cc71F98F74e3f6D,4434,Vicki,Farmer,"Flynn, Tanner and Reid",Lake Lance,Brunei Darussalam,328.212.9810,+1-722-757-4879x74158,alexandria48@sims.com,2020-07-27,https://www.daugherty-griffin.com/
03-Sep-2021,Purchase,"59,202.60",00.00,"258,488.96",98F4ee7BABb2D6d,6541,Paul,Dalton,"Mays, Hale and Frye",Lake Kendra,Niger,670-703-5686x209,763-501-8099x162,riceisabel@rivera.net,2021-07-02,https://www.sellers-lawrence.com/
03-Sep-2021,Debit Card,00.00,"51,697.79","206,791.17",8df0CcABE5B8115,3283,Debra,Meadows,Erickson-Daniels,Colonborough,Switzerland,(040)297-2193,243-715-8311,annette96@house-serrano.com,2021-10-29,http://rowland-bonilla.biz/
03-Sep-2021,Interest,00.00,"25,848.90","180,942.27",afDB6eda83bcb9d,3019,Tara,Bass,Melton-Dalton,Kristenside,Chad,057-557-4618,(544)284-1589x4103,savageregina@yates-nicholson.biz,2021-01-20,https://villa-church.com/
03-Sep-2021,Cheque,39.00,00.00,"180,981.27",aD7FCD2FB05E924,9365,Haley,Zimmerman,Meyer-Everett,New Eugene,Montserrat,(447)094-8199x46204,(726)482-5634x380,kurt02@harris.info,2020-05-03,http://olson.com/
03-Sep-2021,RTGS,00.00,"45,245.32","135,735.95",0a9fe7D01D7628a,9838,Cheryl,Melendez,Ritter-Pratt,Moodyberg,Bangladesh,+1-221-543-2886,001-879-494-0698x40554,holderruth@nash.com,2020-01-24,https://www.vaughn.com/
03-Sep-2021,RTGS,00.00,"22,622.66","113,113.29",9F47753B78Abdee,5437,Jeanette,Dalton,Tran LLC,New Alexfort,Mauritania,403-880-1464x38205,201-305-1245x26870,sonya88@pace.com,2021-09-30,https://www.lynn-sweeney.com/
03-Sep-2021,Commission,03.00,00.00,"113,116.29",7ED61A1901Ab66A,3303,Tyrone,Rodriguez,Zuniga PLC,South Grantmouth,Sao Tome and Principe,(731)902-3239,313-427-3612,connorpatrick@fletcher-booth.net,2022-01-27,https://www.christensen.info/
03-Sep-2021,Purchase,"124,338.00",00.00,"237,454.29",bA9f39Bd9eEDDc3,5544,Riley,Hartman,"Gonzalez, Pittman and Sampson",Stefanieshire,Sao Tome and Principe,840.683.0632,(409)504-4920,mckenzietara@bryant.com,2020-04-10,http://dunn.biz/
03-Sep-2021,Miscellaneous,"1,641.65",00.00,"239,095.94",575AE57b2ad64c3,2264,Shelly,Jefferson,Guzman LLC,Skinnerton,Jersey,8291722445,9423241976,warrenerik@horn.biz,2020-11-13,https://duran.info/
03-Sep-2021,Tax,00.00,"59,773.99","179,321.96",33f30cb71A1Ad73,2610,Aimee,Fischer,"Lang, Levine and Velazquez",Hornebury,Algeria,001-298-374-8404x005,+1-696-402-6775x0071,davewilkins@clements-craig.com,2020-06-22,http://www.solis.com/
03-Sep-2021,Tax,156.15,00.00,"179,478.11",DEBCf7eED3fe621,7412,Nicole,Paul,Wilkinson-Oconnor,Huangmouth,San Marino,008-548-7862x4363,699.115.3385,bryanjordan@schmidt-browning.com,2021-11-02,https://higgins.org/
03-Sep-2021,NEFT,00.00,"59,826.04","119,652.07",22fEcCFF4D15EdE,3409,Ivan,Russo,Shah-Garcia,Bobbyfort,Lithuania,499.222.1070x886,167-316-0357x386,atkinsebony@simmons-mills.com,2021-09-24,https://chan.com/
03-Sep-2021,Reversal,297.10,00.00,"119,949.17",fC50d4b8745aDfe,3457,Cathy,Gonzales,"Good, Swanson and Mcpherson",West Raymondland,South Africa,681-478-7063x004,541-439-9016x5259,troylowe@taylor.biz,2021-03-13,http://knight-hunt.org/
03-Sep-2021,Debit Card,00.00,"23,989.83","95,959.34",01DAd2cf14AF90a,6928,Duane,Farley,Brennan-Johnson,East Madelinemouth,Guatemala,001-251-402-2117,(386)427-6158,dwatts@norman.info,2022-05-11,http://www.baxter.org/
03-Sep-2021,Transfer,00.00,"13,708.48","82,250.86",8ea1450e01bb7D9,6684,Don,Blackburn,Dean-Love,Brandtburgh,Macedonia,+1-695-056-7858,323.638.5423,dmercado@byrd.biz,2022-01-25,https://www.burke-esparza.com/
03-Sep-2021,Commission,00.00,"13,708.48","68,542.38",75e1B0ECAD06F60,1216,Karen,Powell,Ballard Inc,Wallschester,Bahrain,(837)887-4976x23484,+1-692-477-5826x6040,nobleharold@lawrence-christensen.com,2021-03-31,https://reese.com/
03-Sep-2021,Reversal,00.00,"68,542.38",00.00,B3fFe3b49DB7cBF,6994,Jay,Frey,Case PLC,Lukebury,Brazil,+1-647-044-6168x0479,001-957-061-7730x89182,ritteramber@sparks-west.net,2021-09-11,http://harper-solis.org/
03-Sep-2021,Cheque,08.90,00.00,08.90,449F0b5EC9eb27B,3896,Brandon,Bailey,Pittman-Garza,East Coreyton,Brunei Darussalam,+1-660-291-2166,001-479-040-2771x78261,cspence@oconnor.biz,2021-03-17,https://www.warren.com/
03-Sep-2021,Transfer,00.00,00.89,08.01,ff8DE39ca1BeDC8,8081,Hailey,Nicholson,Rhodes-Valentine,Rickhaven,Brazil,867-936-9866x189,+1-523-427-7643x61597,craigronnie@greene.org,2021-07-23,http://brown.biz/
03-Sep-2021,ATM,00.00,00.80,07.21,CE7a979fba79b49,5373,Maurice,Huerta,"Dickson, Wall and Acosta",West Marciaville,Netherlands Antilles,(557)067-2738x387,(326)306-5251,tonya48@johns-valentine.com,2021-07-28,http://www.cline-bradshaw.net/
03-Sep-2021,Transfer,00.00,02.40,04.81,6CaAB9eB928DcC5,536,Rebecca,Rasmussen,Park and Sons,North Tanya,Comoros,749-064-9430x7897,204-684-0840x23498,weberkerry@mcbride.biz,2020-08-06,http://ashley.com/
03-Sep-2021,Tax,00.00,02.41,02.40,f258EB0EEB6AA80,3797,Frank,George,Shepard LLC,West Isabellastad,Bermuda,(202)824-7339x8770,+1-583-157-7485x12540,karl18@hicks-boone.com,2020-05-10,https://www.lowery-preston.com/
03-Sep-2021,Tax,"38,281.70",00.00,"38,284.10",6D440ac7CfFF06d,3670,Latasha,Craig,"Walker, Chan and Mathews",New Misty,Papua New Guinea,(177)369-5847,+1-674-398-0276x16880,wolfefrancis@davies.com,2021-06-17,https://www.maxwell.com/
03-Sep-2021,Debit Card,"2,372.00",00.00,"40,656.10",C74CADB9aC1137A,9618,Cindy,Vasquez,Wong-Chan,Mckaychester,Mali,(055)197-7581x919,125-403-9562,neil04@allen-cohen.com,2020-03-16,https://osborn-roberson.com/
03-Sep-2021,Interest,"1,714,487.00",00.00,"1,755,143.10",CdEba1AA3272cA7,9857,Martha,Harrington,Grimes-Juarez,East Miaburgh,Cocos (Keeling) Islands,934-158-0116x06347,102.279.7915,kristine83@chambers.org,2020-10-08,https://www.giles.info/
03-Sep-2021,Bill,"30,785.17",00.00,"1,785,928.27",78Dfc889fA5fd4b,3312,Tara,York,Hoover and Sons,Courtneyside,Jordan,813.443.9372,+1-326-662-5416x209,roweconnor@garza.com,2020-01-22,http://pena-foley.org/
03-Sep-2021,RTGS,00.00,"223,241.03","1,562,687.24",4BBF47654CeB9Ee,577,Mike,Waters,Holt and Sons,Anneville,Kyrgyz Republic,493-252-1924x410,(430)515-2816x568,victorcaldwell@blanchard.com,2020-12-30,https://www.avila.com/
03-Sep-2021,Commission,05.00,00.00,"1,562,692.24",bCaF3F7d5791a59,8790,Marcia,Blanchard,Larson PLC,Jaredstad,Oman,363.673.5433,631-663-9210x558,nicholsdavid@schneider-krause.info,2022-01-11,https://barron-richardson.com/
03-Sep-2021,Miscellaneous,"1,521,346.00",00.00,"3,084,038.24",c00E78BA78Ade7A,6223,Angela,Schneider,Madden PLC,Vasquezfort,Armenia,521-209-3743,652.119.4974x69809,harrellcaroline@cortez-espinoza.com,2020-10-31,https://www.jenkins.info/
03-Sep-2021,Commission,"94,499.72",00.00,"3,178,537.96",dC7Dd3eA85dC9D3,8035,Kristin,Wise,"Schaefer, Bird and Jackson",North Robertabury,Solomon Islands,577-337-8501,940.671.4343,brandy21@parker-lindsey.com,2020-01-11,https://www.greene.biz/
03-Sep-2021,Miscellaneous,39.00,00.00,"3,178,576.96",5bBd44de5aE793e,2830,Chad,Fleming,"Bradshaw, Guerrero and Roth",South Kayleeton,United States Virgin Islands,001-120-147-0122x93953,341-819-3443x6389,colin13@richardson.biz,2020-12-25,http://keith-rush.org/
03-Sep-2021,Cheque,59.97,00.00,"3,178,636.93",2BDb52292Aac5fe,6718,Shawn,Haney,Aguilar-Blair,Swansonville,Nauru,584-654-5737,(620)767-2190x7400,saralara@brady.com,2021-10-26,http://www.mercer.com/
03-Sep-2021,Cheque,"29,335.70",00.00,"3,207,972.63",659874894840d78,419,Judy,Middleton,Galvan and Sons,Lukeville,Belarus,+1-903-323-7946x9825,359-078-3850x89196,tuckeradriana@cannon.com,2021-03-20,http://torres-trevino.com/
03-Sep-2021,Tax,00.00,"3,207,972.63",00.00,d83A31462C8dd34,2238,Mark,Hester,Huber-Ewing,Port Cindy,Ethiopia,833.648.6982x4982,(396)134-6646x19151,frederickstark@mcintyre-wang.biz,2020-08-13,http://jordan.org/
03-Sep-2021,Transfer,513.43,00.00,513.43,97dd4d6F78dDDB5,8183,Lori,Durham,"Figueroa, Wells and Kaiser",Branchstad,Papua New Guinea,001-745-302-2954x964,9974205647,cynthiamckay@mcclure-booker.com,2021-01-02,https://houston.net/
03-Sep-2021,NEFT,00.00,128.36,385.07,752aAcFA53DCc3E,5759,Teresa,Huang,Cunningham and Sons,South John,Gabon,001-388-815-1756x0088,(278)384-5233x412,lbarber@copeland-ingram.com,2021-01-20,http://barber.com/
03-Sep-2021,Reversal,"2,929.36",00.00,"3,314.43",Ec3FD1FA85ff437,3184,Kaylee,Galloway,"Melendez, Nguyen and Keller",Pamelaport,Angola,6795737003,(804)602-2227x6257,romeroseth@woodward.info,2021-12-24,https://christensen.com/
03-Sep-2021,Bill,"8,468.47",00.00,"11,782.90",BfcA73968Eb30AE,3581,Emma,Franco,Tanner-Nicholson,New Gabriellaview,Morocco,(984)972-2765,+1-677-206-4129x849,collin67@parsons.com,2020-11-15,https://www.cortez-santos.com/
03-Sep-2021,RTGS,00.00,"1,178.29","10,604.61",F3Ab3D80D7212e9,8284,Meredith,Hoffman,Reid Inc,Pattersonmouth,Brunei Darussalam,321-824-5673x3627,+1-164-108-5404x574,taylorbeltran@nixon.org,2021-09-22,https://www.harrell.com/
03-Sep-2021,RTGS,03.40,00.00,"10,608.01",7d1B22C60d9b9bE,3810,Meagan,Stevens,Sexton-Meyers,Dariusview,Liechtenstein,+1-118-189-9351x7375,4210254455,lauren58@ramsey.com,2020-01-08,https://www.pacheco.com/
03-Sep-2021,Interest,00.00,"1,768.00","8,840.01",Fd8CD3d6946EE58,4748,Virginia,Baird,"Powers, Jarvis and Carpenter",West Robynmouth,Hungary,608.539.3742x01943,(607)144-2981x66078,marvincordova@buck.com,2020-10-05,http://www.chandler.info/
03-Sep-2021,Interest,339.67,00.00,"9,179.68",4BDa2E785507F3A,1014,Tiffany,Gonzalez,"Jarvis, Garza and Zamora",North Jeanne,Paraguay,513-363-5589x576,001-484-199-3334,pbailey@whitaker.info,2022-01-12,https://www.lamb.org/
04-Sep-2021,Tax,00.00,"1,311.38","7,868.30",fF532C168cCEE1a,4160,Margaret,Mcdaniel,Page-Preston,Mckinneychester,Aruba,+1-703-832-9765x90636,309-071-5713x15355,kgreer@cordova-santos.biz,2021-08-22,http://www.ochoa-clements.org/
04-Sep-2021,Debit Card,00.00,"1,311.38","6,556.92",9e787efb97980CC,6220,Perry,Sweeney,Owen-Weiss,New Julian,Jersey,937-562-5373,701.148.2260x27445,bushkatrina@cordova.com,2021-05-22,http://www.carroll.com/
04-Sep-2021,NEFT,"4,052.70",00.00,"10,609.62",01958cCCe8aB8A8,6815,Julie,Moore,"Raymond, Juarez and Werner",Port Lacey,New Zealand,+1-397-794-8374x7296,+1-581-548-0899,michelle32@reese-marshall.com,2021-08-09,https://pena-mclean.com/
04-Sep-2021,NEFT,00.00,"2,652.41","7,957.22",41643625453c5Dc,722,Joy,Shields,"Jennings, Reyes and Solis",West Frederickchester,Saint Martin,(312)708-9026,437-049-4464x674,weberlucas@gallagher.com,2020-06-22,http://www.craig-rowland.com/
04-Sep-2021,Miscellaneous,00.00,"1,326.20","6,631.02",Ff6b1e9297D9aEA,4666,Jacob,Irwin,"Patton, Dorsey and Davenport",Kennedybury,Dominican Republic,693-852-2729x71569,001-357-723-9905,hlozano@dorsey.org,2020-02-12,https://mills.net/
04-Sep-2021,Cash,00.00,"6,631.02",00.00,AaA1c4aB0ffFDeA,6269,Levi,Bird,Copeland Group,Jeromeview,Timor-Leste,995.629.7685,(255)860-6798x733,bryanmelanie@chambers.com,2020-12-02,https://pugh-griffith.net/
04-Sep-2021,Reversal,"66,651.12",00.00,"66,651.12",4C6dD9f7bcbed9d,2537,Mathew,Whitehead,"Medina, Charles and Graves",South Emma,Cape Verde,(687)635-3292x5491,001-230-697-2183x028,aprille@richards-bartlett.net,2021-01-24,http://solis-bean.com/
04-Sep-2021,Reversal,00.00,"7,405.68","59,245.44",43f683C3361eb65,62,Doris,Drake,"Rich, Edwards and Miranda",Lukemouth,Indonesia,184-508-9386x4549,+1-839-084-8619x4015,carpentergary@vance-weeks.com,2022-03-03,https://www.snow.org/
04-Sep-2021,Transfer,"2,820.00",00.00,"62,065.44",FD89FDe55A82eaB,891,Cassidy,Gibson,Pearson-Watkins,Rileystad,Ethiopia,648.930.7549,608-784-6194,lawrence67@french.com,2021-06-03,http://thompson.biz/
04-Sep-2021,Transfer,00.00,"6,206.54","55,858.90",BEeDBC92eFD6ee3,1197,Rick,Faulkner,Meyers Ltd,Jerrymouth,Turkmenistan,577-371-0397,495-549-2895,isaacduncan@blair.com,2021-02-23,http://hines.com/
04-Sep-2021,Miscellaneous,00.00,"27,929.45","27,929.45",7A44c27C64Cd3e1,7423,Dale,Rios,Bryan-Wright,Bethburgh,Portugal,242.583.7862x19676,(919)776-1718x8623,karina57@ballard-cowan.com,2021-11-14,https://day.com/
04-Sep-2021,IMPS,06.30,00.00,"27,935.75",56C4dDB1EB7c004,2449,Bob,Wilcox,Melton Ltd,North Katie,Sudan,829.002.2276x68795,(591)423-8553,dsimon@mays-harmon.com,2021-01-31,http://www.cummings.com/
04-Sep-2021,RTGS,00.00,"3,491.97","24,443.78",c9c569C1FE7ACbf,7322,Andres,Reid,Campos and Sons,Lake Nichole,French Guiana,906.396.0856x04265,478.825.5725,jonathanedwards@kemp-werner.com,2020-02-19,https://lloyd.com/
04-Sep-2021,ATM,508.48,00.00,"24,952.26",ABCFefFaDAc5F2C,1297,Judith,Abbott,Potter-Haney,Lake Evanberg,San Marino,(803)522-0695,8758726874,alyssajuarez@villanueva.com,2020-04-14,https://gates.com/
04-Sep-2021,Commission,"228,449.88",00.00,"253,402.14",Aa31dDC99911aFE,8879,Carla,Richard,"Pratt, Cowan and Grimes",Kristinemouth,Italy,(665)813-4793x9528,+1-162-345-7801x926,guerrerokaylee@curry-briggs.com,2021-11-29,https://www.avery.com/
04-Sep-2021,Debit Card,00.00,"63,350.54","190,051.60",FdF7F6e6D49739a,7420,Jorge,Maddox,Hodge LLC,West Francistown,Faroe Islands,(820)794-9460,(472)778-2822x628,adrienneescobar@gardner.com,2020-05-02,http://www.davenport-gray.com/
04-Sep-2021,Bill,"172,220.10",00.00,"362,271.70",EdffD0Fce258adE,1713,Anne,Hardin,Santos LLC,Jonathonview,Suriname,486-807-6475x166,(311)395-3251x9021,barry55@kane-mercado.com,2021-11-28,https://www.bruce.com/
04-Sep-2021,Reversal,"75,871.03",00.00,"438,142.73",DF42EfcdACF9952,6808,Carly,Wheeler,Stokes Group,New Colebury,Montenegro,920-235-9919,001-777-288-4224,bernardhowe@schultz.com,2020-12-23,https://www.fuller.org/
04-Sep-2021,Commission,00.95,00.00,"438,143.68",f3A9a37bD8A7AFA,8366,Anthony,Dominguez,"Blair, Burch and Yates",Samanthaburgh,Kuwait,534-563-8895x05052,001-339-194-7343x5010,alec12@mcneil.com,2021-08-09,http://bender-deleon.net/
04-Sep-2021,Bill,"2,759.00",00.00,"440,902.68",34fbA4af1E690ef,4427,Maria,Riddle,"Rush, Sparks and Kennedy",Darrylbury,Maldives,194.943.5497,001-364-178-5014x9878,clarencerandolph@nunez.com,2020-05-24,http://hoover.org/
04-Sep-2021,IMPS,"576,443.50",00.00,"1,017,346.18",96DD165F4Cf0E9C,6671,Kendra,Oliver,"Sheppard, Goodman and Knapp",Lake Nathaniel,Philippines,+1-614-170-0382,001-776-530-9334x1130,whitneyjonathan@gillespie-mcknight.com,2020-02-01,https://www.alvarez-cooke.com/
04-Sep-2021,Cash,"25,331.00",00.00,"1,042,677.18",7cbcfDb0BaC95C8,5121,Xavier,Walsh,Costa Inc,Priscillabury,Vietnam,(380)010-2685x472,737.747.8158,phillippollard@lambert-castillo.biz,2020-04-03,https://www.sanders.com/
04-Sep-2021,Debit Card,"1,724.90",00.00,"1,044,402.08",910dF5c39bf23cD,5365,Jordan,Fletcher,Kane Group,Jordanbury,Lao People's Democratic Republic,968.338.6452x3032,+1-863-978-8629,stacyellison@pace-poole.org,2021-08-09,http://www.bullock.biz/
04-Sep-2021,Reversal,"4,245.10",00.00,"1,048,647.18",cb74bb4Db79aF64,8298,Stephen,Woodward,Gates-Sweeney,Henryport,Comoros,7446547584,001-357-807-2461x5770,geverett@haas.com,2021-09-18,http://weaver-day.com/
04-Sep-2021,IMPS,"2,780.60",00.00,"1,051,427.78",6df4F5Fa38D3BB4,9492,Deanna,Hines,"Stone, Dean and Garcia",Cooleyland,Greenland,(423)450-1907x5292,308.424.7469,josebeard@mcbride-donaldson.com,2022-05-06,https://www.chan.com/
04-Sep-2021,Reversal,06.40,00.00,"1,051,434.18",45c7C5DbEC6EcA9,9877,Diane,Hays,Frederick and Sons,Port Martha,Equatorial Guinea,413.438.1947x002,162.706.9922,kyleschaefer@day.info,2021-02-23,http://www.bolton.info/
04-Sep-2021,Debit Card,"3,241.78",00.00,"1,054,675.96",51dE6f5a10A9eb0,3860,Kimberly,Keller,Bean-Hahn,Stephenburgh,Haiti,+1-875-245-3183x763,001-708-706-2005x6648,carlos62@reid.biz,2021-04-05,http://joseph-blankenship.com/
04-Sep-2021,Transfer,00.00,"105,467.60","949,208.36",d4B5845ceEBe667,3555,Belinda,Reeves,Bush LLC,West Haileyport,Peru,142.027.4130x31827,001-435-379-6121x58933,sierrameza@terry.com,2021-05-12,http://reid.info/
04-Sep-2021,Debit Card,"5,609.00",00.00,"954,817.36",7fcC0CB80f178Db,7497,Sheila,Small,Vargas-Cobb,Lake Steven,Jersey,302-918-0698,090-965-3545,fsellers@copeland.com,2021-06-01,http://www.mccann.com/
04-Sep-2021,Reversal,"197,144.00",00.00,"1,151,961.36",da97EAeCD6FCe2d,6325,Kelsey,Wilkinson,Hays PLC,New Nicholebury,Bahrain,144-106-0641,+1-592-742-1038x772,chelseymurphy@malone-bentley.com,2020-03-17,http://www.castillo-powers.com/
05-Sep-2021,Commission,"51,423.38",00.00,"1,203,384.74",1CbAdE57CFBaE6d,9060,Marvin,Hunter,Pruitt and Sons,Port Karla,France,344-642-0451x68163,8391687057,bcurtis@sanford-mcfarland.net,2020-02-05,https://www.mccann-ali.com/
05-Sep-2021,Commission,"95,853.84",00.00,"1,299,238.58",Fec624bb6ca55AC,5174,Joanna,Moon,Baker and Sons,Port Kaitlin,Jersey,(301)135-9206,+1-857-829-3270x09561,josephroy@boyle.com,2021-10-27,https://www.arellano.net/
05-Sep-2021,Purchase,06.00,00.00,"1,299,244.58",daEFd10fa657afb,9682,Wayne,Hawkins,Stokes Group,Marissastad,Grenada,024.878.7226,223-212-3399x43123,jsantana@downs.com,2021-01-20,http://www.tyler-vaughan.com/
05-Sep-2021,Purchase,00.00,"144,360.51","1,154,884.07",74faebCbFF04222,8762,Kristy,Griffith,"Baxter, Peters and Griffin",Cantrellborough,Rwanda,430.881.9982,+1-020-610-4890x993,miguel65@mendoza.info,2021-10-27,https://www.wyatt.com/
06-Sep-2021,Cash,03.50,00.00,"1,154,887.57",61DbE2f2f4CfA55,1785,Emma,Douglas,Mccullough-Harrison,Jeffhaven,Tonga,(447)750-0364,(925)023-5928x97748,jermainesherman@weeks.com,2022-01-13,https://www.mcclain.com/
06-Sep-2021,Reversal,00.00,"115,488.76","1,039,398.81",E5b5Bf2DBfcE824,1359,Andres,Combs,Patrick Inc,Port Selenaborough,Taiwan,001-235-315-3625,(494)290-2579x338,vhaynes@wise-fritz.com,2022-01-08,http://medina-norton.com/
06-Sep-2021,Purchase,00.00,"148,485.54","890,913.27",7a619E93F0cA947,5922,Leonard,Reid,"Vega, Carroll and Bell",East Michelle,Dominica,+1-301-236-6777x1811,753.267.0061x585,georgehayley@freeman-freeman.org,2020-05-09,https://www.crane-hamilton.net/
06-Sep-2021,Tax,00.00,"445,456.64","445,456.64",AAFEf71DDFCf0ce,6377,Doris,Yu,Crane-Bruce,West Vincentton,Gambia,001-425-008-9825x41046,+1-308-374-6828x70814,tyler98@garrett.com,2021-11-09,http://wood.com/
06-Sep-2021,Commission,"193,878.10",00.00,"639,334.74",abcBd0FbBcA2F4c,6958,Roger,Haney,"Wilkerson, Anthony and Hatfield",West Pamela,Lesotho,(337)094-5325x2413,814-355-2494x398,kathleen90@vaughn.com,2020-08-07,https://mullen.com/
06-Sep-2021,Interest,15.00,00.00,"639,349.74",D4EEa2EF8f1be34,3994,Kathryn,Nash,Willis-Nash,South Kristiemouth,Tajikistan,648.326.7734x6222,324-377-9718x42327,shaunbryan@payne.net,2022-05-10,http://moreno.com/
06-Sep-2021,RTGS,00.00,"79,918.72","559,431.02",C4B93d4ec054aFe,6527,Helen,Molina,Shepard and Sons,Adriantown,Lao People's Democratic Republic,+1-065-671-4577x3102,(337)255-7645x9391,christie74@martinez.net,2020-07-03,https://jennings-villarreal.org/
06-Sep-2021,Purchase,00.00,"559,431.02",00.00,43eBC5D90A693da,7136,Monica,Steele,Thompson-Reeves,East Rachael,Mali,613-767-0557x968,001-829-947-9873x3668,shelby99@kline.com,2020-09-10,http://huber.biz/
06-Sep-2021,NEFT,05.00,00.00,05.00,b0Ed3bb9ACbfCC0,2941,Lindsay,Hendricks,Wiggins-Shea,East Annette,Haiti,(378)228-2412x81618,618.652.4679x8151,collincase@santos.info,2021-05-02,http://www.bright.com/
06-Sep-2021,Interest,"63,305.00",00.00,"63,310.00",f660a09BbCe1912,5177,Willie,Benitez,Stark Group,Norrisstad,Korea,001-482-961-5699x1764,(356)152-2253,darius02@pratt.net,2020-01-03,https://www.parsons-hanson.org/
06-Sep-2021,Tax,00.00,"31,655.00","31,655.00",EfDb96CC2abA50A,3028,Sydney,Rosario,Sweeney Ltd,New Audreyfort,Vanuatu,049.318.8103,355.449.1449x994,parksmax@castaneda.com,2021-09-08,http://branch.com/
06-Sep-2021,Debit Card,"13,386.00",00.00,"45,041.00",C17dab74930a79C,3546,Kristy,Fitzpatrick,Mccormick-Salazar,Orrton,Antigua and Barbuda,780-061-0442x427,422.432.2106,terrysharon@watts-reyes.com,2021-08-11,http://www.foster.com/
06-Sep-2021,Purchase,07.00,00.00,"45,048.00",3F389fdde74aaAB,6674,Alex,Pace,Strong and Sons,Wangfort,Madagascar,(156)793-6917x4940,742.192.0076x7446,bradsolomon@bryan.org,2022-05-29,https://www.charles-gordon.info/
07-Sep-2021,Reversal,44.32,00.00,"45,092.32",24f2cB08785b6bB,3159,Joann,Bullock,Munoz-Gomez,Colliershire,Pitcairn Islands,(450)258-8188x79632,697.832.7502x05859,shirleyriddle@huynh.biz,2022-02-07,https://huang.com/
07-Sep-2021,Reversal,00.00,"5,636.54","39,455.78",9BEcDe3EA3d5631,5770,Danny,Black,Key-Haas,Nicholsbury,Taiwan,654-036-5042x00021,875-647-1684x826,montgomerycolin@cox.com,2020-09-14,https://watson.net/
07-Sep-2021,Reversal,00.00,"9,863.95","29,591.84",d7FA5CCbCfD3565,3831,Geoffrey,Robles,Green Group,West Lauren,Netherlands Antilles,+1-865-144-6877x763,(656)834-1155x67358,sharonduncan@callahan.com,2020-10-09,http://sheppard-hunter.biz/
07-Sep-2021,Interest,141.00,00.00,"29,732.84",6d6F3fb9EdE210f,7314,Andre,Ray,Anthony-Mercado,Everetthaven,Saint Barthelemy,094.167.7605,+1-009-089-0353,wberger@pope.com,2022-01-07,https://miller-burns.biz/
07-Sep-2021,NEFT,"2,726.00",00.00,"32,458.84",4EAB3f9cfC43520,8213,Shelia,Page,"Golden, Turner and Wolf",Josephfort,Norway,472.851.6574,4036500092,marissakaufman@sheppard.com,2020-06-29,https://thompson-cuevas.com/
07-Sep-2021,Commission,31.98,00.00,"32,490.82",35522CB3aa1a15e,5840,Eddie,Duffy,"Pineda, Rice and Cuevas",West Patrickport,Montserrat,971.743.5961x4812,192-966-2252x48357,brianbooker@mack.com,2021-06-05,http://allison.com/
07-Sep-2021,Commission,00.00,"16,245.41","16,245.41",d53ABB60D6CeafA,1303,Brady,Meyers,Bonilla LLC,Guerreroville,Sri Lanka,001-338-653-8914x59043,+1-953-565-1936x678,jeremiahirwin@pineda.com,2020-09-06,https://gillespie.com/
07-Sep-2021,Bill,04.43,00.00,"16,249.84",BfefD374B023dDF,2775,Jeffrey,Wright,Gordon Ltd,Harrellville,Central African Republic,0179257815,001-654-373-9737x507,terri95@logan.com,2022-03-30,https://houston.com/
07-Sep-2021,Purchase,34.92,00.00,"16,284.76",1Ddd0d9d13eaABA,3866,Malik,Brady,Martinez and Sons,Olsonhaven,Zambia,495-666-0987x3154,(146)410-7719x69181,traciebryant@blake.info,2020-01-29,https://www.crawford.info/
07-Sep-2021,Tax,556.00,00.00,"16,840.76",BACf84F3ab8Ba7e,5960,Hunter,Everett,"Rivers, Donovan and Franklin",Soniamouth,Cameroon,332-249-1088,553-464-2568,kendra71@shelton-roberson.biz,2021-02-14,https://esparza.com/
07-Sep-2021,Bill,"3,317.73",00.00,"20,158.49",faE37c4DB5ecEbF,5257,Javier,David,Mooney Inc,Lake Tammiebury,Saudi Arabia,+1-643-532-6073x175,618.764.7064,buckleydominic@hampton.com,2020-06-30,https://decker.com/
07-Sep-2021,Debit Card,02.54,00.00,"20,161.03",A2bAa723D8E27Ee,1191,Daniel,Patel,Schultz and Sons,New Danielport,Belize,329.612.8560,207-752-6169x735,doriswalls@bartlett.com,2022-01-24,http://bright.info/
07-Sep-2021,Purchase,09.00,00.00,"20,170.03",dd6BBbdEFD7A1e6,8068,Rebecca,Fowler,"Walton, Salas and Rosales",Lake Ronnieburgh,Maldives,184-815-5397,874.398.1523,ihouston@long-skinner.info,2020-10-26,http://www.hughes.com/
07-Sep-2021,RTGS,302.00,00.00,"20,472.03",2C0E6f5B67CacDf,4332,Marissa,Shields,"Horn, Abbott and Pham",North Peggy,Guam,001-359-554-0498x5635,188.571.8247x7067,maria42@howell.com,2022-05-29,https://www.fox-cobb.com/
07-Sep-2021,Purchase,95.90,00.00,"20,567.93",eE803B9eF6F8e8B,7620,Miguel,Walter,Fry Ltd,Aliceberg,Norfolk Island,+1-034-326-9194x883,+1-011-643-9978x6458,littlemichael@villanueva.com,2022-03-24,http://www.ramos.biz/
07-Sep-2021,Reversal,00.00,"10,283.97","10,283.96",aEdAAbcf77908A8,4211,Breanna,Duffy,Daniel-Ford,Danielsborough,Israel,+1-286-826-6093,846.294.5818,alishawoodward@osborn.biz,2021-05-24,http://www.sharp.biz/
07-Sep-2021,RTGS,00.00,"1,028.40","9,255.56",5aFc7BFbe176B2e,4336,David,Benson,Brock-Yates,Littletown,Sierra Leone,229-353-1835,+1-651-408-4328x18499,nicole73@dickerson-krause.com,2021-08-22,https://henderson.org/
07-Sep-2021,Miscellaneous,"129,644.56",00.00,"138,900.12",02E3e35DAc3354B,6750,Antonio,Clarke,Bartlett-Howell,Sethhaven,Bouvet Island (Bouvetoya),(054)909-5403x54225,001-594-113-0858x8267,jeffcarter@molina.biz,2020-04-05,http://avery-kramer.com/
07-Sep-2021,IMPS,00.00,"15,433.35","123,466.77",b77AcEcdC7AfCEB,9648,Jillian,Hendrix,Zhang Group,Bridgettown,Macedonia,804-544-7885x59713,683.530.9772,audrey30@herman-howard.com,2022-04-02,http://www.robertson.com/
07-Sep-2021,Commission,"4,043.47",00.00,"127,510.24",73Ad6f9Cbe021D3,6340,Kelsey,Sawyer,"Callahan, Blake and Fuentes",Jeanland,Guatemala,001-444-313-6363x50164,001-938-075-9287,ehampton@huerta.org,2022-01-05,https://mitchell.biz/
07-Sep-2021,Interest,"27,987.40",00.00,"155,497.64",d5EdD3356cF0F9A,7076,Javier,Collins,"Walls, Bird and Cameron",East Darrellfurt,Egypt,(102)099-1300x05300,001-304-751-1808x32204,carpenterpenny@schmitt-skinner.com,2020-08-21,https://farley.com/
07-Sep-2021,Purchase,05.40,00.00,"155,503.04",dBC92Cde4BbFDbe,5712,Janice,Wall,Pena Group,Manningborough,Cambodia,7663763712,(424)921-1635x431,julian34@leblanc.org,2021-05-08,https://www.gardner.com/
07-Sep-2021,Cash,00.00,"31,100.61","124,402.43",AF64c02A20410f5,1925,Susan,Faulkner,Dillon Ltd,Port Kirstenmouth,Zimbabwe,+1-491-811-4201x4025,(325)759-9729x95975,leroymeyer@beard.com,2021-02-01,http://www.berg.biz/
07-Sep-2021,RTGS,845.30,00.00,"125,247.73",AEBc2cbC73AB569,8576,Todd,Pace,"Ibarra, Oconnor and Mcdaniel",East Brucemouth,Myanmar,(929)772-9780,644-161-2685,kcisneros@rosales-kirby.com,2021-10-08,http://may-stevens.com/
07-Sep-2021,Cash,00.00,"62,623.87","62,623.86",aBbddcDd5B1e57E,1267,Mia,Shah,"Ochoa, Beard and Guerrero",North Warrenport,Madagascar,967-579-4549x1491,001-300-617-7306x56607,efrey@campbell-ritter.org,2021-03-24,http://www.harper.biz/
07-Sep-2021,ATM,00.00,"8,946.27","53,677.59",9De5a7C4F977Dec,4897,Traci,Oconnor,Hull-Ware,East Angelaberg,Bermuda,(151)089-3406x49727,(794)676-5425,diazchristie@garrett-rowe.info,2020-10-06,https://www.houston.org/
07-Sep-2021,Bill,00.00,"26,838.80","26,838.80",00edbFDE79692BC,5205,Wendy,Cardenas,Hoover Ltd,North Leslie,Western Sahara,7513221972,950-308-1916,alan39@payne.biz,2022-05-14,http://garrison-gomez.com/
07-Sep-2021,Bill,00.00,"2,982.09","23,856.71",bF2DF581FD0DC5a,4825,Sherri,Frey,Hardin Group,Mooreburgh,Congo,(062)211-5026,252.155.3997x5653,bryantmolly@brewer-yates.com,2020-09-16,http://riggs-cherry.com/
07-Sep-2021,RTGS,"560,480.00",00.00,"584,336.71",D4EEd12c5B0F192,9806,Kenneth,Hansen,Juarez-Harper,Lake Stuartville,Senegal,001-128-494-5934x8229,001-050-732-9825x02718,jeffrey25@johnston-summers.net,2020-12-08,http://vincent-powell.com/
07-Sep-2021,Miscellaneous,00.00,"194,778.90","389,557.81",1Ba224cAA8c6bA5,3627,Angelica,Moreno,Parker-Benjamin,East Faithberg,Panama,724-548-3912x0490,(815)908-4828x953,savagelinda@zimmerman.net,2021-03-15,https://www.morales-newman.com/
07-Sep-2021,Tax,"5,968.58",00.00,"395,526.39",C39c818ccfc5A6C,9212,Darren,Houston,Gillespie LLC,Garnertown,Bouvet Island (Bouvetoya),001-351-378-6125x041,3314976273,grimescasey@fitzgerald.com,2021-07-14,https://chan-rich.biz/
07-Sep-2021,Tax,248.92,00.00,"395,775.31",b9B3B5f1ba40FD3,28,Roberta,Walton,"Lamb, Little and Frazier",Campbellshire,Tonga,805-974-3346x026,001-324-540-6599x3227,sharigriffin@cameron.com,2020-11-15,https://quinn.biz/
07-Sep-2021,Bill,"179,730.34",00.00,"575,505.65",F34BAc64dFFCEa9,9028,Andre,Villanueva,"Butler, Benitez and Howell",Feliciastad,Malawi,001-683-181-4194x04677,+1-193-239-9513x670,chelseyyork@willis.com,2021-12-19,http://english-hahn.biz/
07-Sep-2021,Debit Card,00.00,"63,945.07","511,560.58",62591BdCf896dE5,5909,Larry,Herring,Gibbs Inc,Malikland,United Kingdom,629-233-4454x25483,+1-229-524-4867,bryanmeredith@sawyer.org,2020-01-19,http://pope-baxter.biz/
07-Sep-2021,Purchase,00.00,"102,312.12","409,248.46",Dc9fab1C577FdAB,116,Daryl,Mejia,"Atkins, Huerta and Wolf",West Cristian,Bermuda,564.315.9882x76632,651.345.8376,beckyshaw@bradley-booth.com,2021-07-23,http://cortez-cooper.com/
07-Sep-2021,Cash,483.21,00.00,"409,731.67",dA3669d0BaD459C,9377,Jade,Beasley,Stafford-Rosario,Bruceburgh,Venezuela,026-852-0074x943,+1-145-399-8308x6996,jprice@dunlap.biz,2021-03-06,https://arias-barry.org/
08-Sep-2021,Purchase,"2,465.60",00.00,"412,197.27",2eDB9DDDadDaAEd,457,Sonya,Calderon,Savage-Mcdonald,South Leehaven,Trinidad and Tobago,883.145.5554,(585)628-2336x835,kevinwallace@woodard.com,2022-04-07,https://barber.com/
08-Sep-2021,Cheque,02.00,00.00,"412,199.27",7D0cE91963E42Ec,2284,Misty,Barrera,Mcneil Ltd,Carterfort,Bosnia and Herzegovina,362-807-9323,(162)690-0327,duane54@klein-savage.org,2022-04-12,http://www.wyatt.com/
08-Sep-2021,Transfer,00.00,"41,219.93","370,979.34",A3CAfea45bCC3DE,3498,Preston,Gilbert,"Cordova, Fleming and Noble",Rossfort,Bahamas,998.420.3915,076-083-0059x546,josephdale@vincent.info,2022-01-09,http://www.sosa-lambert.com/
08-Sep-2021,ATM,02.70,00.00,"370,982.04",9f6C1EF41E03EB1,1012,Lindsey,Houston,"Avila, Barton and Weeks",West Kathyburgh,Trinidad and Tobago,+1-948-118-2481x570,544.609.2502x38377,kelly48@cantrell-grimes.com,2020-04-15,https://monroe-oliver.com/
08-Sep-2021,RTGS,00.00,"37,098.20","333,883.84",0e0DD99adD51BD7,868,Carl,White,Michael-Owens,East Victor,Cuba,656.753.8857,(149)003-4491x928,kristina61@lopez-chavez.com,2022-05-09,https://www.brandt-hawkins.biz/
08-Sep-2021,Purchase,00.00,"111,294.61","222,589.23",5Cb5F774E18eD4E,4918,Tara,Duke,Kidd Group,Kaitlynmouth,Maldives,(406)761-3203x444,559-211-5351,traceymora@horne-farrell.info,2021-12-22,http://www.meyer.com/
08-Sep-2021,ATM,00.68,00.00,"222,589.91",F506aff4D8D38B0,5807,Nicole,Lamb,Snyder-Huber,Gordonhaven,Portugal,+1-070-675-7939x50644,326.671.9817x835,trangel@washington-swanson.com,2021-09-24,http://bridges-peters.com/
08-Sep-2021,Purchase,"93,504.00",00.00,"316,093.91",FA07C464bDefdC2,9188,Sonya,Flores,Lawson-Yu,Copelandborough,Turks and Caicos Islands,498-441-1668x77741,865.911.4125,alectate@gamble.com,2021-06-23,http://perkins.com/
